Date,Client Name,Legal Entity,Received Amount,Delivered Amount,Net Amount
2010-01-01,HSBC,CitiBank New York,12253,97451,-85198
2010-02-01,HSBC,CitiBank New York,11928,98215,-86287
2010-03-01,HSBC,CitiBank New York,11625,97365,-85740
2010-04-01,HSBC,CitiBank New York,19454,98995,-79541
2010-05-01,HSBC,CitiBank New York,14914,97357,-82443
2010-06-01,HSBC,CitiBank New York,18613,95874,-77261
2010-07-01,HSBC,CitiBank New York,11256,99987,-88731
2010-08-01,HSBC,CitiBank New York,14112,99375,-85263
2010-09-01,HSBC,CitiBank New York,13832,99756,-85924
2010-10-01,HSBC,CitiBank New York,11355,95668,-84313
2010-11-01,HSBC,CitiBank New York,22584,97259,-74675
2010-12-01,HSBC,CitiBank New York,26933,93744,-66811
2011-01-01,HSBC,CitiBank New York,28743,92851,-64108
2011-02-01,HSBC,CitiBank New York,22358,94758,-72400
2011-03-01,HSBC,CitiBank New York,26286,93369,-67083
2011-04-01,HSBC,CitiBank New York,27323,93914,-66591
2011-05-01,HSBC,CitiBank New York,25278,98962,-73684
2011-06-01,HSBC,CitiBank New York,25331,94912,-69581
2011-07-01,HSBC,CitiBank New York,24647,97894,-73247
2011-08-01,HSBC,CitiBank New York,21225,95922,-74697
2011-09-01,HSBC,CitiBank New York,36729,81654,-44925
2011-10-01,HSBC,CitiBank New York,37855,81887,-44032
2011-11-01,HSBC,CitiBank New York,34493,86621,-52128
2011-12-01,HSBC,CitiBank New York,31394,85527,-54133
2012-01-01,HSBC,CitiBank New York,34654,83521,-48867
2012-02-01,HSBC,CitiBank New York,37835,86371,-48536
2012-03-01,HSBC,CitiBank New York,33376,83918,-50542
2012-04-01,HSBC,CitiBank New York,38836,85224,-46388
2012-05-01,HSBC,CitiBank New York,33224,83647,-50423
2012-06-01,HSBC,CitiBank New York,35819,85634,-49815
2012-07-01,HSBC,CitiBank New York,43678,89664,-45986
2012-08-01,HSBC,CitiBank New York,48147,89398,-41251
2012-09-01,HSBC,CitiBank New York,48971,85116,-36145
2012-10-01,HSBC,CitiBank New York,45697,82631,-36934
2012-11-01,HSBC,CitiBank New York,44576,83951,-39375
2012-12-01,HSBC,CitiBank New York,49223,87467,-38244
2013-01-01,HSBC,CitiBank New York,42482,82831,-40349
2013-02-01,HSBC,CitiBank New York,41562,89749,-48187
2013-03-01,HSBC,CitiBank New York,47669,82179,-34510
2013-04-01,HSBC,CitiBank New York,49711,86321,-36610
2013-05-01,HSBC,CitiBank New York,56785,71822,-15037
2013-06-01,HSBC,CitiBank New York,52821,75657,-22836
2013-07-01,HSBC,CitiBank New York,59338,79148,-19810
2013-08-01,HSBC,CitiBank New York,53726,76287,-22561
2013-09-01,HSBC,CitiBank New York,52549,75349,-22800
2013-10-01,HSBC,CitiBank New York,57124,73756,-16632
2013-11-01,HSBC,CitiBank New York,57949,71858,-13909
2013-12-01,HSBC,CitiBank New York,51754,78548,-26794
2014-01-01,HSBC,CitiBank New York,51975,73576,-21601
2014-02-01,HSBC,CitiBank New York,59254,76147,-16893
2014-03-01,HSBC,CitiBank New York,62516,72767,-10251
2014-04-01,HSBC,CitiBank New York,62846,74167,-11321
2014-05-01,HSBC,CitiBank New York,61355,71225,-9870
2014-06-01,HSBC,CitiBank New York,63367,79591,-16224
2014-07-01,HSBC,CitiBank New York,68621,71666,-3045
2014-08-01,HSBC,CitiBank New York,66661,74746,-8085
2014-09-01,HSBC,CitiBank New York,65212,72944,-7732
2014-10-01,HSBC,CitiBank New York,66537,79895,-13358
2014-11-01,HSBC,CitiBank New York,68897,71171,-2274
2014-12-01,HSBC,CitiBank New York,61334,71735,-10401
2015-01-01,HSBC,CitiBank New York,71449,65864,5585
2015-02-01,HSBC,CitiBank New York,78259,68444,9815
2015-03-01,HSBC,CitiBank New York,76544,66435,10109
2015-04-01,HSBC,CitiBank New York,74926,68397,6529
2015-05-01,HSBC,CitiBank New York,75373,61811,13562
2015-06-01,HSBC,CitiBank New York,78249,67488,10761
2015-07-01,HSBC,CitiBank New York,74876,65917,8959
2015-08-01,HSBC,CitiBank New York,78576,61386,17190
2015-09-01,HSBC,CitiBank New York,75817,66887,8930
2015-10-01,HSBC,CitiBank New York,73918,65919,7999
2015-11-01,HSBC,CitiBank New York,83838,64923,18915
2015-12-01,HSBC,CitiBank New York,89433,64362,25071
2016-01-01,HSBC,CitiBank New York,86147,69767,16380
2016-02-01,HSBC,CitiBank New York,82192,66249,15943
2016-03-01,HSBC,CitiBank New York,82269,63738,18531
2016-04-01,HSBC,CitiBank New York,82746,69763,12983
2016-05-01,HSBC,CitiBank New York,81964,64865,17099
2016-06-01,HSBC,CitiBank New York,88212,66533,21679
2016-07-01,HSBC,CitiBank New York,89634,62618,27016
2016-08-01,HSBC,CitiBank New York,87773,62266,25507
2016-09-01,HSBC,CitiBank New York,99764,57754,42010
2016-10-01,HSBC,CitiBank New York,96486,58365,38121
2016-11-01,HSBC,CitiBank New York,99947,53754,46193
2016-12-01,HSBC,CitiBank New York,98646,51481,47165
2017-01-01,HSBC,CitiBank New York,92742,59842,32900
2017-02-01,HSBC,CitiBank New York,98546,58215,40331
2017-03-01,HSBC,CitiBank New York,94371,55614,38757
2017-04-01,HSBC,CitiBank New York,99197,55788,43409
2017-05-01,HSBC,CitiBank New York,94832,52293,42539
2017-06-01,HSBC,CitiBank New York,98256,59317,38939
2017-07-01,HSBC,CitiBank New York,104683,59314,45369
2017-08-01,HSBC,CitiBank New York,103598,55534,48064
2017-09-01,HSBC,CitiBank New York,109534,53881,55653
2017-10-01,HSBC,CitiBank New York,102713,54454,48259
2017-11-01,HSBC,CitiBank New York,109984,57113,52871
2017-12-01,HSBC,CitiBank New York,103899,51389,52510
2018-01-01,HSBC,CitiBank New York,107658,53114,54544
2018-02-01,HSBC,CitiBank New York,106531,59464,47067
2018-03-01,HSBC,CitiBank New York,102954,57951,45003
2018-04-01,HSBC,CitiBank New York,109435,57684,51751
2010-01-01,HSBC,CitiBank London,17797,95257,-77460
2010-02-01,HSBC,CitiBank London,15418,96866,-81448
2010-03-01,HSBC,CitiBank London,19291,93488,-74197
2010-04-01,HSBC,CitiBank London,18483,94597,-76114
2010-05-01,HSBC,CitiBank London,12763,97875,-85112
2010-06-01,HSBC,CitiBank London,13349,94539,-81190
2010-07-01,HSBC,CitiBank London,11146,93144,-81998
2010-08-01,HSBC,CitiBank London,15175,95948,-80773
2010-09-01,HSBC,CitiBank London,11783,94658,-82875
2010-10-01,HSBC,CitiBank London,11978,97822,-85844
2010-11-01,HSBC,CitiBank London,21935,99365,-77430
2010-12-01,HSBC,CitiBank London,27879,99229,-71350
2011-01-01,HSBC,CitiBank London,24148,99671,-75523
2011-02-01,HSBC,CitiBank London,25886,93266,-67380
2011-03-01,HSBC,CitiBank London,26497,99511,-73014
2011-04-01,HSBC,CitiBank London,25672,93822,-68150
2011-05-01,HSBC,CitiBank London,22931,99829,-76898
2011-06-01,HSBC,CitiBank London,27624,91684,-64060
2011-07-01,HSBC,CitiBank London,29543,95777,-66234
2011-08-01,HSBC,CitiBank London,26591,97758,-71167
2011-09-01,HSBC,CitiBank London,39323,82193,-42870
2011-10-01,HSBC,CitiBank London,35313,87426,-52113
2011-11-01,HSBC,CitiBank London,31382,85616,-54234
2011-12-01,HSBC,CitiBank London,38732,87162,-48430
2012-01-01,HSBC,CitiBank London,34954,81264,-46310
2012-02-01,HSBC,CitiBank London,32324,88899,-56575
2012-03-01,HSBC,CitiBank London,34448,83333,-48885
2012-04-01,HSBC,CitiBank London,34563,87236,-52673
2012-05-01,HSBC,CitiBank London,39339,89816,-50477
2012-06-01,HSBC,CitiBank London,32856,86142,-53286
2012-07-01,HSBC,CitiBank London,43952,81288,-37336
2012-08-01,HSBC,CitiBank London,41651,87363,-45712
2012-09-01,HSBC,CitiBank London,44891,89847,-44956
2012-10-01,HSBC,CitiBank London,44396,89699,-45303
2012-11-01,HSBC,CitiBank London,47799,88987,-41188
2012-12-01,HSBC,CitiBank London,49381,84172,-34791
2013-01-01,HSBC,CitiBank London,41689,84278,-42589
2013-02-01,HSBC,CitiBank London,45589,81528,-35939
2013-03-01,HSBC,CitiBank London,47427,88221,-40794
2013-04-01,HSBC,CitiBank London,47756,84341,-36585
2013-05-01,HSBC,CitiBank London,55377,79312,-23935
2013-06-01,HSBC,CitiBank London,52993,72352,-19359
2013-07-01,HSBC,CitiBank London,57495,74512,-17017
2013-08-01,HSBC,CitiBank London,59294,74122,-14828
2013-09-01,HSBC,CitiBank London,55297,76378,-21081
2013-10-01,HSBC,CitiBank London,52397,74131,-21734
2013-11-01,HSBC,CitiBank London,51992,76979,-24987
2013-12-01,HSBC,CitiBank London,52322,72416,-20094
2014-01-01,HSBC,CitiBank London,56118,79114,-22996
2014-02-01,HSBC,CitiBank London,56494,79458,-22964
2014-03-01,HSBC,CitiBank London,66578,77424,-10846
2014-04-01,HSBC,CitiBank London,65857,78388,-12531
2014-05-01,HSBC,CitiBank London,69785,71788,-2003
2014-06-01,HSBC,CitiBank London,61254,74119,-12865
2014-07-01,HSBC,CitiBank London,67913,71928,-4015
2014-08-01,HSBC,CitiBank London,67425,77227,-9802
2014-09-01,HSBC,CitiBank London,66952,71979,-5027
2014-10-01,HSBC,CitiBank London,64271,73121,-8850
2014-11-01,HSBC,CitiBank London,64259,78759,-14500
2014-12-01,HSBC,CitiBank London,68657,71982,-3325
2015-01-01,HSBC,CitiBank London,72482,64659,7823
2015-02-01,HSBC,CitiBank London,72723,61738,10985
2015-03-01,HSBC,CitiBank London,75897,69243,6654
2015-04-01,HSBC,CitiBank London,79949,68387,11562
2015-05-01,HSBC,CitiBank London,76619,68666,7953
2015-06-01,HSBC,CitiBank London,77226,65549,11677
2015-07-01,HSBC,CitiBank London,75494,67873,7621
2015-08-01,HSBC,CitiBank London,76379,69756,6623
2015-09-01,HSBC,CitiBank London,76927,65911,11016
2015-10-01,HSBC,CitiBank London,72816,62981,9835
2015-11-01,HSBC,CitiBank London,89922,68888,21034
2015-12-01,HSBC,CitiBank London,88998,62797,26201
2016-01-01,HSBC,CitiBank London,88898,62991,25907
2016-02-01,HSBC,CitiBank London,85185,64381,20804
2016-03-01,HSBC,CitiBank London,86694,67638,19056
2016-04-01,HSBC,CitiBank London,86766,65964,20802
2016-05-01,HSBC,CitiBank London,85561,63662,21899
2016-06-01,HSBC,CitiBank London,85612,63494,22118
2016-07-01,HSBC,CitiBank London,81557,68895,12662
2016-08-01,HSBC,CitiBank London,84247,61483,22764
2016-09-01,HSBC,CitiBank London,99716,55581,44135
2016-10-01,HSBC,CitiBank London,95396,59371,36025
2016-11-01,HSBC,CitiBank London,94334,54595,39739
2016-12-01,HSBC,CitiBank London,93694,55742,37952
2017-01-01,HSBC,CitiBank London,93119,59263,33856
2017-02-01,HSBC,CitiBank London,96638,57899,38739
2017-03-01,HSBC,CitiBank London,93419,53613,39806
2017-04-01,HSBC,CitiBank London,96265,51713,44552
2017-05-01,HSBC,CitiBank London,91132,58753,32379
2017-06-01,HSBC,CitiBank London,95751,54637,41114
2017-07-01,HSBC,CitiBank London,109937,59264,50673
2017-08-01,HSBC,CitiBank London,108831,55865,52966
2017-09-01,HSBC,CitiBank London,108336,53339,54997
2017-10-01,HSBC,CitiBank London,109669,55212,54457
2017-11-01,HSBC,CitiBank London,101796,53414,48382
2017-12-01,HSBC,CitiBank London,105799,57358,48441
2018-01-01,HSBC,CitiBank London,104269,53268,51001
2018-02-01,HSBC,CitiBank London,106866,54355,52511
2018-03-01,HSBC,CitiBank London,106958,54279,52679
2018-04-01,HSBC,CitiBank London,101182,53781,47401
2010-01-01,HSBC,CitiBank Pune,12332,93456,-81124
2010-02-01,HSBC,CitiBank Pune,15712,96793,-81081
2010-03-01,HSBC,CitiBank Pune,16689,95362,-78673
2010-04-01,HSBC,CitiBank Pune,12118,99827,-87709
2010-05-01,HSBC,CitiBank Pune,13913,94494,-80581
2010-06-01,HSBC,CitiBank Pune,16645,95649,-79004
2010-07-01,HSBC,CitiBank Pune,15666,92123,-76457
2010-08-01,HSBC,CitiBank Pune,18391,97549,-79158
2010-09-01,HSBC,CitiBank Pune,14143,99411,-85268
2010-10-01,HSBC,CitiBank Pune,17431,92627,-75196
2010-11-01,HSBC,CitiBank Pune,24844,96374,-71530
2010-12-01,HSBC,CitiBank Pune,21625,98324,-76699
2011-01-01,HSBC,CitiBank Pune,24715,97181,-72466
2011-02-01,HSBC,CitiBank Pune,22293,97638,-75345
2011-03-01,HSBC,CitiBank Pune,29548,98256,-68708
2011-04-01,HSBC,CitiBank Pune,23379,99489,-76110
2011-05-01,HSBC,CitiBank Pune,27836,96412,-68576
2011-06-01,HSBC,CitiBank Pune,22992,91454,-68462
2011-07-01,HSBC,CitiBank Pune,28957,91952,-62995
2011-08-01,HSBC,CitiBank Pune,25757,92723,-66966
2011-09-01,HSBC,CitiBank Pune,35222,89168,-53946
2011-10-01,HSBC,CitiBank Pune,31643,82392,-50749
2011-11-01,HSBC,CitiBank Pune,31563,81636,-50073
2011-12-01,HSBC,CitiBank Pune,33743,84975,-51232
2012-01-01,HSBC,CitiBank Pune,38217,83648,-45431
2012-02-01,HSBC,CitiBank Pune,33132,82176,-49044
2012-03-01,HSBC,CitiBank Pune,37232,87796,-50564
2012-04-01,HSBC,CitiBank Pune,38869,82411,-43542
2012-05-01,HSBC,CitiBank Pune,35579,83796,-48217
2012-06-01,HSBC,CitiBank Pune,38645,88115,-49470
2012-07-01,HSBC,CitiBank Pune,41813,87437,-45624
2012-08-01,HSBC,CitiBank Pune,47354,89357,-42003
2012-09-01,HSBC,CitiBank Pune,49497,82218,-32721
2012-10-01,HSBC,CitiBank Pune,47515,84788,-37273
2012-11-01,HSBC,CitiBank Pune,45329,88643,-43314
2012-12-01,HSBC,CitiBank Pune,45411,88221,-42810
2013-01-01,HSBC,CitiBank Pune,45971,82457,-36486
2013-02-01,HSBC,CitiBank Pune,41697,89144,-47447
2013-03-01,HSBC,CitiBank Pune,46979,89855,-42876
2013-04-01,HSBC,CitiBank Pune,42844,84126,-41282
2013-05-01,HSBC,CitiBank Pune,59267,79718,-20451
2013-06-01,HSBC,CitiBank Pune,53858,73986,-20128
2013-07-01,HSBC,CitiBank Pune,52588,78259,-25671
2013-08-01,HSBC,CitiBank Pune,56381,74188,-17807
2013-09-01,HSBC,CitiBank Pune,57157,78239,-21082
2013-10-01,HSBC,CitiBank Pune,53835,74354,-20519
2013-11-01,HSBC,CitiBank Pune,56847,74335,-17488
2013-12-01,HSBC,CitiBank Pune,59138,71615,-12477
2014-01-01,HSBC,CitiBank Pune,54366,78419,-24053
2014-02-01,HSBC,CitiBank Pune,58344,73879,-15535
2014-03-01,HSBC,CitiBank Pune,66836,73142,-6306
2014-04-01,HSBC,CitiBank Pune,64277,78272,-13995
2014-05-01,HSBC,CitiBank Pune,61943,71134,-9191
2014-06-01,HSBC,CitiBank Pune,65167,72416,-7249
2014-07-01,HSBC,CitiBank Pune,62193,73126,-10933
2014-08-01,HSBC,CitiBank Pune,61934,71831,-9897
2014-09-01,HSBC,CitiBank Pune,67458,73988,-6530
2014-10-01,HSBC,CitiBank Pune,65778,71794,-6016
2014-11-01,HSBC,CitiBank Pune,62695,71574,-8879
2014-12-01,HSBC,CitiBank Pune,61288,76981,-15693
2015-01-01,HSBC,CitiBank Pune,76927,69411,7516
2015-02-01,HSBC,CitiBank Pune,75246,66733,8513
2015-03-01,HSBC,CitiBank Pune,77435,68188,9247
2015-04-01,HSBC,CitiBank Pune,71941,67849,4092
2015-05-01,HSBC,CitiBank Pune,76414,64893,11521
2015-06-01,HSBC,CitiBank Pune,77919,64561,13358
2015-07-01,HSBC,CitiBank Pune,78963,66278,12685
2015-08-01,HSBC,CitiBank Pune,79227,69858,9369
2015-09-01,HSBC,CitiBank Pune,77312,67691,9621
2015-10-01,HSBC,CitiBank Pune,74954,66414,8540
2015-11-01,HSBC,CitiBank Pune,88225,61998,26227
2015-12-01,HSBC,CitiBank Pune,82557,66932,15625
2016-01-01,HSBC,CitiBank Pune,86768,67441,19327
2016-02-01,HSBC,CitiBank Pune,82161,68816,13345
2016-03-01,HSBC,CitiBank Pune,88213,68167,20046
2016-04-01,HSBC,CitiBank Pune,89242,67843,21399
2016-05-01,HSBC,CitiBank Pune,84986,62985,22001
2016-06-01,HSBC,CitiBank Pune,85783,67957,17826
2016-07-01,HSBC,CitiBank Pune,86267,68621,17646
2016-08-01,HSBC,CitiBank Pune,87623,69266,18357
2016-09-01,HSBC,CitiBank Pune,93639,58413,35226
2016-10-01,HSBC,CitiBank Pune,98822,56679,42143
2016-11-01,HSBC,CitiBank Pune,98653,53864,44789
2016-12-01,HSBC,CitiBank Pune,96694,51436,45258
2017-01-01,HSBC,CitiBank Pune,94793,56972,37821
2017-02-01,HSBC,CitiBank Pune,91929,56826,35103
2017-03-01,HSBC,CitiBank Pune,91772,58386,33386
2017-04-01,HSBC,CitiBank Pune,96238,57459,38779
2017-05-01,HSBC,CitiBank Pune,92645,59573,33072
2017-06-01,HSBC,CitiBank Pune,92354,55836,36518
2017-07-01,HSBC,CitiBank Pune,103978,56954,47024
2017-08-01,HSBC,CitiBank Pune,103363,53193,50170
2017-09-01,HSBC,CitiBank Pune,102284,57864,44420
2017-10-01,HSBC,CitiBank Pune,103125,55248,47877
2017-11-01,HSBC,CitiBank Pune,103496,56373,47123
2017-12-01,HSBC,CitiBank Pune,108611,54458,54153
2018-01-01,HSBC,CitiBank Pune,109554,56686,52868
2018-02-01,HSBC,CitiBank Pune,102838,56418,46420
2018-03-01,HSBC,CitiBank Pune,107195,54787,52408
2018-04-01,HSBC,CitiBank Pune,107914,59658,48256
2010-01-01,HSBC,CitiBank Singapore,19531,97484,-77953
2010-02-01,HSBC,CitiBank Singapore,13215,93239,-80024
2010-03-01,HSBC,CitiBank Singapore,19866,91722,-71856
2010-04-01,HSBC,CitiBank Singapore,18116,97325,-79209
2010-05-01,HSBC,CitiBank Singapore,11116,95648,-84532
2010-06-01,HSBC,CitiBank Singapore,17159,91419,-74260
2010-07-01,HSBC,CitiBank Singapore,17517,95612,-78095
2010-08-01,HSBC,CitiBank Singapore,16497,95376,-78879
2010-09-01,HSBC,CitiBank Singapore,13598,92468,-78870
2010-10-01,HSBC,CitiBank Singapore,14264,92241,-77977
2010-11-01,HSBC,CitiBank Singapore,25393,92266,-66873
2010-12-01,HSBC,CitiBank Singapore,24997,93157,-68160
2011-01-01,HSBC,CitiBank Singapore,25735,93387,-67652
2011-02-01,HSBC,CitiBank Singapore,22999,94148,-71149
2011-03-01,HSBC,CitiBank Singapore,25591,99215,-73624
2011-04-01,HSBC,CitiBank Singapore,22433,97274,-74841
2011-05-01,HSBC,CitiBank Singapore,29922,91878,-61956
2011-06-01,HSBC,CitiBank Singapore,21539,96595,-75056
2011-07-01,HSBC,CitiBank Singapore,26937,95278,-68341
2011-08-01,HSBC,CitiBank Singapore,24749,96959,-72210
2011-09-01,HSBC,CitiBank Singapore,34377,85867,-51490
2011-10-01,HSBC,CitiBank Singapore,39297,87154,-47857
2011-11-01,HSBC,CitiBank Singapore,35436,88421,-52985
2011-12-01,HSBC,CitiBank Singapore,38726,81688,-42962
2012-01-01,HSBC,CitiBank Singapore,35329,82734,-47405
2012-02-01,HSBC,CitiBank Singapore,39849,81238,-41389
2012-03-01,HSBC,CitiBank Singapore,35887,86897,-51010
2012-04-01,HSBC,CitiBank Singapore,33776,83111,-49335
2012-05-01,HSBC,CitiBank Singapore,39714,81378,-41664
2012-06-01,HSBC,CitiBank Singapore,32184,89238,-57054
2012-07-01,HSBC,CitiBank Singapore,49391,85524,-36133
2012-08-01,HSBC,CitiBank Singapore,42589,87581,-44992
2012-09-01,HSBC,CitiBank Singapore,44246,85514,-41268
2012-10-01,HSBC,CitiBank Singapore,45938,89261,-43323
2012-11-01,HSBC,CitiBank Singapore,42149,84976,-42827
2012-12-01,HSBC,CitiBank Singapore,44764,86744,-41980
2013-01-01,HSBC,CitiBank Singapore,44983,88217,-43234
2013-02-01,HSBC,CitiBank Singapore,48273,87529,-39256
2013-03-01,HSBC,CitiBank Singapore,49794,82119,-32325
2013-04-01,HSBC,CitiBank Singapore,46795,85424,-38629
2013-05-01,HSBC,CitiBank Singapore,57493,78469,-20976
2013-06-01,HSBC,CitiBank Singapore,51545,71388,-19843
2013-07-01,HSBC,CitiBank Singapore,52421,75963,-23542
2013-08-01,HSBC,CitiBank Singapore,53233,78747,-25514
2013-09-01,HSBC,CitiBank Singapore,59377,76928,-17551
2013-10-01,HSBC,CitiBank Singapore,52196,79827,-27631
2013-11-01,HSBC,CitiBank Singapore,56834,73661,-16827
2013-12-01,HSBC,CitiBank Singapore,57815,79842,-22027
2014-01-01,HSBC,CitiBank Singapore,54565,79458,-24893
2014-02-01,HSBC,CitiBank Singapore,59972,75943,-15971
2014-03-01,HSBC,CitiBank Singapore,67855,73658,-5803
2014-04-01,HSBC,CitiBank Singapore,65925,73889,-7964
2014-05-01,HSBC,CitiBank Singapore,68521,76714,-8193
2014-06-01,HSBC,CitiBank Singapore,62268,74125,-11857
2014-07-01,HSBC,CitiBank Singapore,61136,73544,-12408
2014-08-01,HSBC,CitiBank Singapore,68715,77452,-8737
2014-09-01,HSBC,CitiBank Singapore,61561,79273,-17712
2014-10-01,HSBC,CitiBank Singapore,69685,76954,-7269
2014-11-01,HSBC,CitiBank Singapore,67491,72732,-5241
2014-12-01,HSBC,CitiBank Singapore,63111,78433,-15322
2015-01-01,HSBC,CitiBank Singapore,74648,66654,7994
2015-02-01,HSBC,CitiBank Singapore,79775,69571,10204
2015-03-01,HSBC,CitiBank Singapore,73836,65134,8702
2015-04-01,HSBC,CitiBank Singapore,74646,67566,7080
2015-05-01,HSBC,CitiBank Singapore,75536,64112,11424
2015-06-01,HSBC,CitiBank Singapore,73685,63221,10464
2015-07-01,HSBC,CitiBank Singapore,74416,62593,11823
2015-08-01,HSBC,CitiBank Singapore,76872,65554,11318
2015-09-01,HSBC,CitiBank Singapore,74757,68352,6405
2015-10-01,HSBC,CitiBank Singapore,72175,61334,10841
2015-11-01,HSBC,CitiBank Singapore,82799,62177,20622
2015-12-01,HSBC,CitiBank Singapore,88919,62439,26480
2016-01-01,HSBC,CitiBank Singapore,82917,69314,13603
2016-02-01,HSBC,CitiBank Singapore,87486,66451,21035
2016-03-01,HSBC,CitiBank Singapore,81383,69292,12091
2016-04-01,HSBC,CitiBank Singapore,81551,66243,15308
2016-05-01,HSBC,CitiBank Singapore,82777,66582,16195
2016-06-01,HSBC,CitiBank Singapore,82225,67552,14673
2016-07-01,HSBC,CitiBank Singapore,85431,61297,24134
2016-08-01,HSBC,CitiBank Singapore,88164,61724,26440
2016-09-01,HSBC,CitiBank Singapore,99949,58738,41211
2016-10-01,HSBC,CitiBank Singapore,98934,55387,43547
2016-11-01,HSBC,CitiBank Singapore,95951,53959,41992
2016-12-01,HSBC,CitiBank Singapore,97261,55873,41388
2017-01-01,HSBC,CitiBank Singapore,93661,55418,38243
2017-02-01,HSBC,CitiBank Singapore,93766,55235,38531
2017-03-01,HSBC,CitiBank Singapore,93587,58531,35056
2017-04-01,HSBC,CitiBank Singapore,94852,59649,35203
2017-05-01,HSBC,CitiBank Singapore,94782,52479,42303
2017-06-01,HSBC,CitiBank Singapore,96135,59561,36574
2017-07-01,HSBC,CitiBank Singapore,102662,59661,43001
2017-08-01,HSBC,CitiBank Singapore,106823,56424,50399
2017-09-01,HSBC,CitiBank Singapore,102139,53622,48517
2017-10-01,HSBC,CitiBank Singapore,106318,53158,53160
2017-11-01,HSBC,CitiBank Singapore,106624,59159,47465
2017-12-01,HSBC,CitiBank Singapore,108329,58535,49794
2018-01-01,HSBC,CitiBank Singapore,109997,51179,58818
2018-02-01,HSBC,CitiBank Singapore,104778,55297,49481
2018-03-01,HSBC,CitiBank Singapore,104349,51696,52653
2018-04-01,HSBC,CitiBank Singapore,107522,59741,47781
2010-01-01,HSBC,CitiBank HongKong,14468,98293,-83825
2010-02-01,HSBC,CitiBank HongKong,12727,93744,-81017
2010-03-01,HSBC,CitiBank HongKong,11576,95994,-84418
2010-04-01,HSBC,CitiBank HongKong,17825,91199,-73374
2010-05-01,HSBC,CitiBank HongKong,12119,91668,-79549
2010-06-01,HSBC,CitiBank HongKong,14629,99165,-84536
2010-07-01,HSBC,CitiBank HongKong,19116,95211,-76095
2010-08-01,HSBC,CitiBank HongKong,17462,91369,-73907
2010-09-01,HSBC,CitiBank HongKong,13832,94755,-80923
2010-10-01,HSBC,CitiBank HongKong,15853,99462,-83609
2010-11-01,HSBC,CitiBank HongKong,22112,96511,-74399
2010-12-01,HSBC,CitiBank HongKong,23999,96968,-72969
2011-01-01,HSBC,CitiBank HongKong,21987,98728,-76741
2011-02-01,HSBC,CitiBank HongKong,25721,92364,-66643
2011-03-01,HSBC,CitiBank HongKong,26439,98258,-71819
2011-04-01,HSBC,CitiBank HongKong,29857,95415,-65558
2011-05-01,HSBC,CitiBank HongKong,24847,99481,-74634
2011-06-01,HSBC,CitiBank HongKong,28677,91393,-62716
2011-07-01,HSBC,CitiBank HongKong,26166,92558,-66392
2011-08-01,HSBC,CitiBank HongKong,24915,92283,-67368
2011-09-01,HSBC,CitiBank HongKong,33682,87455,-53773
2011-10-01,HSBC,CitiBank HongKong,38544,85993,-47449
2011-11-01,HSBC,CitiBank HongKong,33674,81493,-47819
2011-12-01,HSBC,CitiBank HongKong,39199,86821,-47622
2012-01-01,HSBC,CitiBank HongKong,37472,83528,-46056
2012-02-01,HSBC,CitiBank HongKong,34372,81382,-47010
2012-03-01,HSBC,CitiBank HongKong,37482,89589,-52107
2012-04-01,HSBC,CitiBank HongKong,34161,87262,-53101
2012-05-01,HSBC,CitiBank HongKong,37716,81228,-43512
2012-06-01,HSBC,CitiBank HongKong,36111,86464,-50353
2012-07-01,HSBC,CitiBank HongKong,42131,85571,-43440
2012-08-01,HSBC,CitiBank HongKong,45396,85743,-40347
2012-09-01,HSBC,CitiBank HongKong,41224,84967,-43743
2012-10-01,HSBC,CitiBank HongKong,43767,88497,-44730
2012-11-01,HSBC,CitiBank HongKong,49817,86455,-36638
2012-12-01,HSBC,CitiBank HongKong,45758,89927,-44169
2013-01-01,HSBC,CitiBank HongKong,44831,89139,-44308
2013-02-01,HSBC,CitiBank HongKong,41382,81445,-40063
2013-03-01,HSBC,CitiBank HongKong,49611,81153,-31542
2013-04-01,HSBC,CitiBank HongKong,44461,84329,-39868
2013-05-01,HSBC,CitiBank HongKong,57487,77478,-19991
2013-06-01,HSBC,CitiBank HongKong,58896,73864,-14968
2013-07-01,HSBC,CitiBank HongKong,51844,76756,-24912
2013-08-01,HSBC,CitiBank HongKong,54637,72678,-18041
2013-09-01,HSBC,CitiBank HongKong,52314,74697,-22383
2013-10-01,HSBC,CitiBank HongKong,56932,72839,-15907
2013-11-01,HSBC,CitiBank HongKong,52389,72638,-20249
2013-12-01,HSBC,CitiBank HongKong,54129,74237,-20108
2014-01-01,HSBC,CitiBank HongKong,51945,73566,-21621
2014-02-01,HSBC,CitiBank HongKong,57745,72682,-14937
2014-03-01,HSBC,CitiBank HongKong,63527,79492,-15965
2014-04-01,HSBC,CitiBank HongKong,65221,74719,-9498
2014-05-01,HSBC,CitiBank HongKong,65186,73615,-8429
2014-06-01,HSBC,CitiBank HongKong,65869,79313,-13444
2014-07-01,HSBC,CitiBank HongKong,66532,71786,-5254
2014-08-01,HSBC,CitiBank HongKong,65946,76176,-10230
2014-09-01,HSBC,CitiBank HongKong,62269,72232,-9963
2014-10-01,HSBC,CitiBank HongKong,68533,75974,-7441
2014-11-01,HSBC,CitiBank HongKong,62373,77519,-15146
2014-12-01,HSBC,CitiBank HongKong,65224,76513,-11289
2015-01-01,HSBC,CitiBank HongKong,77436,62591,14845
2015-02-01,HSBC,CitiBank HongKong,76764,69373,7391
2015-03-01,HSBC,CitiBank HongKong,74794,65912,8882
2015-04-01,HSBC,CitiBank HongKong,78871,66679,12192
2015-05-01,HSBC,CitiBank HongKong,72763,67111,5652
2015-06-01,HSBC,CitiBank HongKong,71623,61784,9839
2015-07-01,HSBC,CitiBank HongKong,79394,67344,12050
2015-08-01,HSBC,CitiBank HongKong,78736,64851,13885
2015-09-01,HSBC,CitiBank HongKong,78754,65121,13633
2015-10-01,HSBC,CitiBank HongKong,74895,67582,7313
2015-11-01,HSBC,CitiBank HongKong,82231,64593,17638
2015-12-01,HSBC,CitiBank HongKong,85751,61224,24527
2016-01-01,HSBC,CitiBank HongKong,82369,68598,13771
2016-02-01,HSBC,CitiBank HongKong,85456,61589,23867
2016-03-01,HSBC,CitiBank HongKong,81794,66984,14810
2016-04-01,HSBC,CitiBank HongKong,89265,62235,27030
2016-05-01,HSBC,CitiBank HongKong,89121,66363,22758
2016-06-01,HSBC,CitiBank HongKong,82385,63681,18704
2016-07-01,HSBC,CitiBank HongKong,81972,61155,20817
2016-08-01,HSBC,CitiBank HongKong,89784,66476,23308
2016-09-01,HSBC,CitiBank HongKong,95657,56462,39195
2016-10-01,HSBC,CitiBank HongKong,95716,57244,38472
2016-11-01,HSBC,CitiBank HongKong,96416,56291,40125
2016-12-01,HSBC,CitiBank HongKong,95773,53168,42605
2017-01-01,HSBC,CitiBank HongKong,98198,54486,43712
2017-02-01,HSBC,CitiBank HongKong,94271,52569,41702
2017-03-01,HSBC,CitiBank HongKong,92691,51343,41348
2017-04-01,HSBC,CitiBank HongKong,98538,51445,47093
2017-05-01,HSBC,CitiBank HongKong,96189,55164,41025
2017-06-01,HSBC,CitiBank HongKong,96882,57798,39084
2017-07-01,HSBC,CitiBank HongKong,108554,56592,51962
2017-08-01,HSBC,CitiBank HongKong,106731,59889,46842
2017-09-01,HSBC,CitiBank HongKong,108691,55728,52963
2017-10-01,HSBC,CitiBank HongKong,105258,58482,46776
2017-11-01,HSBC,CitiBank HongKong,106923,58675,48248
2017-12-01,HSBC,CitiBank HongKong,104222,53263,50959
2018-01-01,HSBC,CitiBank HongKong,109281,58393,50888
2018-02-01,HSBC,CitiBank HongKong,102656,54181,48475
2018-03-01,HSBC,CitiBank HongKong,105791,54194,51597
2018-04-01,HSBC,CitiBank HongKong,101348,57453,43895
2010-01-01,BNY Mellon,CitiBank New York,16598,93192,-76594
2010-02-01,BNY Mellon,CitiBank New York,14352,91171,-76819
2010-03-01,BNY Mellon,CitiBank New York,13883,91673,-77790
2010-04-01,BNY Mellon,CitiBank New York,13393,94861,-81468
2010-05-01,BNY Mellon,CitiBank New York,16421,96596,-80175
2010-06-01,BNY Mellon,CitiBank New York,18382,98671,-80289
2010-07-01,BNY Mellon,CitiBank New York,16712,94243,-77531
2010-08-01,BNY Mellon,CitiBank New York,19836,92648,-72812
2010-09-01,BNY Mellon,CitiBank New York,13821,93546,-79725
2010-10-01,BNY Mellon,CitiBank New York,14791,92117,-77326
2010-11-01,BNY Mellon,CitiBank New York,24268,94574,-70306
2010-12-01,BNY Mellon,CitiBank New York,29234,95923,-66689
2011-01-01,BNY Mellon,CitiBank New York,21185,98839,-77654
2011-02-01,BNY Mellon,CitiBank New York,21553,97641,-76088
2011-03-01,BNY Mellon,CitiBank New York,22564,97186,-74622
2011-04-01,BNY Mellon,CitiBank New York,26264,97681,-71417
2011-05-01,BNY Mellon,CitiBank New York,24446,91779,-67333
2011-06-01,BNY Mellon,CitiBank New York,28712,99756,-71044
2011-07-01,BNY Mellon,CitiBank New York,23741,92672,-68931
2011-08-01,BNY Mellon,CitiBank New York,25619,97753,-72134
2011-09-01,BNY Mellon,CitiBank New York,35288,85325,-50037
2011-10-01,BNY Mellon,CitiBank New York,36835,86391,-49556
2011-11-01,BNY Mellon,CitiBank New York,31733,88857,-57124
2011-12-01,BNY Mellon,CitiBank New York,36199,86674,-50475
2012-01-01,BNY Mellon,CitiBank New York,31468,81635,-50167
2012-02-01,BNY Mellon,CitiBank New York,37273,88311,-51038
2012-03-01,BNY Mellon,CitiBank New York,32646,86567,-53921
2012-04-01,BNY Mellon,CitiBank New York,33623,87428,-53805
2012-05-01,BNY Mellon,CitiBank New York,34466,87186,-52720
2012-06-01,BNY Mellon,CitiBank New York,33227,84266,-51039
2012-07-01,BNY Mellon,CitiBank New York,49513,83538,-34025
2012-08-01,BNY Mellon,CitiBank New York,44554,83672,-39118
2012-09-01,BNY Mellon,CitiBank New York,41829,86563,-44734
2012-10-01,BNY Mellon,CitiBank New York,44218,81741,-37523
2012-11-01,BNY Mellon,CitiBank New York,41587,83723,-42136
2012-12-01,BNY Mellon,CitiBank New York,44627,87785,-43158
2013-01-01,BNY Mellon,CitiBank New York,41389,83818,-42429
2013-02-01,BNY Mellon,CitiBank New York,45264,83341,-38077
2013-03-01,BNY Mellon,CitiBank New York,41166,83817,-42651
2013-04-01,BNY Mellon,CitiBank New York,47736,89759,-42023
2013-05-01,BNY Mellon,CitiBank New York,54182,77427,-23245
2013-06-01,BNY Mellon,CitiBank New York,56142,77273,-21131
2013-07-01,BNY Mellon,CitiBank New York,59875,77616,-17741
2013-08-01,BNY Mellon,CitiBank New York,56321,78513,-22192
2013-09-01,BNY Mellon,CitiBank New York,51845,76838,-24993
2013-10-01,BNY Mellon,CitiBank New York,54994,78714,-23720
2013-11-01,BNY Mellon,CitiBank New York,59422,79654,-20232
2013-12-01,BNY Mellon,CitiBank New York,57496,78629,-21133
2014-01-01,BNY Mellon,CitiBank New York,57892,79216,-21324
2014-02-01,BNY Mellon,CitiBank New York,55488,73116,-17628
2014-03-01,BNY Mellon,CitiBank New York,61678,76248,-14570
2014-04-01,BNY Mellon,CitiBank New York,69528,77538,-8010
2014-05-01,BNY Mellon,CitiBank New York,62611,78257,-15646
2014-06-01,BNY Mellon,CitiBank New York,64787,72482,-7695
2014-07-01,BNY Mellon,CitiBank New York,63691,72396,-8705
2014-08-01,BNY Mellon,CitiBank New York,62715,77931,-15216
2014-09-01,BNY Mellon,CitiBank New York,66324,77817,-11493
2014-10-01,BNY Mellon,CitiBank New York,61847,74962,-13115
2014-11-01,BNY Mellon,CitiBank New York,65273,73538,-8265
2014-12-01,BNY Mellon,CitiBank New York,62521,74565,-12044
2015-01-01,BNY Mellon,CitiBank New York,76774,68386,8388
2015-02-01,BNY Mellon,CitiBank New York,71283,64173,7110
2015-03-01,BNY Mellon,CitiBank New York,72684,68375,4309
2015-04-01,BNY Mellon,CitiBank New York,71644,61578,10066
2015-05-01,BNY Mellon,CitiBank New York,72312,68251,4061
2015-06-01,BNY Mellon,CitiBank New York,74671,68294,6377
2015-07-01,BNY Mellon,CitiBank New York,75794,67329,8465
2015-08-01,BNY Mellon,CitiBank New York,71118,66544,4574
2015-09-01,BNY Mellon,CitiBank New York,73936,63214,10722
2015-10-01,BNY Mellon,CitiBank New York,77169,65986,11183
2015-11-01,BNY Mellon,CitiBank New York,87661,64944,22717
2015-12-01,BNY Mellon,CitiBank New York,88693,69466,19227
2016-01-01,BNY Mellon,CitiBank New York,82579,67263,15316
2016-02-01,BNY Mellon,CitiBank New York,84915,66454,18461
2016-03-01,BNY Mellon,CitiBank New York,87169,69454,17715
2016-04-01,BNY Mellon,CitiBank New York,83248,68891,14357
2016-05-01,BNY Mellon,CitiBank New York,89923,61538,28385
2016-06-01,BNY Mellon,CitiBank New York,81588,66368,15220
2016-07-01,BNY Mellon,CitiBank New York,85254,69684,15570
2016-08-01,BNY Mellon,CitiBank New York,85482,61842,23640
2016-09-01,BNY Mellon,CitiBank New York,91281,55232,36049
2016-10-01,BNY Mellon,CitiBank New York,98729,53915,44814
2016-11-01,BNY Mellon,CitiBank New York,92758,56822,35936
2016-12-01,BNY Mellon,CitiBank New York,92577,54437,38140
2017-01-01,BNY Mellon,CitiBank New York,96516,56233,40283
2017-02-01,BNY Mellon,CitiBank New York,92662,51521,41141
2017-03-01,BNY Mellon,CitiBank New York,95146,59771,35375
2017-04-01,BNY Mellon,CitiBank New York,91725,56426,35299
2017-05-01,BNY Mellon,CitiBank New York,99834,55759,44075
2017-06-01,BNY Mellon,CitiBank New York,97162,59534,37628
2017-07-01,BNY Mellon,CitiBank New York,105394,55399,49995
2017-08-01,BNY Mellon,CitiBank New York,103973,58627,45346
2017-09-01,BNY Mellon,CitiBank New York,107237,58696,48541
2017-10-01,BNY Mellon,CitiBank New York,103411,57137,46274
2017-11-01,BNY Mellon,CitiBank New York,102738,57316,45422
2017-12-01,BNY Mellon,CitiBank New York,106569,59457,47112
2018-01-01,BNY Mellon,CitiBank New York,104386,52596,51790
2018-02-01,BNY Mellon,CitiBank New York,104763,53762,51001
2018-03-01,BNY Mellon,CitiBank New York,108491,51981,56510
2018-04-01,BNY Mellon,CitiBank New York,104621,55458,49163
2010-01-01,BNY Mellon,CitiBank London,13214,98963,-85749
2010-02-01,BNY Mellon,CitiBank London,18596,97395,-78799
2010-03-01,BNY Mellon,CitiBank London,15589,95966,-80377
2010-04-01,BNY Mellon,CitiBank London,17299,96683,-79384
2010-05-01,BNY Mellon,CitiBank London,16365,91136,-74771
2010-06-01,BNY Mellon,CitiBank London,17969,96835,-78866
2010-07-01,BNY Mellon,CitiBank London,15186,98537,-83351
2010-08-01,BNY Mellon,CitiBank London,11481,97763,-86282
2010-09-01,BNY Mellon,CitiBank London,11669,94939,-83270
2010-10-01,BNY Mellon,CitiBank London,14676,92744,-78068
2010-11-01,BNY Mellon,CitiBank London,25511,97843,-72332
2010-12-01,BNY Mellon,CitiBank London,26981,97795,-70814
2011-01-01,BNY Mellon,CitiBank London,25736,94811,-69075
2011-02-01,BNY Mellon,CitiBank London,28129,97767,-69638
2011-03-01,BNY Mellon,CitiBank London,23867,99991,-76124
2011-04-01,BNY Mellon,CitiBank London,29928,92152,-62224
2011-05-01,BNY Mellon,CitiBank London,26987,93261,-66274
2011-06-01,BNY Mellon,CitiBank London,23131,95455,-72324
2011-07-01,BNY Mellon,CitiBank London,24726,97891,-73165
2011-08-01,BNY Mellon,CitiBank London,27877,95349,-67472
2011-09-01,BNY Mellon,CitiBank London,39392,88125,-48733
2011-10-01,BNY Mellon,CitiBank London,36318,87689,-51371
2011-11-01,BNY Mellon,CitiBank London,37785,84848,-47063
2011-12-01,BNY Mellon,CitiBank London,37156,87348,-50192
2012-01-01,BNY Mellon,CitiBank London,31753,83511,-51758
2012-02-01,BNY Mellon,CitiBank London,39273,81916,-42643
2012-03-01,BNY Mellon,CitiBank London,39823,89227,-49404
2012-04-01,BNY Mellon,CitiBank London,38634,83423,-44789
2012-05-01,BNY Mellon,CitiBank London,35162,87823,-52661
2012-06-01,BNY Mellon,CitiBank London,35413,88235,-52822
2012-07-01,BNY Mellon,CitiBank London,44463,84651,-40188
2012-08-01,BNY Mellon,CitiBank London,49617,84653,-35036
2012-09-01,BNY Mellon,CitiBank London,41922,84254,-42332
2012-10-01,BNY Mellon,CitiBank London,45721,83534,-37813
2012-11-01,BNY Mellon,CitiBank London,42717,86176,-43459
2012-12-01,BNY Mellon,CitiBank London,48624,87444,-38820
2013-01-01,BNY Mellon,CitiBank London,43473,86964,-43491
2013-02-01,BNY Mellon,CitiBank London,44573,88659,-44086
2013-03-01,BNY Mellon,CitiBank London,41438,86878,-45440
2013-04-01,BNY Mellon,CitiBank London,44679,83622,-38943
2013-05-01,BNY Mellon,CitiBank London,53225,73368,-20143
2013-06-01,BNY Mellon,CitiBank London,56347,78523,-22176
2013-07-01,BNY Mellon,CitiBank London,58429,71819,-13390
2013-08-01,BNY Mellon,CitiBank London,55118,74497,-19379
2013-09-01,BNY Mellon,CitiBank London,59174,74761,-15587
2013-10-01,BNY Mellon,CitiBank London,55882,77842,-21960
2013-11-01,BNY Mellon,CitiBank London,58693,77842,-19149
2013-12-01,BNY Mellon,CitiBank London,54411,72323,-17912
2014-01-01,BNY Mellon,CitiBank London,58243,75688,-17445
2014-02-01,BNY Mellon,CitiBank London,52739,76119,-23380
2014-03-01,BNY Mellon,CitiBank London,68385,71137,-2752
2014-04-01,BNY Mellon,CitiBank London,63724,74775,-11051
2014-05-01,BNY Mellon,CitiBank London,65785,76337,-10552
2014-06-01,BNY Mellon,CitiBank London,67691,79711,-12020
2014-07-01,BNY Mellon,CitiBank London,69774,73486,-3712
2014-08-01,BNY Mellon,CitiBank London,62371,75472,-13101
2014-09-01,BNY Mellon,CitiBank London,66436,78549,-12113
2014-10-01,BNY Mellon,CitiBank London,62269,75621,-13352
2014-11-01,BNY Mellon,CitiBank London,64228,75781,-11553
2014-12-01,BNY Mellon,CitiBank London,68777,79729,-10952
2015-01-01,BNY Mellon,CitiBank London,74176,68519,5657
2015-02-01,BNY Mellon,CitiBank London,74113,66171,7942
2015-03-01,BNY Mellon,CitiBank London,74148,67439,6709
2015-04-01,BNY Mellon,CitiBank London,75374,69562,5812
2015-05-01,BNY Mellon,CitiBank London,77934,67152,10782
2015-06-01,BNY Mellon,CitiBank London,77292,63482,13810
2015-07-01,BNY Mellon,CitiBank London,74894,65341,9553
2015-08-01,BNY Mellon,CitiBank London,73679,64921,8758
2015-09-01,BNY Mellon,CitiBank London,73386,67139,6247
2015-10-01,BNY Mellon,CitiBank London,75391,63823,11568
2015-11-01,BNY Mellon,CitiBank London,82623,62987,19636
2015-12-01,BNY Mellon,CitiBank London,82941,63391,19550
2016-01-01,BNY Mellon,CitiBank London,88925,62458,26467
2016-02-01,BNY Mellon,CitiBank London,83159,68582,14577
2016-03-01,BNY Mellon,CitiBank London,89485,67744,21741
2016-04-01,BNY Mellon,CitiBank London,86376,61416,24960
2016-05-01,BNY Mellon,CitiBank London,81721,64138,17583
2016-06-01,BNY Mellon,CitiBank London,85775,67724,18051
2016-07-01,BNY Mellon,CitiBank London,89481,68265,21216
2016-08-01,BNY Mellon,CitiBank London,81365,64673,16692
2016-09-01,BNY Mellon,CitiBank London,99465,58843,40622
2016-10-01,BNY Mellon,CitiBank London,99834,58999,40835
2016-11-01,BNY Mellon,CitiBank London,96954,51343,45611
2016-12-01,BNY Mellon,CitiBank London,96659,55722,40937
2017-01-01,BNY Mellon,CitiBank London,96392,56621,39771
2017-02-01,BNY Mellon,CitiBank London,99986,57219,42767
2017-03-01,BNY Mellon,CitiBank London,91133,54325,36808
2017-04-01,BNY Mellon,CitiBank London,96625,57511,39114
2017-05-01,BNY Mellon,CitiBank London,95432,54658,40774
2017-06-01,BNY Mellon,CitiBank London,96236,57989,38247
2017-07-01,BNY Mellon,CitiBank London,107235,56423,50812
2017-08-01,BNY Mellon,CitiBank London,105249,57134,48115
2017-09-01,BNY Mellon,CitiBank London,108965,53153,55812
2017-10-01,BNY Mellon,CitiBank London,109912,53433,56479
2017-11-01,BNY Mellon,CitiBank London,108165,59611,48554
2017-12-01,BNY Mellon,CitiBank London,101752,54296,47456
2018-01-01,BNY Mellon,CitiBank London,104944,56225,48719
2018-02-01,BNY Mellon,CitiBank London,108771,59343,49428
2018-03-01,BNY Mellon,CitiBank London,105667,58951,46716
2018-04-01,BNY Mellon,CitiBank London,108648,55613,53035
2010-01-01,BNY Mellon,CitiBank Pune,14251,93666,-79415
2010-02-01,BNY Mellon,CitiBank Pune,11468,97251,-85783
2010-03-01,BNY Mellon,CitiBank Pune,17388,93958,-76570
2010-04-01,BNY Mellon,CitiBank Pune,19426,91633,-72207
2010-05-01,BNY Mellon,CitiBank Pune,12622,98694,-86072
2010-06-01,BNY Mellon,CitiBank Pune,14782,96431,-81649
2010-07-01,BNY Mellon,CitiBank Pune,17516,91132,-73616
2010-08-01,BNY Mellon,CitiBank Pune,19395,95272,-75877
2010-09-01,BNY Mellon,CitiBank Pune,17148,99988,-82840
2010-10-01,BNY Mellon,CitiBank Pune,14512,92244,-77732
2010-11-01,BNY Mellon,CitiBank Pune,21336,95689,-74353
2010-12-01,BNY Mellon,CitiBank Pune,25934,95512,-69578
2011-01-01,BNY Mellon,CitiBank Pune,28727,94927,-66200
2011-02-01,BNY Mellon,CitiBank Pune,25463,95668,-70205
2011-03-01,BNY Mellon,CitiBank Pune,23495,93164,-69669
2011-04-01,BNY Mellon,CitiBank Pune,22913,98529,-75616
2011-05-01,BNY Mellon,CitiBank Pune,27421,99971,-72550
2011-06-01,BNY Mellon,CitiBank Pune,27656,97831,-70175
2011-07-01,BNY Mellon,CitiBank Pune,21576,94283,-72707
2011-08-01,BNY Mellon,CitiBank Pune,21278,98287,-77009
2011-09-01,BNY Mellon,CitiBank Pune,31826,81133,-49307
2011-10-01,BNY Mellon,CitiBank Pune,35659,85891,-50232
2011-11-01,BNY Mellon,CitiBank Pune,32856,82982,-50126
2011-12-01,BNY Mellon,CitiBank Pune,35811,83326,-47515
2012-01-01,BNY Mellon,CitiBank Pune,32632,84193,-51561
2012-02-01,BNY Mellon,CitiBank Pune,36839,81536,-44697
2012-03-01,BNY Mellon,CitiBank Pune,39688,87437,-47749
2012-04-01,BNY Mellon,CitiBank Pune,39662,81387,-41725
2012-05-01,BNY Mellon,CitiBank Pune,33334,84324,-50990
2012-06-01,BNY Mellon,CitiBank Pune,35531,81378,-45847
2012-07-01,BNY Mellon,CitiBank Pune,42735,88779,-46044
2012-08-01,BNY Mellon,CitiBank Pune,48755,82964,-34209
2012-09-01,BNY Mellon,CitiBank Pune,47117,81953,-34836
2012-10-01,BNY Mellon,CitiBank Pune,43884,82578,-38694
2012-11-01,BNY Mellon,CitiBank Pune,49666,86571,-36905
2012-12-01,BNY Mellon,CitiBank Pune,45284,89496,-44212
2013-01-01,BNY Mellon,CitiBank Pune,45256,84632,-39376
2013-02-01,BNY Mellon,CitiBank Pune,48783,85556,-36773
2013-03-01,BNY Mellon,CitiBank Pune,47275,88263,-40988
2013-04-01,BNY Mellon,CitiBank Pune,45878,83792,-37914
2013-05-01,BNY Mellon,CitiBank Pune,54743,76675,-21932
2013-06-01,BNY Mellon,CitiBank Pune,52435,79257,-26822
2013-07-01,BNY Mellon,CitiBank Pune,54365,75156,-20791
2013-08-01,BNY Mellon,CitiBank Pune,54733,74973,-20240
2013-09-01,BNY Mellon,CitiBank Pune,54189,72322,-18133
2013-10-01,BNY Mellon,CitiBank Pune,57365,72138,-14773
2013-11-01,BNY Mellon,CitiBank Pune,51135,78498,-27363
2013-12-01,BNY Mellon,CitiBank Pune,53565,73955,-20390
2014-01-01,BNY Mellon,CitiBank Pune,56598,76554,-19956
2014-02-01,BNY Mellon,CitiBank Pune,58887,71987,-13100
2014-03-01,BNY Mellon,CitiBank Pune,68525,72538,-4013
2014-04-01,BNY Mellon,CitiBank Pune,67983,79111,-11128
2014-05-01,BNY Mellon,CitiBank Pune,69669,71832,-2163
2014-06-01,BNY Mellon,CitiBank Pune,68263,77518,-9255
2014-07-01,BNY Mellon,CitiBank Pune,61989,76995,-15006
2014-08-01,BNY Mellon,CitiBank Pune,67256,77196,-9940
2014-09-01,BNY Mellon,CitiBank Pune,68239,76927,-8688
2014-10-01,BNY Mellon,CitiBank Pune,62241,71692,-9451
2014-11-01,BNY Mellon,CitiBank Pune,65353,79698,-14345
2014-12-01,BNY Mellon,CitiBank Pune,63669,74711,-11042
2015-01-01,BNY Mellon,CitiBank Pune,73281,61474,11807
2015-02-01,BNY Mellon,CitiBank Pune,75421,69753,5668
2015-03-01,BNY Mellon,CitiBank Pune,76355,62175,14180
2015-04-01,BNY Mellon,CitiBank Pune,73234,64921,8313
2015-05-01,BNY Mellon,CitiBank Pune,77125,62894,14231
2015-06-01,BNY Mellon,CitiBank Pune,72466,67916,4550
2015-07-01,BNY Mellon,CitiBank Pune,74888,66353,8535
2015-08-01,BNY Mellon,CitiBank Pune,77724,62914,14810
2015-09-01,BNY Mellon,CitiBank Pune,76881,67342,9539
2015-10-01,BNY Mellon,CitiBank Pune,71737,61987,9750
2015-11-01,BNY Mellon,CitiBank Pune,86847,61277,25570
2015-12-01,BNY Mellon,CitiBank Pune,85974,62519,23455
2016-01-01,BNY Mellon,CitiBank Pune,85613,61936,23677
2016-02-01,BNY Mellon,CitiBank Pune,86271,69879,16392
2016-03-01,BNY Mellon,CitiBank Pune,87667,61416,26251
2016-04-01,BNY Mellon,CitiBank Pune,89881,61292,28589
2016-05-01,BNY Mellon,CitiBank Pune,88629,63244,25385
2016-06-01,BNY Mellon,CitiBank Pune,84187,64592,19595
2016-07-01,BNY Mellon,CitiBank Pune,87117,66624,20493
2016-08-01,BNY Mellon,CitiBank Pune,81886,63596,18290
2016-09-01,BNY Mellon,CitiBank Pune,92818,56692,36126
2016-10-01,BNY Mellon,CitiBank Pune,96268,51171,45097
2016-11-01,BNY Mellon,CitiBank Pune,93645,54681,38964
2016-12-01,BNY Mellon,CitiBank Pune,94716,51871,42845
2017-01-01,BNY Mellon,CitiBank Pune,98435,51131,47304
2017-02-01,BNY Mellon,CitiBank Pune,99454,55745,43709
2017-03-01,BNY Mellon,CitiBank Pune,92844,51689,41155
2017-04-01,BNY Mellon,CitiBank Pune,97116,53638,43478
2017-05-01,BNY Mellon,CitiBank Pune,95491,59677,35814
2017-06-01,BNY Mellon,CitiBank Pune,92559,58219,34340
2017-07-01,BNY Mellon,CitiBank Pune,104418,54253,50165
2017-08-01,BNY Mellon,CitiBank Pune,107897,53192,54705
2017-09-01,BNY Mellon,CitiBank Pune,101448,53323,48125
2017-10-01,BNY Mellon,CitiBank Pune,104388,54972,49416
2017-11-01,BNY Mellon,CitiBank Pune,104185,55153,49032
2017-12-01,BNY Mellon,CitiBank Pune,105527,59782,45745
2018-01-01,BNY Mellon,CitiBank Pune,104628,58655,45973
2018-02-01,BNY Mellon,CitiBank Pune,107953,52129,55824
2018-03-01,BNY Mellon,CitiBank Pune,106731,59298,47433
2018-04-01,BNY Mellon,CitiBank Pune,101343,53939,47404
2010-01-01,BNY Mellon,CitiBank Singapore,11685,95812,-84127
2010-02-01,BNY Mellon,CitiBank Singapore,11784,92679,-80895
2010-03-01,BNY Mellon,CitiBank Singapore,14958,94312,-79354
2010-04-01,BNY Mellon,CitiBank Singapore,12571,97195,-84624
2010-05-01,BNY Mellon,CitiBank Singapore,17995,93747,-75752
2010-06-01,BNY Mellon,CitiBank Singapore,15725,93812,-78087
2010-07-01,BNY Mellon,CitiBank Singapore,11272,97831,-86559
2010-08-01,BNY Mellon,CitiBank Singapore,19812,99472,-79660
2010-09-01,BNY Mellon,CitiBank Singapore,15492,98982,-83490
2010-10-01,BNY Mellon,CitiBank Singapore,15263,91255,-75992
2010-11-01,BNY Mellon,CitiBank Singapore,26859,91453,-64594
2010-12-01,BNY Mellon,CitiBank Singapore,28133,93716,-65583
2011-01-01,BNY Mellon,CitiBank Singapore,27129,97849,-70720
2011-02-01,BNY Mellon,CitiBank Singapore,27333,92864,-65531
2011-03-01,BNY Mellon,CitiBank Singapore,23833,93851,-70018
2011-04-01,BNY Mellon,CitiBank Singapore,28522,92632,-64110
2011-05-01,BNY Mellon,CitiBank Singapore,21543,99147,-77604
2011-06-01,BNY Mellon,CitiBank Singapore,27313,92215,-64902
2011-07-01,BNY Mellon,CitiBank Singapore,23891,98459,-74568
2011-08-01,BNY Mellon,CitiBank Singapore,26216,97475,-71259
2011-09-01,BNY Mellon,CitiBank Singapore,34216,83128,-48912
2011-10-01,BNY Mellon,CitiBank Singapore,35394,82132,-46738
2011-11-01,BNY Mellon,CitiBank Singapore,34611,81436,-46825
2011-12-01,BNY Mellon,CitiBank Singapore,35986,84117,-48131
2012-01-01,BNY Mellon,CitiBank Singapore,33776,89567,-55791
2012-02-01,BNY Mellon,CitiBank Singapore,34753,83516,-48763
2012-03-01,BNY Mellon,CitiBank Singapore,32444,83495,-51051
2012-04-01,BNY Mellon,CitiBank Singapore,34491,83474,-48983
2012-05-01,BNY Mellon,CitiBank Singapore,34516,83165,-48649
2012-06-01,BNY Mellon,CitiBank Singapore,35758,89724,-53966
2012-07-01,BNY Mellon,CitiBank Singapore,47977,85354,-37377
2012-08-01,BNY Mellon,CitiBank Singapore,43477,85596,-42119
2012-09-01,BNY Mellon,CitiBank Singapore,42436,82896,-40460
2012-10-01,BNY Mellon,CitiBank Singapore,46444,82365,-35921
2012-11-01,BNY Mellon,CitiBank Singapore,48871,84957,-36086
2012-12-01,BNY Mellon,CitiBank Singapore,44328,88352,-44024
2013-01-01,BNY Mellon,CitiBank Singapore,42735,83629,-40894
2013-02-01,BNY Mellon,CitiBank Singapore,41226,89567,-48341
2013-03-01,BNY Mellon,CitiBank Singapore,45594,82962,-37368
2013-04-01,BNY Mellon,CitiBank Singapore,49349,89874,-40525
2013-05-01,BNY Mellon,CitiBank Singapore,55746,71244,-15498
2013-06-01,BNY Mellon,CitiBank Singapore,59415,72655,-13240
2013-07-01,BNY Mellon,CitiBank Singapore,53677,71232,-17555
2013-08-01,BNY Mellon,CitiBank Singapore,53345,76487,-23142
2013-09-01,BNY Mellon,CitiBank Singapore,55956,75763,-19807
2013-10-01,BNY Mellon,CitiBank Singapore,54835,79793,-24958
2013-11-01,BNY Mellon,CitiBank Singapore,57598,79575,-21977
2013-12-01,BNY Mellon,CitiBank Singapore,55446,77691,-22245
2014-01-01,BNY Mellon,CitiBank Singapore,51223,76725,-25502
2014-02-01,BNY Mellon,CitiBank Singapore,58745,74394,-15649
2014-03-01,BNY Mellon,CitiBank Singapore,63733,78233,-14500
2014-04-01,BNY Mellon,CitiBank Singapore,65486,77614,-12128
2014-05-01,BNY Mellon,CitiBank Singapore,63458,78854,-15396
2014-06-01,BNY Mellon,CitiBank Singapore,62148,75624,-13476
2014-07-01,BNY Mellon,CitiBank Singapore,64277,73934,-9657
2014-08-01,BNY Mellon,CitiBank Singapore,61267,79343,-18076
2014-09-01,BNY Mellon,CitiBank Singapore,65556,75828,-10272
2014-10-01,BNY Mellon,CitiBank Singapore,65574,77528,-11954
2014-11-01,BNY Mellon,CitiBank Singapore,62156,76664,-14508
2014-12-01,BNY Mellon,CitiBank Singapore,66833,74334,-7501
2015-01-01,BNY Mellon,CitiBank Singapore,75383,66453,8930
2015-02-01,BNY Mellon,CitiBank Singapore,75267,65976,9291
2015-03-01,BNY Mellon,CitiBank Singapore,73164,63671,9493
2015-04-01,BNY Mellon,CitiBank Singapore,76683,67898,8785
2015-05-01,BNY Mellon,CitiBank Singapore,73374,67588,5786
2015-06-01,BNY Mellon,CitiBank Singapore,79855,64669,15186
2015-07-01,BNY Mellon,CitiBank Singapore,75419,61958,13461
2015-08-01,BNY Mellon,CitiBank Singapore,74936,64374,10562
2015-09-01,BNY Mellon,CitiBank Singapore,74184,69284,4900
2015-10-01,BNY Mellon,CitiBank Singapore,72632,64872,7760
2015-11-01,BNY Mellon,CitiBank Singapore,89872,63687,26185
2015-12-01,BNY Mellon,CitiBank Singapore,85746,61678,24068
2016-01-01,BNY Mellon,CitiBank Singapore,89955,65645,24310
2016-02-01,BNY Mellon,CitiBank Singapore,89572,65127,24445
2016-03-01,BNY Mellon,CitiBank Singapore,86257,69113,17144
2016-04-01,BNY Mellon,CitiBank Singapore,81194,64882,16312
2016-05-01,BNY Mellon,CitiBank Singapore,84328,63273,21055
2016-06-01,BNY Mellon,CitiBank Singapore,85834,62565,23269
2016-07-01,BNY Mellon,CitiBank Singapore,86921,69928,16993
2016-08-01,BNY Mellon,CitiBank Singapore,88416,65425,22991
2016-09-01,BNY Mellon,CitiBank Singapore,97932,52645,45287
2016-10-01,BNY Mellon,CitiBank Singapore,95143,52274,42869
2016-11-01,BNY Mellon,CitiBank Singapore,99965,54957,45008
2016-12-01,BNY Mellon,CitiBank Singapore,94857,57824,37033
2017-01-01,BNY Mellon,CitiBank Singapore,91336,59152,32184
2017-02-01,BNY Mellon,CitiBank Singapore,91345,55596,35749
2017-03-01,BNY Mellon,CitiBank Singapore,94452,58339,36113
2017-04-01,BNY Mellon,CitiBank Singapore,91477,56722,34755
2017-05-01,BNY Mellon,CitiBank Singapore,99834,57614,42220
2017-06-01,BNY Mellon,CitiBank Singapore,94615,52819,41796
2017-07-01,BNY Mellon,CitiBank Singapore,108651,51835,56816
2017-08-01,BNY Mellon,CitiBank Singapore,105583,56143,49440
2017-09-01,BNY Mellon,CitiBank Singapore,102492,55862,46630
2017-10-01,BNY Mellon,CitiBank Singapore,102776,54868,47908
2017-11-01,BNY Mellon,CitiBank Singapore,105893,52449,53444
2017-12-01,BNY Mellon,CitiBank Singapore,103882,54772,49110
2018-01-01,BNY Mellon,CitiBank Singapore,107324,51528,55796
2018-02-01,BNY Mellon,CitiBank Singapore,102581,53261,49320
2018-03-01,BNY Mellon,CitiBank Singapore,107556,56685,50871
2018-04-01,BNY Mellon,CitiBank Singapore,105197,52757,52440
2010-01-01,BNY Mellon,CitiBank HongKong,16568,99935,-83367
2010-02-01,BNY Mellon,CitiBank HongKong,11575,94664,-83089
2010-03-01,BNY Mellon,CitiBank HongKong,13451,99454,-86003
2010-04-01,BNY Mellon,CitiBank HongKong,19544,94836,-75292
2010-05-01,BNY Mellon,CitiBank HongKong,14886,93159,-78273
2010-06-01,BNY Mellon,CitiBank HongKong,12875,95776,-82901
2010-07-01,BNY Mellon,CitiBank HongKong,17568,96516,-78948
2010-08-01,BNY Mellon,CitiBank HongKong,11748,91449,-79701
2010-09-01,BNY Mellon,CitiBank HongKong,12351,97776,-85425
2010-10-01,BNY Mellon,CitiBank HongKong,17576,96193,-78617
2010-11-01,BNY Mellon,CitiBank HongKong,29183,93745,-64562
2010-12-01,BNY Mellon,CitiBank HongKong,24667,96898,-72231
2011-01-01,BNY Mellon,CitiBank HongKong,23612,92344,-68732
2011-02-01,BNY Mellon,CitiBank HongKong,22492,95661,-73169
2011-03-01,BNY Mellon,CitiBank HongKong,22563,96291,-73728
2011-04-01,BNY Mellon,CitiBank HongKong,27147,96389,-69242
2011-05-01,BNY Mellon,CitiBank HongKong,27136,99284,-72148
2011-06-01,BNY Mellon,CitiBank HongKong,27642,94146,-66504
2011-07-01,BNY Mellon,CitiBank HongKong,22749,93527,-70778
2011-08-01,BNY Mellon,CitiBank HongKong,22345,97188,-74843
2011-09-01,BNY Mellon,CitiBank HongKong,33444,82256,-48812
2011-10-01,BNY Mellon,CitiBank HongKong,39828,84837,-45009
2011-11-01,BNY Mellon,CitiBank HongKong,39694,87496,-47802
2011-12-01,BNY Mellon,CitiBank HongKong,35444,87163,-51719
2012-01-01,BNY Mellon,CitiBank HongKong,38584,88919,-50335
2012-02-01,BNY Mellon,CitiBank HongKong,36156,82917,-46761
2012-03-01,BNY Mellon,CitiBank HongKong,36469,84225,-47756
2012-04-01,BNY Mellon,CitiBank HongKong,37548,85957,-48409
2012-05-01,BNY Mellon,CitiBank HongKong,35146,87732,-52586
2012-06-01,BNY Mellon,CitiBank HongKong,38167,81378,-43211
2012-07-01,BNY Mellon,CitiBank HongKong,46953,84654,-37701
2012-08-01,BNY Mellon,CitiBank HongKong,48789,84758,-35969
2012-09-01,BNY Mellon,CitiBank HongKong,47364,87915,-40551
2012-10-01,BNY Mellon,CitiBank HongKong,43775,89826,-46051
2012-11-01,BNY Mellon,CitiBank HongKong,41152,86959,-45807
2012-12-01,BNY Mellon,CitiBank HongKong,46338,84369,-38031
2013-01-01,BNY Mellon,CitiBank HongKong,41768,83448,-41680
2013-02-01,BNY Mellon,CitiBank HongKong,41191,81161,-39970
2013-03-01,BNY Mellon,CitiBank HongKong,43338,84479,-41141
2013-04-01,BNY Mellon,CitiBank HongKong,44727,83384,-38657
2013-05-01,BNY Mellon,CitiBank HongKong,52768,71576,-18808
2013-06-01,BNY Mellon,CitiBank HongKong,57292,72479,-15187
2013-07-01,BNY Mellon,CitiBank HongKong,58719,74243,-15524
2013-08-01,BNY Mellon,CitiBank HongKong,59441,71542,-12101
2013-09-01,BNY Mellon,CitiBank HongKong,57322,78598,-21276
2013-10-01,BNY Mellon,CitiBank HongKong,56222,75392,-19170
2013-11-01,BNY Mellon,CitiBank HongKong,51274,72843,-21569
2013-12-01,BNY Mellon,CitiBank HongKong,53299,76771,-23472
2014-01-01,BNY Mellon,CitiBank HongKong,51559,71247,-19688
2014-02-01,BNY Mellon,CitiBank HongKong,58918,78568,-19650
2014-03-01,BNY Mellon,CitiBank HongKong,68381,71957,-3576
2014-04-01,BNY Mellon,CitiBank HongKong,62554,75849,-13295
2014-05-01,BNY Mellon,CitiBank HongKong,61134,75726,-14592
2014-06-01,BNY Mellon,CitiBank HongKong,62833,72632,-9799
2014-07-01,BNY Mellon,CitiBank HongKong,67337,75267,-7930
2014-08-01,BNY Mellon,CitiBank HongKong,69822,72819,-2997
2014-09-01,BNY Mellon,CitiBank HongKong,64833,74638,-9805
2014-10-01,BNY Mellon,CitiBank HongKong,65373,73988,-8615
2014-11-01,BNY Mellon,CitiBank HongKong,63168,77547,-14379
2014-12-01,BNY Mellon,CitiBank HongKong,65414,79967,-14553
2015-01-01,BNY Mellon,CitiBank HongKong,73798,63862,9936
2015-02-01,BNY Mellon,CitiBank HongKong,79745,68154,11591
2015-03-01,BNY Mellon,CitiBank HongKong,76937,67652,9285
2015-04-01,BNY Mellon,CitiBank HongKong,75582,61762,13820
2015-05-01,BNY Mellon,CitiBank HongKong,77334,69894,7440
2015-06-01,BNY Mellon,CitiBank HongKong,75975,62785,13190
2015-07-01,BNY Mellon,CitiBank HongKong,72982,65278,7704
2015-08-01,BNY Mellon,CitiBank HongKong,75993,64472,11521
2015-09-01,BNY Mellon,CitiBank HongKong,71733,68426,3307
2015-10-01,BNY Mellon,CitiBank HongKong,78761,62981,15780
2015-11-01,BNY Mellon,CitiBank HongKong,88818,64259,24559
2015-12-01,BNY Mellon,CitiBank HongKong,87328,67674,19654
2016-01-01,BNY Mellon,CitiBank HongKong,82375,67531,14844
2016-02-01,BNY Mellon,CitiBank HongKong,83625,63879,19746
2016-03-01,BNY Mellon,CitiBank HongKong,86138,69686,16452
2016-04-01,BNY Mellon,CitiBank HongKong,84535,61619,22916
2016-05-01,BNY Mellon,CitiBank HongKong,85496,64955,20541
2016-06-01,BNY Mellon,CitiBank HongKong,88554,69811,18743
2016-07-01,BNY Mellon,CitiBank HongKong,84712,67931,16781
2016-08-01,BNY Mellon,CitiBank HongKong,83838,62391,21447
2016-09-01,BNY Mellon,CitiBank HongKong,91843,55275,36568
2016-10-01,BNY Mellon,CitiBank HongKong,97989,59516,38473
2016-11-01,BNY Mellon,CitiBank HongKong,91984,55532,36452
2016-12-01,BNY Mellon,CitiBank HongKong,97214,57262,39952
2017-01-01,BNY Mellon,CitiBank HongKong,91555,58539,33016
2017-02-01,BNY Mellon,CitiBank HongKong,94351,53292,41059
2017-03-01,BNY Mellon,CitiBank HongKong,92717,58381,34336
2017-04-01,BNY Mellon,CitiBank HongKong,95866,51582,44284
2017-05-01,BNY Mellon,CitiBank HongKong,97151,51544,45607
2017-06-01,BNY Mellon,CitiBank HongKong,95254,51152,44102
2017-07-01,BNY Mellon,CitiBank HongKong,102298,51934,50364
2017-08-01,BNY Mellon,CitiBank HongKong,104539,57893,46646
2017-09-01,BNY Mellon,CitiBank HongKong,102352,57622,44730
2017-10-01,BNY Mellon,CitiBank HongKong,108562,51945,56617
2017-11-01,BNY Mellon,CitiBank HongKong,101566,54351,47215
2017-12-01,BNY Mellon,CitiBank HongKong,109141,54859,54282
2018-01-01,BNY Mellon,CitiBank HongKong,105644,53726,51918
2018-02-01,BNY Mellon,CitiBank HongKong,104912,51818,53094
2018-03-01,BNY Mellon,CitiBank HongKong,106722,52375,54347
2018-04-01,BNY Mellon,CitiBank HongKong,101242,55833,45409
2010-01-01,Goldman Sachs,CitiBank New York,16519,93339,-76820
2010-02-01,Goldman Sachs,CitiBank New York,12326,96449,-84123
2010-03-01,Goldman Sachs,CitiBank New York,14464,98619,-84155
2010-04-01,Goldman Sachs,CitiBank New York,18349,98649,-80300
2010-05-01,Goldman Sachs,CitiBank New York,12341,95538,-83197
2010-06-01,Goldman Sachs,CitiBank New York,12621,92119,-79498
2010-07-01,Goldman Sachs,CitiBank New York,19777,92458,-72681
2010-08-01,Goldman Sachs,CitiBank New York,13957,94323,-80366
2010-09-01,Goldman Sachs,CitiBank New York,17851,97511,-79660
2010-10-01,Goldman Sachs,CitiBank New York,17518,98127,-80609
2010-11-01,Goldman Sachs,CitiBank New York,23313,93266,-69953
2010-12-01,Goldman Sachs,CitiBank New York,24178,96188,-72010
2011-01-01,Goldman Sachs,CitiBank New York,24944,96676,-71732
2011-02-01,Goldman Sachs,CitiBank New York,23674,98815,-75141
2011-03-01,Goldman Sachs,CitiBank New York,24817,92382,-67565
2011-04-01,Goldman Sachs,CitiBank New York,22259,99493,-77234
2011-05-01,Goldman Sachs,CitiBank New York,25917,91449,-65532
2011-06-01,Goldman Sachs,CitiBank New York,28826,93481,-64655
2011-07-01,Goldman Sachs,CitiBank New York,22515,95885,-73370
2011-08-01,Goldman Sachs,CitiBank New York,29148,92148,-63000
2011-09-01,Goldman Sachs,CitiBank New York,35667,86496,-50829
2011-10-01,Goldman Sachs,CitiBank New York,32232,86967,-54735
2011-11-01,Goldman Sachs,CitiBank New York,39471,81339,-41868
2011-12-01,Goldman Sachs,CitiBank New York,32436,83781,-51345
2012-01-01,Goldman Sachs,CitiBank New York,33825,85716,-51891
2012-02-01,Goldman Sachs,CitiBank New York,32487,84316,-51829
2012-03-01,Goldman Sachs,CitiBank New York,37887,88823,-50936
2012-04-01,Goldman Sachs,CitiBank New York,32212,85673,-53461
2012-05-01,Goldman Sachs,CitiBank New York,31227,82934,-51707
2012-06-01,Goldman Sachs,CitiBank New York,36361,86661,-50300
2012-07-01,Goldman Sachs,CitiBank New York,48245,89421,-41176
2012-08-01,Goldman Sachs,CitiBank New York,46721,87523,-40802
2012-09-01,Goldman Sachs,CitiBank New York,42981,82427,-39446
2012-10-01,Goldman Sachs,CitiBank New York,42294,89396,-47102
2012-11-01,Goldman Sachs,CitiBank New York,45119,88439,-43320
2012-12-01,Goldman Sachs,CitiBank New York,47362,86153,-38791
2013-01-01,Goldman Sachs,CitiBank New York,47685,81832,-34147
2013-02-01,Goldman Sachs,CitiBank New York,46951,88934,-41983
2013-03-01,Goldman Sachs,CitiBank New York,45858,84964,-39106
2013-04-01,Goldman Sachs,CitiBank New York,44657,83622,-38965
2013-05-01,Goldman Sachs,CitiBank New York,59392,72849,-13457
2013-06-01,Goldman Sachs,CitiBank New York,57193,76893,-19700
2013-07-01,Goldman Sachs,CitiBank New York,58435,72734,-14299
2013-08-01,Goldman Sachs,CitiBank New York,54398,75251,-20853
2013-09-01,Goldman Sachs,CitiBank New York,57326,79413,-22087
2013-10-01,Goldman Sachs,CitiBank New York,52856,74113,-21257
2013-11-01,Goldman Sachs,CitiBank New York,58653,79295,-20642
2013-12-01,Goldman Sachs,CitiBank New York,54741,75936,-21195
2014-01-01,Goldman Sachs,CitiBank New York,51967,77349,-25382
2014-02-01,Goldman Sachs,CitiBank New York,52365,77891,-25526
2014-03-01,Goldman Sachs,CitiBank New York,61581,76627,-15046
2014-04-01,Goldman Sachs,CitiBank New York,68477,78136,-9659
2014-05-01,Goldman Sachs,CitiBank New York,62851,75428,-12577
2014-06-01,Goldman Sachs,CitiBank New York,61435,72643,-11208
2014-07-01,Goldman Sachs,CitiBank New York,69586,72594,-3008
2014-08-01,Goldman Sachs,CitiBank New York,65586,75474,-9888
2014-09-01,Goldman Sachs,CitiBank New York,62541,74656,-12115
2014-10-01,Goldman Sachs,CitiBank New York,69195,74262,-5067
2014-11-01,Goldman Sachs,CitiBank New York,62781,78797,-16016
2014-12-01,Goldman Sachs,CitiBank New York,64974,78787,-13813
2015-01-01,Goldman Sachs,CitiBank New York,73486,64772,8714
2015-02-01,Goldman Sachs,CitiBank New York,73432,69269,4163
2015-03-01,Goldman Sachs,CitiBank New York,76715,63899,12816
2015-04-01,Goldman Sachs,CitiBank New York,71683,66122,5561
2015-05-01,Goldman Sachs,CitiBank New York,73152,68689,4463
2015-06-01,Goldman Sachs,CitiBank New York,71169,64546,6623
2015-07-01,Goldman Sachs,CitiBank New York,74512,64423,10089
2015-08-01,Goldman Sachs,CitiBank New York,71119,65852,5267
2015-09-01,Goldman Sachs,CitiBank New York,72232,66924,5308
2015-10-01,Goldman Sachs,CitiBank New York,77751,64169,13582
2015-11-01,Goldman Sachs,CitiBank New York,85678,67888,17790
2015-12-01,Goldman Sachs,CitiBank New York,86239,62778,23461
2016-01-01,Goldman Sachs,CitiBank New York,87434,61893,25541
2016-02-01,Goldman Sachs,CitiBank New York,82378,61229,21149
2016-03-01,Goldman Sachs,CitiBank New York,85478,63921,21557
2016-04-01,Goldman Sachs,CitiBank New York,88653,67325,21328
2016-05-01,Goldman Sachs,CitiBank New York,85356,68148,17208
2016-06-01,Goldman Sachs,CitiBank New York,84812,64572,20240
2016-07-01,Goldman Sachs,CitiBank New York,89526,68561,20965
2016-08-01,Goldman Sachs,CitiBank New York,83194,66997,16197
2016-09-01,Goldman Sachs,CitiBank New York,98956,59971,38985
2016-10-01,Goldman Sachs,CitiBank New York,93193,59288,33905
2016-11-01,Goldman Sachs,CitiBank New York,99269,57754,41515
2016-12-01,Goldman Sachs,CitiBank New York,94895,51133,43762
2017-01-01,Goldman Sachs,CitiBank New York,96961,59975,36986
2017-02-01,Goldman Sachs,CitiBank New York,91926,59339,32587
2017-03-01,Goldman Sachs,CitiBank New York,91452,56455,34997
2017-04-01,Goldman Sachs,CitiBank New York,92894,53878,39016
2017-05-01,Goldman Sachs,CitiBank New York,93829,55639,38190
2017-06-01,Goldman Sachs,CitiBank New York,93665,51662,42003
2017-07-01,Goldman Sachs,CitiBank New York,106857,54978,51879
2017-08-01,Goldman Sachs,CitiBank New York,103932,54657,49275
2017-09-01,Goldman Sachs,CitiBank New York,107888,55425,52463
2017-10-01,Goldman Sachs,CitiBank New York,106626,51857,54769
2017-11-01,Goldman Sachs,CitiBank New York,101831,52122,49709
2017-12-01,Goldman Sachs,CitiBank New York,108656,59787,48869
2018-01-01,Goldman Sachs,CitiBank New York,107146,57755,49391
2018-02-01,Goldman Sachs,CitiBank New York,107661,54324,53337
2018-03-01,Goldman Sachs,CitiBank New York,104752,59751,45001
2018-04-01,Goldman Sachs,CitiBank New York,106456,58219,48237
2010-01-01,Goldman Sachs,CitiBank London,13614,93344,-79730
2010-02-01,Goldman Sachs,CitiBank London,14824,99928,-85104
2010-03-01,Goldman Sachs,CitiBank London,15654,92393,-76739
2010-04-01,Goldman Sachs,CitiBank London,17768,91771,-74003
2010-05-01,Goldman Sachs,CitiBank London,15621,95612,-79991
2010-06-01,Goldman Sachs,CitiBank London,12235,93333,-81098
2010-07-01,Goldman Sachs,CitiBank London,19837,97454,-77617
2010-08-01,Goldman Sachs,CitiBank London,17316,94481,-77165
2010-09-01,Goldman Sachs,CitiBank London,17441,96734,-79293
2010-10-01,Goldman Sachs,CitiBank London,11428,93628,-82200
2010-11-01,Goldman Sachs,CitiBank London,27233,93565,-66332
2010-12-01,Goldman Sachs,CitiBank London,28243,97274,-69031
2011-01-01,Goldman Sachs,CitiBank London,29234,94616,-65382
2011-02-01,Goldman Sachs,CitiBank London,28457,99231,-70774
2011-03-01,Goldman Sachs,CitiBank London,22484,92953,-70469
2011-04-01,Goldman Sachs,CitiBank London,29291,92982,-63691
2011-05-01,Goldman Sachs,CitiBank London,27895,98575,-70680
2011-06-01,Goldman Sachs,CitiBank London,26476,92326,-65850
2011-07-01,Goldman Sachs,CitiBank London,28325,97189,-68864
2011-08-01,Goldman Sachs,CitiBank London,27298,96825,-69527
2011-09-01,Goldman Sachs,CitiBank London,34939,88464,-53525
2011-10-01,Goldman Sachs,CitiBank London,35182,87791,-52609
2011-11-01,Goldman Sachs,CitiBank London,33621,88674,-55053
2011-12-01,Goldman Sachs,CitiBank London,35743,84239,-48496
2012-01-01,Goldman Sachs,CitiBank London,37399,89488,-52089
2012-02-01,Goldman Sachs,CitiBank London,36515,88583,-52068
2012-03-01,Goldman Sachs,CitiBank London,36774,81746,-44972
2012-04-01,Goldman Sachs,CitiBank London,38228,88644,-50416
2012-05-01,Goldman Sachs,CitiBank London,32816,81681,-48865
2012-06-01,Goldman Sachs,CitiBank London,33235,89685,-56450
2012-07-01,Goldman Sachs,CitiBank London,44883,82637,-37754
2012-08-01,Goldman Sachs,CitiBank London,41289,88683,-47394
2012-09-01,Goldman Sachs,CitiBank London,42435,82886,-40451
2012-10-01,Goldman Sachs,CitiBank London,41228,86197,-44969
2012-11-01,Goldman Sachs,CitiBank London,46194,87683,-41489
2012-12-01,Goldman Sachs,CitiBank London,42936,81243,-38307
2013-01-01,Goldman Sachs,CitiBank London,45462,88695,-43233
2013-02-01,Goldman Sachs,CitiBank London,43323,83639,-40316
2013-03-01,Goldman Sachs,CitiBank London,41245,89121,-47876
2013-04-01,Goldman Sachs,CitiBank London,42747,81564,-38817
2013-05-01,Goldman Sachs,CitiBank London,53154,77985,-24831
2013-06-01,Goldman Sachs,CitiBank London,56133,77154,-21021
2013-07-01,Goldman Sachs,CitiBank London,56491,79118,-22627
2013-08-01,Goldman Sachs,CitiBank London,58417,79143,-20726
2013-09-01,Goldman Sachs,CitiBank London,51777,72326,-20549
2013-10-01,Goldman Sachs,CitiBank London,51945,74375,-22430
2013-11-01,Goldman Sachs,CitiBank London,59443,75753,-16310
2013-12-01,Goldman Sachs,CitiBank London,59889,74559,-14670
2014-01-01,Goldman Sachs,CitiBank London,52244,71656,-19412
2014-02-01,Goldman Sachs,CitiBank London,59924,76785,-16861
2014-03-01,Goldman Sachs,CitiBank London,67189,76552,-9363
2014-04-01,Goldman Sachs,CitiBank London,63136,77856,-14720
2014-05-01,Goldman Sachs,CitiBank London,61977,79336,-17359
2014-06-01,Goldman Sachs,CitiBank London,65148,77444,-12296
2014-07-01,Goldman Sachs,CitiBank London,66572,71134,-4562
2014-08-01,Goldman Sachs,CitiBank London,61266,77836,-16570
2014-09-01,Goldman Sachs,CitiBank London,64179,72616,-8437
2014-10-01,Goldman Sachs,CitiBank London,62449,77169,-14720
2014-11-01,Goldman Sachs,CitiBank London,67253,77857,-10604
2014-12-01,Goldman Sachs,CitiBank London,65986,73479,-7493
2015-01-01,Goldman Sachs,CitiBank London,72213,63616,8597
2015-02-01,Goldman Sachs,CitiBank London,76935,65738,11197
2015-03-01,Goldman Sachs,CitiBank London,74749,64426,10323
2015-04-01,Goldman Sachs,CitiBank London,74568,69838,4730
2015-05-01,Goldman Sachs,CitiBank London,76187,62247,13940
2015-06-01,Goldman Sachs,CitiBank London,74615,67275,7340
2015-07-01,Goldman Sachs,CitiBank London,78129,65946,12183
2015-08-01,Goldman Sachs,CitiBank London,79379,66668,12711
2015-09-01,Goldman Sachs,CitiBank London,79513,63463,16050
2015-10-01,Goldman Sachs,CitiBank London,71661,62133,9528
2015-11-01,Goldman Sachs,CitiBank London,83948,68441,15507
2015-12-01,Goldman Sachs,CitiBank London,83923,64918,19005
2016-01-01,Goldman Sachs,CitiBank London,88789,61185,27604
2016-02-01,Goldman Sachs,CitiBank London,84926,62416,22510
2016-03-01,Goldman Sachs,CitiBank London,87176,69558,17618
2016-04-01,Goldman Sachs,CitiBank London,82753,63964,18789
2016-05-01,Goldman Sachs,CitiBank London,86918,69536,17382
2016-06-01,Goldman Sachs,CitiBank London,82526,64179,18347
2016-07-01,Goldman Sachs,CitiBank London,87845,64361,23484
2016-08-01,Goldman Sachs,CitiBank London,84958,65526,19432
2016-09-01,Goldman Sachs,CitiBank London,96139,52249,43890
2016-10-01,Goldman Sachs,CitiBank London,95726,51742,43984
2016-11-01,Goldman Sachs,CitiBank London,94651,53712,40939
2016-12-01,Goldman Sachs,CitiBank London,91128,52813,38315
2017-01-01,Goldman Sachs,CitiBank London,99625,59437,40188
2017-02-01,Goldman Sachs,CitiBank London,99912,56195,43717
2017-03-01,Goldman Sachs,CitiBank London,97168,59232,37936
2017-04-01,Goldman Sachs,CitiBank London,91964,51459,40505
2017-05-01,Goldman Sachs,CitiBank London,98644,55994,42650
2017-06-01,Goldman Sachs,CitiBank London,97262,52546,44716
2017-07-01,Goldman Sachs,CitiBank London,103492,56792,46700
2017-08-01,Goldman Sachs,CitiBank London,107723,53576,54147
2017-09-01,Goldman Sachs,CitiBank London,106233,57687,48546
2017-10-01,Goldman Sachs,CitiBank London,101948,55658,46290
2017-11-01,Goldman Sachs,CitiBank London,105528,52885,52643
2017-12-01,Goldman Sachs,CitiBank London,103924,55366,48558
2018-01-01,Goldman Sachs,CitiBank London,109856,51526,58330
2018-02-01,Goldman Sachs,CitiBank London,101714,59223,42491
2018-03-01,Goldman Sachs,CitiBank London,104421,57117,47304
2018-04-01,Goldman Sachs,CitiBank London,103461,52792,50669
2010-01-01,Goldman Sachs,CitiBank Pune,14512,96985,-82473
2010-02-01,Goldman Sachs,CitiBank Pune,13112,92851,-79739
2010-03-01,Goldman Sachs,CitiBank Pune,15811,95976,-80165
2010-04-01,Goldman Sachs,CitiBank Pune,19496,99215,-79719
2010-05-01,Goldman Sachs,CitiBank Pune,18525,92657,-74132
2010-06-01,Goldman Sachs,CitiBank Pune,11879,96494,-84615
2010-07-01,Goldman Sachs,CitiBank Pune,19274,94885,-75611
2010-08-01,Goldman Sachs,CitiBank Pune,17479,96646,-79167
2010-09-01,Goldman Sachs,CitiBank Pune,18499,93682,-75183
2010-10-01,Goldman Sachs,CitiBank Pune,18246,96167,-77921
2010-11-01,Goldman Sachs,CitiBank Pune,27438,96718,-69280
2010-12-01,Goldman Sachs,CitiBank Pune,28972,94373,-65401
2011-01-01,Goldman Sachs,CitiBank Pune,28118,97454,-69336
2011-02-01,Goldman Sachs,CitiBank Pune,27381,95734,-68353
2011-03-01,Goldman Sachs,CitiBank Pune,22883,94724,-71841
2011-04-01,Goldman Sachs,CitiBank Pune,27214,99622,-72408
2011-05-01,Goldman Sachs,CitiBank Pune,23846,94893,-71047
2011-06-01,Goldman Sachs,CitiBank Pune,27515,95138,-67623
2011-07-01,Goldman Sachs,CitiBank Pune,24374,98959,-74585
2011-08-01,Goldman Sachs,CitiBank Pune,23325,98316,-74991
2011-09-01,Goldman Sachs,CitiBank Pune,37189,85492,-48303
2011-10-01,Goldman Sachs,CitiBank Pune,37679,89596,-51917
2011-11-01,Goldman Sachs,CitiBank Pune,34369,88315,-53946
2011-12-01,Goldman Sachs,CitiBank Pune,32725,82954,-50229
2012-01-01,Goldman Sachs,CitiBank Pune,34876,85748,-50872
2012-02-01,Goldman Sachs,CitiBank Pune,37596,88874,-51278
2012-03-01,Goldman Sachs,CitiBank Pune,38533,87764,-49231
2012-04-01,Goldman Sachs,CitiBank Pune,33494,83899,-50405
2012-05-01,Goldman Sachs,CitiBank Pune,34939,82854,-47915
2012-06-01,Goldman Sachs,CitiBank Pune,31425,85122,-53697
2012-07-01,Goldman Sachs,CitiBank Pune,41832,81917,-40085
2012-08-01,Goldman Sachs,CitiBank Pune,43198,81592,-38394
2012-09-01,Goldman Sachs,CitiBank Pune,41844,84281,-42437
2012-10-01,Goldman Sachs,CitiBank Pune,48614,85341,-36727
2012-11-01,Goldman Sachs,CitiBank Pune,46351,83489,-37138
2012-12-01,Goldman Sachs,CitiBank Pune,44736,83683,-38947
2013-01-01,Goldman Sachs,CitiBank Pune,44293,89286,-44993
2013-02-01,Goldman Sachs,CitiBank Pune,49148,81925,-32777
2013-03-01,Goldman Sachs,CitiBank Pune,43355,81419,-38064
2013-04-01,Goldman Sachs,CitiBank Pune,48826,86556,-37730
2013-05-01,Goldman Sachs,CitiBank Pune,55951,79963,-24012
2013-06-01,Goldman Sachs,CitiBank Pune,54377,75816,-21439
2013-07-01,Goldman Sachs,CitiBank Pune,54261,73357,-19096
2013-08-01,Goldman Sachs,CitiBank Pune,56873,71795,-14922
2013-09-01,Goldman Sachs,CitiBank Pune,59339,78286,-18947
2013-10-01,Goldman Sachs,CitiBank Pune,59158,77191,-18033
2013-11-01,Goldman Sachs,CitiBank Pune,55872,78583,-22711
2013-12-01,Goldman Sachs,CitiBank Pune,51511,75487,-23976
2014-01-01,Goldman Sachs,CitiBank Pune,56576,74944,-18368
2014-02-01,Goldman Sachs,CitiBank Pune,59927,72662,-12735
2014-03-01,Goldman Sachs,CitiBank Pune,66388,72349,-5961
2014-04-01,Goldman Sachs,CitiBank Pune,61379,71826,-10447
2014-05-01,Goldman Sachs,CitiBank Pune,64435,71289,-6854
2014-06-01,Goldman Sachs,CitiBank Pune,69966,74525,-4559
2014-07-01,Goldman Sachs,CitiBank Pune,64949,79717,-14768
2014-08-01,Goldman Sachs,CitiBank Pune,64198,77244,-13046
2014-09-01,Goldman Sachs,CitiBank Pune,64344,73916,-9572
2014-10-01,Goldman Sachs,CitiBank Pune,67948,76932,-8984
2014-11-01,Goldman Sachs,CitiBank Pune,61883,71357,-9474
2014-12-01,Goldman Sachs,CitiBank Pune,68939,76313,-7374
2015-01-01,Goldman Sachs,CitiBank Pune,77824,63269,14555
2015-02-01,Goldman Sachs,CitiBank Pune,77542,69476,8066
2015-03-01,Goldman Sachs,CitiBank Pune,76312,69859,6453
2015-04-01,Goldman Sachs,CitiBank Pune,71347,64197,7150
2015-05-01,Goldman Sachs,CitiBank Pune,74947,66157,8790
2015-06-01,Goldman Sachs,CitiBank Pune,77834,61691,16143
2015-07-01,Goldman Sachs,CitiBank Pune,79999,69141,10858
2015-08-01,Goldman Sachs,CitiBank Pune,71918,61843,10075
2015-09-01,Goldman Sachs,CitiBank Pune,75211,66148,9063
2015-10-01,Goldman Sachs,CitiBank Pune,75226,63132,12094
2015-11-01,Goldman Sachs,CitiBank Pune,81462,67843,13619
2015-12-01,Goldman Sachs,CitiBank Pune,88757,65162,23595
2016-01-01,Goldman Sachs,CitiBank Pune,82255,69793,12462
2016-02-01,Goldman Sachs,CitiBank Pune,85681,67143,18538
2016-03-01,Goldman Sachs,CitiBank Pune,88815,67978,20837
2016-04-01,Goldman Sachs,CitiBank Pune,83146,64635,18511
2016-05-01,Goldman Sachs,CitiBank Pune,88229,66929,21300
2016-06-01,Goldman Sachs,CitiBank Pune,88517,63784,24733
2016-07-01,Goldman Sachs,CitiBank Pune,83738,63768,19970
2016-08-01,Goldman Sachs,CitiBank Pune,81461,63985,17476
2016-09-01,Goldman Sachs,CitiBank Pune,94295,53824,40471
2016-10-01,Goldman Sachs,CitiBank Pune,99636,51646,47990
2016-11-01,Goldman Sachs,CitiBank Pune,93287,53349,39938
2016-12-01,Goldman Sachs,CitiBank Pune,96599,57915,38684
2017-01-01,Goldman Sachs,CitiBank Pune,96799,57178,39621
2017-02-01,Goldman Sachs,CitiBank Pune,97559,57549,40010
2017-03-01,Goldman Sachs,CitiBank Pune,95795,52775,43020
2017-04-01,Goldman Sachs,CitiBank Pune,96326,51953,44373
2017-05-01,Goldman Sachs,CitiBank Pune,96139,56879,39260
2017-06-01,Goldman Sachs,CitiBank Pune,92871,51521,41350
2017-07-01,Goldman Sachs,CitiBank Pune,109554,59625,49929
2017-08-01,Goldman Sachs,CitiBank Pune,101679,51521,50158
2017-09-01,Goldman Sachs,CitiBank Pune,105477,53587,51890
2017-10-01,Goldman Sachs,CitiBank Pune,107578,58552,49026
2017-11-01,Goldman Sachs,CitiBank Pune,101944,52545,49399
2017-12-01,Goldman Sachs,CitiBank Pune,108926,57843,51083
2018-01-01,Goldman Sachs,CitiBank Pune,106314,53927,52387
2018-02-01,Goldman Sachs,CitiBank Pune,105367,57968,47399
2018-03-01,Goldman Sachs,CitiBank Pune,107328,55761,51567
2018-04-01,Goldman Sachs,CitiBank Pune,101434,52386,49048
2010-01-01,Goldman Sachs,CitiBank Singapore,19923,95999,-76076
2010-02-01,Goldman Sachs,CitiBank Singapore,17735,94975,-77240
2010-03-01,Goldman Sachs,CitiBank Singapore,18523,97192,-78669
2010-04-01,Goldman Sachs,CitiBank Singapore,18217,91449,-73232
2010-05-01,Goldman Sachs,CitiBank Singapore,17166,92731,-75565
2010-06-01,Goldman Sachs,CitiBank Singapore,16444,91378,-74934
2010-07-01,Goldman Sachs,CitiBank Singapore,19634,99721,-80087
2010-08-01,Goldman Sachs,CitiBank Singapore,14932,92181,-77249
2010-09-01,Goldman Sachs,CitiBank Singapore,19243,97767,-78524
2010-10-01,Goldman Sachs,CitiBank Singapore,16269,92198,-75929
2010-11-01,Goldman Sachs,CitiBank Singapore,28698,97197,-68499
2010-12-01,Goldman Sachs,CitiBank Singapore,28166,98964,-70798
2011-01-01,Goldman Sachs,CitiBank Singapore,25181,95973,-70792
2011-02-01,Goldman Sachs,CitiBank Singapore,28188,93855,-65667
2011-03-01,Goldman Sachs,CitiBank Singapore,29135,97877,-68742
2011-04-01,Goldman Sachs,CitiBank Singapore,27335,96185,-68850
2011-05-01,Goldman Sachs,CitiBank Singapore,21631,92915,-71284
2011-06-01,Goldman Sachs,CitiBank Singapore,23583,98822,-75239
2011-07-01,Goldman Sachs,CitiBank Singapore,28478,98467,-69989
2011-08-01,Goldman Sachs,CitiBank Singapore,27362,96146,-68784
2011-09-01,Goldman Sachs,CitiBank Singapore,37431,87245,-49814
2011-10-01,Goldman Sachs,CitiBank Singapore,36923,82847,-45924
2011-11-01,Goldman Sachs,CitiBank Singapore,36879,88434,-51555
2011-12-01,Goldman Sachs,CitiBank Singapore,35336,86478,-51142
2012-01-01,Goldman Sachs,CitiBank Singapore,34519,85219,-50700
2012-02-01,Goldman Sachs,CitiBank Singapore,37113,85473,-48360
2012-03-01,Goldman Sachs,CitiBank Singapore,34672,86921,-52249
2012-04-01,Goldman Sachs,CitiBank Singapore,31689,82688,-50999
2012-05-01,Goldman Sachs,CitiBank Singapore,38197,89233,-51036
2012-06-01,Goldman Sachs,CitiBank Singapore,39681,88867,-49186
2012-07-01,Goldman Sachs,CitiBank Singapore,44672,83139,-38467
2012-08-01,Goldman Sachs,CitiBank Singapore,45796,81549,-35753
2012-09-01,Goldman Sachs,CitiBank Singapore,45228,81227,-35999
2012-10-01,Goldman Sachs,CitiBank Singapore,45756,84379,-38623
2012-11-01,Goldman Sachs,CitiBank Singapore,44497,82447,-37950
2012-12-01,Goldman Sachs,CitiBank Singapore,48632,87363,-38731
2013-01-01,Goldman Sachs,CitiBank Singapore,43957,87654,-43697
2013-02-01,Goldman Sachs,CitiBank Singapore,43757,85547,-41790
2013-03-01,Goldman Sachs,CitiBank Singapore,43576,86595,-43019
2013-04-01,Goldman Sachs,CitiBank Singapore,47893,86346,-38453
2013-05-01,Goldman Sachs,CitiBank Singapore,57687,74263,-16576
2013-06-01,Goldman Sachs,CitiBank Singapore,55211,76936,-21725
2013-07-01,Goldman Sachs,CitiBank Singapore,53746,72566,-18820
2013-08-01,Goldman Sachs,CitiBank Singapore,54224,77928,-23704
2013-09-01,Goldman Sachs,CitiBank Singapore,58223,73226,-15003
2013-10-01,Goldman Sachs,CitiBank Singapore,52416,77188,-24772
2013-11-01,Goldman Sachs,CitiBank Singapore,59457,74963,-15506
2013-12-01,Goldman Sachs,CitiBank Singapore,55614,74341,-18727
2014-01-01,Goldman Sachs,CitiBank Singapore,52265,76944,-24679
2014-02-01,Goldman Sachs,CitiBank Singapore,58595,77235,-18640
2014-03-01,Goldman Sachs,CitiBank Singapore,68585,71418,-2833
2014-04-01,Goldman Sachs,CitiBank Singapore,67966,76542,-8576
2014-05-01,Goldman Sachs,CitiBank Singapore,63343,76873,-13530
2014-06-01,Goldman Sachs,CitiBank Singapore,67465,72218,-4753
2014-07-01,Goldman Sachs,CitiBank Singapore,62827,78212,-15385
2014-08-01,Goldman Sachs,CitiBank Singapore,68736,79474,-10738
2014-09-01,Goldman Sachs,CitiBank Singapore,61467,77627,-16160
2014-10-01,Goldman Sachs,CitiBank Singapore,69356,74831,-5475
2014-11-01,Goldman Sachs,CitiBank Singapore,64875,73644,-8769
2014-12-01,Goldman Sachs,CitiBank Singapore,69645,78775,-9130
2015-01-01,Goldman Sachs,CitiBank Singapore,72617,62297,10320
2015-02-01,Goldman Sachs,CitiBank Singapore,78135,69929,8206
2015-03-01,Goldman Sachs,CitiBank Singapore,76479,64626,11853
2015-04-01,Goldman Sachs,CitiBank Singapore,73316,63597,9719
2015-05-01,Goldman Sachs,CitiBank Singapore,79148,61597,17551
2015-06-01,Goldman Sachs,CitiBank Singapore,73629,62342,11287
2015-07-01,Goldman Sachs,CitiBank Singapore,79554,61257,18297
2015-08-01,Goldman Sachs,CitiBank Singapore,78818,68878,9940
2015-09-01,Goldman Sachs,CitiBank Singapore,76126,61334,14792
2015-10-01,Goldman Sachs,CitiBank Singapore,73457,61829,11628
2015-11-01,Goldman Sachs,CitiBank Singapore,88755,63993,24762
2015-12-01,Goldman Sachs,CitiBank Singapore,82239,66796,15443
2016-01-01,Goldman Sachs,CitiBank Singapore,86991,67294,19697
2016-02-01,Goldman Sachs,CitiBank Singapore,87783,63341,24442
2016-03-01,Goldman Sachs,CitiBank Singapore,88213,65922,22291
2016-04-01,Goldman Sachs,CitiBank Singapore,85673,62438,23235
2016-05-01,Goldman Sachs,CitiBank Singapore,89754,64344,25410
2016-06-01,Goldman Sachs,CitiBank Singapore,85256,68198,17058
2016-07-01,Goldman Sachs,CitiBank Singapore,87411,64218,23193
2016-08-01,Goldman Sachs,CitiBank Singapore,88238,65762,22476
2016-09-01,Goldman Sachs,CitiBank Singapore,92344,54885,37459
2016-10-01,Goldman Sachs,CitiBank Singapore,98193,57147,41046
2016-11-01,Goldman Sachs,CitiBank Singapore,95669,58864,36805
2016-12-01,Goldman Sachs,CitiBank Singapore,92127,57222,34905
2017-01-01,Goldman Sachs,CitiBank Singapore,94936,57863,37073
2017-02-01,Goldman Sachs,CitiBank Singapore,97342,55662,41680
2017-03-01,Goldman Sachs,CitiBank Singapore,95248,55636,39612
2017-04-01,Goldman Sachs,CitiBank Singapore,94649,53619,41030
2017-05-01,Goldman Sachs,CitiBank Singapore,98497,59537,38960
2017-06-01,Goldman Sachs,CitiBank Singapore,92577,57243,35334
2017-07-01,Goldman Sachs,CitiBank Singapore,105984,55588,50396
2017-08-01,Goldman Sachs,CitiBank Singapore,107411,58794,48617
2017-09-01,Goldman Sachs,CitiBank Singapore,104248,55888,48360
2017-10-01,Goldman Sachs,CitiBank Singapore,101329,56689,44640
2017-11-01,Goldman Sachs,CitiBank Singapore,103649,53984,49665
2017-12-01,Goldman Sachs,CitiBank Singapore,108683,55759,52924
2018-01-01,Goldman Sachs,CitiBank Singapore,107733,53271,54462
2018-02-01,Goldman Sachs,CitiBank Singapore,104547,56776,47771
2018-03-01,Goldman Sachs,CitiBank Singapore,101838,55731,46107
2018-04-01,Goldman Sachs,CitiBank Singapore,106977,51484,55493
2010-01-01,Goldman Sachs,CitiBank HongKong,18544,92126,-73582
2010-02-01,Goldman Sachs,CitiBank HongKong,13743,94587,-80844
2010-03-01,Goldman Sachs,CitiBank HongKong,13762,99666,-85904
2010-04-01,Goldman Sachs,CitiBank HongKong,18218,96118,-77900
2010-05-01,Goldman Sachs,CitiBank HongKong,13765,99936,-86171
2010-06-01,Goldman Sachs,CitiBank HongKong,18292,95939,-77647
2010-07-01,Goldman Sachs,CitiBank HongKong,18499,95978,-77479
2010-08-01,Goldman Sachs,CitiBank HongKong,14379,94234,-79855
2010-09-01,Goldman Sachs,CitiBank HongKong,14454,94842,-80388
2010-10-01,Goldman Sachs,CitiBank HongKong,18466,99476,-81010
2010-11-01,Goldman Sachs,CitiBank HongKong,23849,92979,-69130
2010-12-01,Goldman Sachs,CitiBank HongKong,29722,94365,-64643
2011-01-01,Goldman Sachs,CitiBank HongKong,23553,98686,-75133
2011-02-01,Goldman Sachs,CitiBank HongKong,22937,96268,-73331
2011-03-01,Goldman Sachs,CitiBank HongKong,22883,96123,-73240
2011-04-01,Goldman Sachs,CitiBank HongKong,25116,94888,-69772
2011-05-01,Goldman Sachs,CitiBank HongKong,27644,91352,-63708
2011-06-01,Goldman Sachs,CitiBank HongKong,28597,97277,-68680
2011-07-01,Goldman Sachs,CitiBank HongKong,22386,92719,-70333
2011-08-01,Goldman Sachs,CitiBank HongKong,29922,99657,-69735
2011-09-01,Goldman Sachs,CitiBank HongKong,39359,88752,-49393
2011-10-01,Goldman Sachs,CitiBank HongKong,39442,85316,-45874
2011-11-01,Goldman Sachs,CitiBank HongKong,33474,86215,-52741
2011-12-01,Goldman Sachs,CitiBank HongKong,37891,84558,-46667
2012-01-01,Goldman Sachs,CitiBank HongKong,37324,86294,-48970
2012-02-01,Goldman Sachs,CitiBank HongKong,38144,82761,-44617
2012-03-01,Goldman Sachs,CitiBank HongKong,39816,81476,-41660
2012-04-01,Goldman Sachs,CitiBank HongKong,37327,85259,-47932
2012-05-01,Goldman Sachs,CitiBank HongKong,34574,85514,-50940
2012-06-01,Goldman Sachs,CitiBank HongKong,33714,88298,-54584
2012-07-01,Goldman Sachs,CitiBank HongKong,48945,87987,-39042
2012-08-01,Goldman Sachs,CitiBank HongKong,49564,82182,-32618
2012-09-01,Goldman Sachs,CitiBank HongKong,49951,88764,-38813
2012-10-01,Goldman Sachs,CitiBank HongKong,45966,85985,-40019
2012-11-01,Goldman Sachs,CitiBank HongKong,41839,84769,-42930
2012-12-01,Goldman Sachs,CitiBank HongKong,47716,81312,-33596
2013-01-01,Goldman Sachs,CitiBank HongKong,48565,83464,-34899
2013-02-01,Goldman Sachs,CitiBank HongKong,41858,82728,-40870
2013-03-01,Goldman Sachs,CitiBank HongKong,45953,84182,-38229
2013-04-01,Goldman Sachs,CitiBank HongKong,46271,89297,-43026
2013-05-01,Goldman Sachs,CitiBank HongKong,59692,78272,-18580
2013-06-01,Goldman Sachs,CitiBank HongKong,52687,79868,-27181
2013-07-01,Goldman Sachs,CitiBank HongKong,57143,75244,-18101
2013-08-01,Goldman Sachs,CitiBank HongKong,51127,75387,-24260
2013-09-01,Goldman Sachs,CitiBank HongKong,57631,73287,-15656
2013-10-01,Goldman Sachs,CitiBank HongKong,55942,73314,-17372
2013-11-01,Goldman Sachs,CitiBank HongKong,59635,75349,-15714
2013-12-01,Goldman Sachs,CitiBank HongKong,52134,78848,-26714
2014-01-01,Goldman Sachs,CitiBank HongKong,56874,72859,-15985
2014-02-01,Goldman Sachs,CitiBank HongKong,51944,77638,-25694
2014-03-01,Goldman Sachs,CitiBank HongKong,69594,79628,-10034
2014-04-01,Goldman Sachs,CitiBank HongKong,64984,77383,-12399
2014-05-01,Goldman Sachs,CitiBank HongKong,63511,71923,-8412
2014-06-01,Goldman Sachs,CitiBank HongKong,61659,72772,-11113
2014-07-01,Goldman Sachs,CitiBank HongKong,64535,71896,-7361
2014-08-01,Goldman Sachs,CitiBank HongKong,65899,75192,-9293
2014-09-01,Goldman Sachs,CitiBank HongKong,69792,71424,-1632
2014-10-01,Goldman Sachs,CitiBank HongKong,67196,78631,-11435
2014-11-01,Goldman Sachs,CitiBank HongKong,61162,76419,-15257
2014-12-01,Goldman Sachs,CitiBank HongKong,67596,72251,-4655
2015-01-01,Goldman Sachs,CitiBank HongKong,76166,63676,12490
2015-02-01,Goldman Sachs,CitiBank HongKong,72343,68696,3647
2015-03-01,Goldman Sachs,CitiBank HongKong,78976,63295,15681
2015-04-01,Goldman Sachs,CitiBank HongKong,78652,63146,15506
2015-05-01,Goldman Sachs,CitiBank HongKong,78863,68921,9942
2015-06-01,Goldman Sachs,CitiBank HongKong,74415,61983,12432
2015-07-01,Goldman Sachs,CitiBank HongKong,76474,67613,8861
2015-08-01,Goldman Sachs,CitiBank HongKong,74541,67886,6655
2015-09-01,Goldman Sachs,CitiBank HongKong,77198,62634,14564
2015-10-01,Goldman Sachs,CitiBank HongKong,78337,61813,16524
2015-11-01,Goldman Sachs,CitiBank HongKong,84183,69217,14966
2015-12-01,Goldman Sachs,CitiBank HongKong,89582,62877,26705
2016-01-01,Goldman Sachs,CitiBank HongKong,83223,62332,20891
2016-02-01,Goldman Sachs,CitiBank HongKong,83278,68888,14390
2016-03-01,Goldman Sachs,CitiBank HongKong,83857,64961,18896
2016-04-01,Goldman Sachs,CitiBank HongKong,88215,62191,26024
2016-05-01,Goldman Sachs,CitiBank HongKong,85282,61345,23937
2016-06-01,Goldman Sachs,CitiBank HongKong,85914,62738,23176
2016-07-01,Goldman Sachs,CitiBank HongKong,83473,63113,20360
2016-08-01,Goldman Sachs,CitiBank HongKong,84319,69863,14456
2016-09-01,Goldman Sachs,CitiBank HongKong,98894,59463,39431
2016-10-01,Goldman Sachs,CitiBank HongKong,98785,51883,46902
2016-11-01,Goldman Sachs,CitiBank HongKong,98236,57497,40739
2016-12-01,Goldman Sachs,CitiBank HongKong,96459,56483,39976
2017-01-01,Goldman Sachs,CitiBank HongKong,98864,52425,46439
2017-02-01,Goldman Sachs,CitiBank HongKong,93642,59753,33889
2017-03-01,Goldman Sachs,CitiBank HongKong,96748,58637,38111
2017-04-01,Goldman Sachs,CitiBank HongKong,98733,59665,39068
2017-05-01,Goldman Sachs,CitiBank HongKong,97772,54254,43518
2017-06-01,Goldman Sachs,CitiBank HongKong,93543,54512,39031
2017-07-01,Goldman Sachs,CitiBank HongKong,106698,53173,53525
2017-08-01,Goldman Sachs,CitiBank HongKong,104241,53625,50616
2017-09-01,Goldman Sachs,CitiBank HongKong,107321,53214,54107
2017-10-01,Goldman Sachs,CitiBank HongKong,109497,58682,50815
2017-11-01,Goldman Sachs,CitiBank HongKong,109536,58276,51260
2017-12-01,Goldman Sachs,CitiBank HongKong,103753,57139,46614
2018-01-01,Goldman Sachs,CitiBank HongKong,104173,54711,49462
2018-02-01,Goldman Sachs,CitiBank HongKong,106821,52346,54475
2018-03-01,Goldman Sachs,CitiBank HongKong,103938,56792,47146
2018-04-01,Goldman Sachs,CitiBank HongKong,102185,52117,50068
2010-01-01,Deutsche Bank,CitiBank New York,15718,91598,-75880
2010-02-01,Deutsche Bank,CitiBank New York,18888,91383,-72495
2010-03-01,Deutsche Bank,CitiBank New York,16812,96843,-80031
2010-04-01,Deutsche Bank,CitiBank New York,19458,91281,-71823
2010-05-01,Deutsche Bank,CitiBank New York,19438,97564,-78126
2010-06-01,Deutsche Bank,CitiBank New York,16193,98485,-82292
2010-07-01,Deutsche Bank,CitiBank New York,16915,93397,-76482
2010-08-01,Deutsche Bank,CitiBank New York,19436,97342,-77906
2010-09-01,Deutsche Bank,CitiBank New York,19933,99513,-79580
2010-10-01,Deutsche Bank,CitiBank New York,19734,95382,-75648
2010-11-01,Deutsche Bank,CitiBank New York,22165,94771,-72606
2010-12-01,Deutsche Bank,CitiBank New York,28552,99847,-71295
2011-01-01,Deutsche Bank,CitiBank New York,26237,92826,-66589
2011-02-01,Deutsche Bank,CitiBank New York,22997,97288,-74291
2011-03-01,Deutsche Bank,CitiBank New York,21187,96715,-75528
2011-04-01,Deutsche Bank,CitiBank New York,21399,92428,-71029
2011-05-01,Deutsche Bank,CitiBank New York,24724,96713,-71989
2011-06-01,Deutsche Bank,CitiBank New York,21661,94397,-72736
2011-07-01,Deutsche Bank,CitiBank New York,26469,91457,-64988
2011-08-01,Deutsche Bank,CitiBank New York,27144,97772,-70628
2011-09-01,Deutsche Bank,CitiBank New York,34693,84633,-49940
2011-10-01,Deutsche Bank,CitiBank New York,34946,88715,-53769
2011-11-01,Deutsche Bank,CitiBank New York,39329,81936,-42607
2011-12-01,Deutsche Bank,CitiBank New York,34557,84289,-49732
2012-01-01,Deutsche Bank,CitiBank New York,31333,85667,-54334
2012-02-01,Deutsche Bank,CitiBank New York,38433,84734,-46301
2012-03-01,Deutsche Bank,CitiBank New York,31344,85987,-54643
2012-04-01,Deutsche Bank,CitiBank New York,37124,88667,-51543
2012-05-01,Deutsche Bank,CitiBank New York,37889,82669,-44780
2012-06-01,Deutsche Bank,CitiBank New York,34252,81667,-47415
2012-07-01,Deutsche Bank,CitiBank New York,41431,83866,-42435
2012-08-01,Deutsche Bank,CitiBank New York,43437,89656,-46219
2012-09-01,Deutsche Bank,CitiBank New York,43921,87556,-43635
2012-10-01,Deutsche Bank,CitiBank New York,48932,86734,-37802
2012-11-01,Deutsche Bank,CitiBank New York,46957,87597,-40640
2012-12-01,Deutsche Bank,CitiBank New York,45352,84381,-39029
2013-01-01,Deutsche Bank,CitiBank New York,44252,89532,-45280
2013-02-01,Deutsche Bank,CitiBank New York,46524,81797,-35273
2013-03-01,Deutsche Bank,CitiBank New York,43965,81341,-37376
2013-04-01,Deutsche Bank,CitiBank New York,45911,85851,-39940
2013-05-01,Deutsche Bank,CitiBank New York,51938,71476,-19538
2013-06-01,Deutsche Bank,CitiBank New York,59913,77589,-17676
2013-07-01,Deutsche Bank,CitiBank New York,56841,75161,-18320
2013-08-01,Deutsche Bank,CitiBank New York,58441,75594,-17153
2013-09-01,Deutsche Bank,CitiBank New York,54214,71162,-16948
2013-10-01,Deutsche Bank,CitiBank New York,55962,75571,-19609
2013-11-01,Deutsche Bank,CitiBank New York,56321,71857,-15536
2013-12-01,Deutsche Bank,CitiBank New York,56497,71872,-15375
2014-01-01,Deutsche Bank,CitiBank New York,53433,71133,-17700
2014-02-01,Deutsche Bank,CitiBank New York,51468,77942,-26474
2014-03-01,Deutsche Bank,CitiBank New York,63426,76436,-13010
2014-04-01,Deutsche Bank,CitiBank New York,66897,71411,-4514
2014-05-01,Deutsche Bank,CitiBank New York,61755,79954,-18199
2014-06-01,Deutsche Bank,CitiBank New York,61474,79615,-18141
2014-07-01,Deutsche Bank,CitiBank New York,69618,71145,-1527
2014-08-01,Deutsche Bank,CitiBank New York,66837,79626,-12789
2014-09-01,Deutsche Bank,CitiBank New York,64686,79766,-15080
2014-10-01,Deutsche Bank,CitiBank New York,63811,76881,-13070
2014-11-01,Deutsche Bank,CitiBank New York,61929,79771,-17842
2014-12-01,Deutsche Bank,CitiBank New York,62972,73934,-10962
2015-01-01,Deutsche Bank,CitiBank New York,74692,68625,6067
2015-02-01,Deutsche Bank,CitiBank New York,73164,61542,11622
2015-03-01,Deutsche Bank,CitiBank New York,74588,68246,6342
2015-04-01,Deutsche Bank,CitiBank New York,77638,65815,11823
2015-05-01,Deutsche Bank,CitiBank New York,79756,61292,18464
2015-06-01,Deutsche Bank,CitiBank New York,76191,67493,8698
2015-07-01,Deutsche Bank,CitiBank New York,71933,69438,2495
2015-08-01,Deutsche Bank,CitiBank New York,71557,65893,5664
2015-09-01,Deutsche Bank,CitiBank New York,73381,61619,11762
2015-10-01,Deutsche Bank,CitiBank New York,76459,65679,10780
2015-11-01,Deutsche Bank,CitiBank New York,84172,61844,22328
2015-12-01,Deutsche Bank,CitiBank New York,86818,66937,19881
2016-01-01,Deutsche Bank,CitiBank New York,82939,64781,18158
2016-02-01,Deutsche Bank,CitiBank New York,82611,66183,16428
2016-03-01,Deutsche Bank,CitiBank New York,81939,67218,14721
2016-04-01,Deutsche Bank,CitiBank New York,87877,67919,19958
2016-05-01,Deutsche Bank,CitiBank New York,88616,64962,23654
2016-06-01,Deutsche Bank,CitiBank New York,83142,64922,18220
2016-07-01,Deutsche Bank,CitiBank New York,86243,61553,24690
2016-08-01,Deutsche Bank,CitiBank New York,85237,62987,22250
2016-09-01,Deutsche Bank,CitiBank New York,96282,53771,42511
2016-10-01,Deutsche Bank,CitiBank New York,98511,52968,45543
2016-11-01,Deutsche Bank,CitiBank New York,97387,56283,41104
2016-12-01,Deutsche Bank,CitiBank New York,96567,54815,41752
2017-01-01,Deutsche Bank,CitiBank New York,99957,58422,41535
2017-02-01,Deutsche Bank,CitiBank New York,99872,55932,43940
2017-03-01,Deutsche Bank,CitiBank New York,96372,56192,40180
2017-04-01,Deutsche Bank,CitiBank New York,99173,58292,40881
2017-05-01,Deutsche Bank,CitiBank New York,97563,56863,40700
2017-06-01,Deutsche Bank,CitiBank New York,96914,52967,43947
2017-07-01,Deutsche Bank,CitiBank New York,108485,59744,48741
2017-08-01,Deutsche Bank,CitiBank New York,108238,53271,54967
2017-09-01,Deutsche Bank,CitiBank New York,101677,57454,44223
2017-10-01,Deutsche Bank,CitiBank New York,106329,52568,53761
2017-11-01,Deutsche Bank,CitiBank New York,105275,51119,54156
2017-12-01,Deutsche Bank,CitiBank New York,107948,55666,52282
2018-01-01,Deutsche Bank,CitiBank New York,109595,59969,49626
2018-02-01,Deutsche Bank,CitiBank New York,103997,55664,48333
2018-03-01,Deutsche Bank,CitiBank New York,105719,56583,49136
2018-04-01,Deutsche Bank,CitiBank New York,109747,57247,52500
2010-01-01,Deutsche Bank,CitiBank London,17442,95369,-77927
2010-02-01,Deutsche Bank,CitiBank London,13117,91911,-78794
2010-03-01,Deutsche Bank,CitiBank London,19288,99612,-80324
2010-04-01,Deutsche Bank,CitiBank London,16352,94124,-77772
2010-05-01,Deutsche Bank,CitiBank London,19786,97917,-78131
2010-06-01,Deutsche Bank,CitiBank London,12518,98267,-85749
2010-07-01,Deutsche Bank,CitiBank London,19499,92227,-72728
2010-08-01,Deutsche Bank,CitiBank London,11244,93862,-82618
2010-09-01,Deutsche Bank,CitiBank London,16533,97641,-81108
2010-10-01,Deutsche Bank,CitiBank London,12291,93985,-81694
2010-11-01,Deutsche Bank,CitiBank London,29249,92631,-63382
2010-12-01,Deutsche Bank,CitiBank London,28693,94332,-65639
2011-01-01,Deutsche Bank,CitiBank London,24299,99913,-75614
2011-02-01,Deutsche Bank,CitiBank London,25434,99218,-73784
2011-03-01,Deutsche Bank,CitiBank London,23196,92874,-69678
2011-04-01,Deutsche Bank,CitiBank London,21446,96556,-75110
2011-05-01,Deutsche Bank,CitiBank London,23883,97369,-73486
2011-06-01,Deutsche Bank,CitiBank London,22164,99746,-77582
2011-07-01,Deutsche Bank,CitiBank London,25656,93335,-67679
2011-08-01,Deutsche Bank,CitiBank London,23365,92113,-68748
2011-09-01,Deutsche Bank,CitiBank London,31352,82325,-50973
2011-10-01,Deutsche Bank,CitiBank London,36525,83139,-46614
2011-11-01,Deutsche Bank,CitiBank London,34436,89384,-54948
2011-12-01,Deutsche Bank,CitiBank London,31745,89947,-58202
2012-01-01,Deutsche Bank,CitiBank London,34195,84986,-50791
2012-02-01,Deutsche Bank,CitiBank London,37218,85985,-48767
2012-03-01,Deutsche Bank,CitiBank London,37561,82733,-45172
2012-04-01,Deutsche Bank,CitiBank London,31283,86551,-55268
2012-05-01,Deutsche Bank,CitiBank London,32321,87725,-55404
2012-06-01,Deutsche Bank,CitiBank London,31427,89897,-58470
2012-07-01,Deutsche Bank,CitiBank London,43166,89184,-46018
2012-08-01,Deutsche Bank,CitiBank London,42656,81175,-38519
2012-09-01,Deutsche Bank,CitiBank London,46419,86114,-39695
2012-10-01,Deutsche Bank,CitiBank London,41995,87552,-45557
2012-11-01,Deutsche Bank,CitiBank London,42726,83689,-40963
2012-12-01,Deutsche Bank,CitiBank London,48297,82385,-34088
2013-01-01,Deutsche Bank,CitiBank London,47756,85783,-38027
2013-02-01,Deutsche Bank,CitiBank London,47646,84136,-36490
2013-03-01,Deutsche Bank,CitiBank London,46473,85851,-39378
2013-04-01,Deutsche Bank,CitiBank London,42524,86518,-43994
2013-05-01,Deutsche Bank,CitiBank London,57764,78997,-21233
2013-06-01,Deutsche Bank,CitiBank London,54257,72481,-18224
2013-07-01,Deutsche Bank,CitiBank London,52131,76156,-24025
2013-08-01,Deutsche Bank,CitiBank London,55549,78477,-22928
2013-09-01,Deutsche Bank,CitiBank London,59542,78318,-18776
2013-10-01,Deutsche Bank,CitiBank London,57985,79296,-21311
2013-11-01,Deutsche Bank,CitiBank London,54954,76114,-21160
2013-12-01,Deutsche Bank,CitiBank London,55524,76138,-20614
2014-01-01,Deutsche Bank,CitiBank London,55369,77251,-21882
2014-02-01,Deutsche Bank,CitiBank London,51686,77355,-25669
2014-03-01,Deutsche Bank,CitiBank London,63123,77997,-14874
2014-04-01,Deutsche Bank,CitiBank London,63341,74841,-11500
2014-05-01,Deutsche Bank,CitiBank London,62765,78278,-15513
2014-06-01,Deutsche Bank,CitiBank London,63458,76255,-12797
2014-07-01,Deutsche Bank,CitiBank London,61653,72895,-11242
2014-08-01,Deutsche Bank,CitiBank London,65281,78327,-13046
2014-09-01,Deutsche Bank,CitiBank London,65738,78555,-12817
2014-10-01,Deutsche Bank,CitiBank London,61577,72185,-10608
2014-11-01,Deutsche Bank,CitiBank London,66961,71446,-4485
2014-12-01,Deutsche Bank,CitiBank London,63414,73775,-10361
2015-01-01,Deutsche Bank,CitiBank London,72593,64438,8155
2015-02-01,Deutsche Bank,CitiBank London,76749,63533,13216
2015-03-01,Deutsche Bank,CitiBank London,79972,64941,15031
2015-04-01,Deutsche Bank,CitiBank London,78529,67653,10876
2015-05-01,Deutsche Bank,CitiBank London,77657,62977,14680
2015-06-01,Deutsche Bank,CitiBank London,78781,69893,8888
2015-07-01,Deutsche Bank,CitiBank London,72595,68584,4011
2015-08-01,Deutsche Bank,CitiBank London,72129,64631,7498
2015-09-01,Deutsche Bank,CitiBank London,79481,65842,13639
2015-10-01,Deutsche Bank,CitiBank London,78327,63527,14800
2015-11-01,Deutsche Bank,CitiBank London,84384,69156,15228
2015-12-01,Deutsche Bank,CitiBank London,86418,61591,24827
2016-01-01,Deutsche Bank,CitiBank London,83295,65987,17308
2016-02-01,Deutsche Bank,CitiBank London,87616,66715,20901
2016-03-01,Deutsche Bank,CitiBank London,89881,62411,27470
2016-04-01,Deutsche Bank,CitiBank London,83818,62561,21257
2016-05-01,Deutsche Bank,CitiBank London,83687,64323,19364
2016-06-01,Deutsche Bank,CitiBank London,81871,67712,14159
2016-07-01,Deutsche Bank,CitiBank London,84246,66725,17521
2016-08-01,Deutsche Bank,CitiBank London,83989,66535,17454
2016-09-01,Deutsche Bank,CitiBank London,96189,57912,38277
2016-10-01,Deutsche Bank,CitiBank London,93998,55558,38440
2016-11-01,Deutsche Bank,CitiBank London,97121,59883,37238
2016-12-01,Deutsche Bank,CitiBank London,94783,54189,40594
2017-01-01,Deutsche Bank,CitiBank London,91166,59986,31180
2017-02-01,Deutsche Bank,CitiBank London,93827,52876,40951
2017-03-01,Deutsche Bank,CitiBank London,94966,57575,37391
2017-04-01,Deutsche Bank,CitiBank London,95397,57453,37944
2017-05-01,Deutsche Bank,CitiBank London,99496,53585,45911
2017-06-01,Deutsche Bank,CitiBank London,92669,59655,33014
2017-07-01,Deutsche Bank,CitiBank London,103145,51386,51759
2017-08-01,Deutsche Bank,CitiBank London,107153,54783,52370
2017-09-01,Deutsche Bank,CitiBank London,104129,54635,49494
2017-10-01,Deutsche Bank,CitiBank London,105153,55419,49734
2017-11-01,Deutsche Bank,CitiBank London,109634,58591,51043
2017-12-01,Deutsche Bank,CitiBank London,101654,53294,48360
2018-01-01,Deutsche Bank,CitiBank London,107836,57488,50348
2018-02-01,Deutsche Bank,CitiBank London,102883,56942,45941
2018-03-01,Deutsche Bank,CitiBank London,102152,57521,44631
2018-04-01,Deutsche Bank,CitiBank London,108559,52457,56102
2010-01-01,Deutsche Bank,CitiBank Pune,15795,93426,-77631
2010-02-01,Deutsche Bank,CitiBank Pune,12338,97788,-85450
2010-03-01,Deutsche Bank,CitiBank Pune,13456,92863,-79407
2010-04-01,Deutsche Bank,CitiBank Pune,17931,94962,-77031
2010-05-01,Deutsche Bank,CitiBank Pune,11234,98474,-87240
2010-06-01,Deutsche Bank,CitiBank Pune,17752,99885,-82133
2010-07-01,Deutsche Bank,CitiBank Pune,12877,98266,-85389
2010-08-01,Deutsche Bank,CitiBank Pune,12914,98627,-85713
2010-09-01,Deutsche Bank,CitiBank Pune,18561,96477,-77916
2010-10-01,Deutsche Bank,CitiBank Pune,19219,95713,-76494
2010-11-01,Deutsche Bank,CitiBank Pune,28173,99247,-71074
2010-12-01,Deutsche Bank,CitiBank Pune,29589,93846,-64257
2011-01-01,Deutsche Bank,CitiBank Pune,25747,98677,-72930
2011-02-01,Deutsche Bank,CitiBank Pune,29968,99916,-69948
2011-03-01,Deutsche Bank,CitiBank Pune,23232,97852,-74620
2011-04-01,Deutsche Bank,CitiBank Pune,25255,91197,-65942
2011-05-01,Deutsche Bank,CitiBank Pune,23947,94532,-70585
2011-06-01,Deutsche Bank,CitiBank Pune,22344,92224,-69880
2011-07-01,Deutsche Bank,CitiBank Pune,27128,92575,-65447
2011-08-01,Deutsche Bank,CitiBank Pune,28838,91738,-62900
2011-09-01,Deutsche Bank,CitiBank Pune,38988,84415,-45427
2011-10-01,Deutsche Bank,CitiBank Pune,33554,81265,-47711
2011-11-01,Deutsche Bank,CitiBank Pune,33917,83879,-49962
2011-12-01,Deutsche Bank,CitiBank Pune,31282,83535,-52253
2012-01-01,Deutsche Bank,CitiBank Pune,36974,89493,-52519
2012-02-01,Deutsche Bank,CitiBank Pune,38913,86925,-48012
2012-03-01,Deutsche Bank,CitiBank Pune,39823,82833,-43010
2012-04-01,Deutsche Bank,CitiBank Pune,37814,87292,-49478
2012-05-01,Deutsche Bank,CitiBank Pune,34858,88499,-53641
2012-06-01,Deutsche Bank,CitiBank Pune,36821,89119,-52298
2012-07-01,Deutsche Bank,CitiBank Pune,41895,84335,-42440
2012-08-01,Deutsche Bank,CitiBank Pune,43862,87527,-43665
2012-09-01,Deutsche Bank,CitiBank Pune,49456,84594,-35138
2012-10-01,Deutsche Bank,CitiBank Pune,44838,88798,-43960
2012-11-01,Deutsche Bank,CitiBank Pune,41984,84926,-42942
2012-12-01,Deutsche Bank,CitiBank Pune,43778,89613,-45835
2013-01-01,Deutsche Bank,CitiBank Pune,43645,82173,-38528
2013-02-01,Deutsche Bank,CitiBank Pune,46413,85418,-39005
2013-03-01,Deutsche Bank,CitiBank Pune,42684,87474,-44790
2013-04-01,Deutsche Bank,CitiBank Pune,43949,85528,-41579
2013-05-01,Deutsche Bank,CitiBank Pune,53669,72483,-18814
2013-06-01,Deutsche Bank,CitiBank Pune,54627,74899,-20272
2013-07-01,Deutsche Bank,CitiBank Pune,51978,78257,-26279
2013-08-01,Deutsche Bank,CitiBank Pune,55259,71664,-16405
2013-09-01,Deutsche Bank,CitiBank Pune,52836,76794,-23958
2013-10-01,Deutsche Bank,CitiBank Pune,58827,78399,-19572
2013-11-01,Deutsche Bank,CitiBank Pune,56955,73878,-16923
2013-12-01,Deutsche Bank,CitiBank Pune,51622,77411,-25789
2014-01-01,Deutsche Bank,CitiBank Pune,52314,72552,-20238
2014-02-01,Deutsche Bank,CitiBank Pune,56362,72896,-16534
2014-03-01,Deutsche Bank,CitiBank Pune,62881,76447,-13566
2014-04-01,Deutsche Bank,CitiBank Pune,69566,77553,-7987
2014-05-01,Deutsche Bank,CitiBank Pune,64991,78157,-13166
2014-06-01,Deutsche Bank,CitiBank Pune,62226,79562,-17336
2014-07-01,Deutsche Bank,CitiBank Pune,64117,71874,-7757
2014-08-01,Deutsche Bank,CitiBank Pune,62913,75884,-12971
2014-09-01,Deutsche Bank,CitiBank Pune,69823,73965,-4142
2014-10-01,Deutsche Bank,CitiBank Pune,69594,75331,-5737
2014-11-01,Deutsche Bank,CitiBank Pune,62849,78774,-15925
2014-12-01,Deutsche Bank,CitiBank Pune,62496,75361,-12865
2015-01-01,Deutsche Bank,CitiBank Pune,77662,67951,9711
2015-02-01,Deutsche Bank,CitiBank Pune,73486,69714,3772
2015-03-01,Deutsche Bank,CitiBank Pune,78515,62582,15933
2015-04-01,Deutsche Bank,CitiBank Pune,71674,65838,5836
2015-05-01,Deutsche Bank,CitiBank Pune,79944,65382,14562
2015-06-01,Deutsche Bank,CitiBank Pune,79923,68817,11106
2015-07-01,Deutsche Bank,CitiBank Pune,78526,68645,9881
2015-08-01,Deutsche Bank,CitiBank Pune,76476,61144,15332
2015-09-01,Deutsche Bank,CitiBank Pune,75645,63628,12017
2015-10-01,Deutsche Bank,CitiBank Pune,78524,65919,12605
2015-11-01,Deutsche Bank,CitiBank Pune,87287,62333,24954
2015-12-01,Deutsche Bank,CitiBank Pune,82214,63379,18835
2016-01-01,Deutsche Bank,CitiBank Pune,85948,64766,21182
2016-02-01,Deutsche Bank,CitiBank Pune,86867,65948,20919
2016-03-01,Deutsche Bank,CitiBank Pune,87892,69415,18477
2016-04-01,Deutsche Bank,CitiBank Pune,89522,62538,26984
2016-05-01,Deutsche Bank,CitiBank Pune,86298,64482,21816
2016-06-01,Deutsche Bank,CitiBank Pune,85338,65286,20052
2016-07-01,Deutsche Bank,CitiBank Pune,87817,61267,26550
2016-08-01,Deutsche Bank,CitiBank Pune,89486,65673,23813
2016-09-01,Deutsche Bank,CitiBank Pune,92644,59259,33385
2016-10-01,Deutsche Bank,CitiBank Pune,93928,56139,37789
2016-11-01,Deutsche Bank,CitiBank Pune,99135,57513,41622
2016-12-01,Deutsche Bank,CitiBank Pune,97621,55823,41798
2017-01-01,Deutsche Bank,CitiBank Pune,99978,59738,40240
2017-02-01,Deutsche Bank,CitiBank Pune,97155,54175,42980
2017-03-01,Deutsche Bank,CitiBank Pune,91566,58485,33081
2017-04-01,Deutsche Bank,CitiBank Pune,96223,59651,36572
2017-05-01,Deutsche Bank,CitiBank Pune,92116,53617,38499
2017-06-01,Deutsche Bank,CitiBank Pune,99315,55743,43572
2017-07-01,Deutsche Bank,CitiBank Pune,103799,54933,48866
2017-08-01,Deutsche Bank,CitiBank Pune,104332,55588,48744
2017-09-01,Deutsche Bank,CitiBank Pune,104489,51324,53165
2017-10-01,Deutsche Bank,CitiBank Pune,102574,56681,45893
2017-11-01,Deutsche Bank,CitiBank Pune,106719,56235,50484
2017-12-01,Deutsche Bank,CitiBank Pune,105669,59684,45985
2018-01-01,Deutsche Bank,CitiBank Pune,103184,57976,45208
2018-02-01,Deutsche Bank,CitiBank Pune,109852,57583,52269
2018-03-01,Deutsche Bank,CitiBank Pune,108549,56656,51893
2018-04-01,Deutsche Bank,CitiBank Pune,101715,59441,42274
2010-01-01,Deutsche Bank,CitiBank Singapore,14564,96188,-81624
2010-02-01,Deutsche Bank,CitiBank Singapore,19937,94128,-74191
2010-03-01,Deutsche Bank,CitiBank Singapore,12883,96672,-83789
2010-04-01,Deutsche Bank,CitiBank Singapore,15941,94642,-78701
2010-05-01,Deutsche Bank,CitiBank Singapore,13148,95864,-82716
2010-06-01,Deutsche Bank,CitiBank Singapore,18839,93944,-75105
2010-07-01,Deutsche Bank,CitiBank Singapore,17411,95183,-77772
2010-08-01,Deutsche Bank,CitiBank Singapore,14338,92838,-78500
2010-09-01,Deutsche Bank,CitiBank Singapore,11856,94516,-82660
2010-10-01,Deutsche Bank,CitiBank Singapore,19771,93278,-73507
2010-11-01,Deutsche Bank,CitiBank Singapore,27315,97266,-69951
2010-12-01,Deutsche Bank,CitiBank Singapore,26655,94116,-67461
2011-01-01,Deutsche Bank,CitiBank Singapore,29432,93311,-63879
2011-02-01,Deutsche Bank,CitiBank Singapore,28286,92741,-64455
2011-03-01,Deutsche Bank,CitiBank Singapore,24125,92922,-68797
2011-04-01,Deutsche Bank,CitiBank Singapore,22654,98642,-75988
2011-05-01,Deutsche Bank,CitiBank Singapore,23739,96946,-73207
2011-06-01,Deutsche Bank,CitiBank Singapore,22775,92633,-69858
2011-07-01,Deutsche Bank,CitiBank Singapore,29462,98644,-69182
2011-08-01,Deutsche Bank,CitiBank Singapore,21273,94114,-72841
2011-09-01,Deutsche Bank,CitiBank Singapore,36344,84766,-48422
2011-10-01,Deutsche Bank,CitiBank Singapore,33463,82898,-49435
2011-11-01,Deutsche Bank,CitiBank Singapore,37257,86843,-49586
2011-12-01,Deutsche Bank,CitiBank Singapore,36942,84461,-47519
2012-01-01,Deutsche Bank,CitiBank Singapore,33336,82339,-49003
2012-02-01,Deutsche Bank,CitiBank Singapore,38295,81122,-42827
2012-03-01,Deutsche Bank,CitiBank Singapore,32934,86455,-53521
2012-04-01,Deutsche Bank,CitiBank Singapore,39421,82967,-43546
2012-05-01,Deutsche Bank,CitiBank Singapore,35743,83332,-47589
2012-06-01,Deutsche Bank,CitiBank Singapore,33826,89666,-55840
2012-07-01,Deutsche Bank,CitiBank Singapore,43382,82542,-39160
2012-08-01,Deutsche Bank,CitiBank Singapore,41691,88247,-46556
2012-09-01,Deutsche Bank,CitiBank Singapore,41324,89999,-48675
2012-10-01,Deutsche Bank,CitiBank Singapore,49895,84611,-34716
2012-11-01,Deutsche Bank,CitiBank Singapore,43533,85777,-42244
2012-12-01,Deutsche Bank,CitiBank Singapore,48991,82964,-33973
2013-01-01,Deutsche Bank,CitiBank Singapore,47426,81311,-33885
2013-02-01,Deutsche Bank,CitiBank Singapore,43247,86571,-43324
2013-03-01,Deutsche Bank,CitiBank Singapore,46498,85753,-39255
2013-04-01,Deutsche Bank,CitiBank Singapore,45992,81123,-35131
2013-05-01,Deutsche Bank,CitiBank Singapore,56613,74885,-18272
2013-06-01,Deutsche Bank,CitiBank Singapore,51832,77425,-25593
2013-07-01,Deutsche Bank,CitiBank Singapore,57922,77557,-19635
2013-08-01,Deutsche Bank,CitiBank Singapore,53212,79544,-26332
2013-09-01,Deutsche Bank,CitiBank Singapore,56739,79733,-22994
2013-10-01,Deutsche Bank,CitiBank Singapore,58429,72887,-14458
2013-11-01,Deutsche Bank,CitiBank Singapore,53812,77692,-23880
2013-12-01,Deutsche Bank,CitiBank Singapore,54683,72585,-17902
2014-01-01,Deutsche Bank,CitiBank Singapore,51217,78499,-27282
2014-02-01,Deutsche Bank,CitiBank Singapore,58519,74462,-15943
2014-03-01,Deutsche Bank,CitiBank Singapore,64997,75679,-10682
2014-04-01,Deutsche Bank,CitiBank Singapore,68313,73771,-5458
2014-05-01,Deutsche Bank,CitiBank Singapore,69298,77839,-8541
2014-06-01,Deutsche Bank,CitiBank Singapore,68811,75845,-7034
2014-07-01,Deutsche Bank,CitiBank Singapore,62842,79628,-16786
2014-08-01,Deutsche Bank,CitiBank Singapore,63659,76675,-13016
2014-09-01,Deutsche Bank,CitiBank Singapore,63188,72859,-9671
2014-10-01,Deutsche Bank,CitiBank Singapore,64916,79229,-14313
2014-11-01,Deutsche Bank,CitiBank Singapore,66498,74379,-7881
2014-12-01,Deutsche Bank,CitiBank Singapore,67478,74115,-6637
2015-01-01,Deutsche Bank,CitiBank Singapore,75418,66422,8996
2015-02-01,Deutsche Bank,CitiBank Singapore,79277,68126,11151
2015-03-01,Deutsche Bank,CitiBank Singapore,79112,69514,9598
2015-04-01,Deutsche Bank,CitiBank Singapore,73422,68625,4797
2015-05-01,Deutsche Bank,CitiBank Singapore,79942,65895,14047
2015-06-01,Deutsche Bank,CitiBank Singapore,79271,64296,14975
2015-07-01,Deutsche Bank,CitiBank Singapore,76138,62124,14014
2015-08-01,Deutsche Bank,CitiBank Singapore,75824,68327,7497
2015-09-01,Deutsche Bank,CitiBank Singapore,74371,66532,7839
2015-10-01,Deutsche Bank,CitiBank Singapore,73457,61774,11683
2015-11-01,Deutsche Bank,CitiBank Singapore,86964,67234,19730
2015-12-01,Deutsche Bank,CitiBank Singapore,88365,64338,24027
2016-01-01,Deutsche Bank,CitiBank Singapore,84917,64794,20123
2016-02-01,Deutsche Bank,CitiBank Singapore,82645,69456,13189
2016-03-01,Deutsche Bank,CitiBank Singapore,88753,61442,27311
2016-04-01,Deutsche Bank,CitiBank Singapore,81629,64316,17313
2016-05-01,Deutsche Bank,CitiBank Singapore,85816,63245,22571
2016-06-01,Deutsche Bank,CitiBank Singapore,82592,69459,13133
2016-07-01,Deutsche Bank,CitiBank Singapore,83641,68361,15280
2016-08-01,Deutsche Bank,CitiBank Singapore,81165,66268,14897
2016-09-01,Deutsche Bank,CitiBank Singapore,91727,52336,39391
2016-10-01,Deutsche Bank,CitiBank Singapore,97959,53872,44087
2016-11-01,Deutsche Bank,CitiBank Singapore,93832,53331,40501
2016-12-01,Deutsche Bank,CitiBank Singapore,94664,52224,42440
2017-01-01,Deutsche Bank,CitiBank Singapore,92423,55813,36610
2017-02-01,Deutsche Bank,CitiBank Singapore,93554,58137,35417
2017-03-01,Deutsche Bank,CitiBank Singapore,92968,54627,38341
2017-04-01,Deutsche Bank,CitiBank Singapore,99992,53671,46321
2017-05-01,Deutsche Bank,CitiBank Singapore,92749,57264,35485
2017-06-01,Deutsche Bank,CitiBank Singapore,92329,59342,32987
2017-07-01,Deutsche Bank,CitiBank Singapore,107164,59959,47205
2017-08-01,Deutsche Bank,CitiBank Singapore,105757,52626,53131
2017-09-01,Deutsche Bank,CitiBank Singapore,103877,51285,52592
2017-10-01,Deutsche Bank,CitiBank Singapore,102992,54121,48871
2017-11-01,Deutsche Bank,CitiBank Singapore,109759,59622,50137
2017-12-01,Deutsche Bank,CitiBank Singapore,107839,54311,53528
2018-01-01,Deutsche Bank,CitiBank Singapore,101781,53462,48319
2018-02-01,Deutsche Bank,CitiBank Singapore,103353,56843,46510
2018-03-01,Deutsche Bank,CitiBank Singapore,107769,52916,54853
2018-04-01,Deutsche Bank,CitiBank Singapore,109189,57294,51895
2010-01-01,Deutsche Bank,CitiBank HongKong,13991,92828,-78837
2010-02-01,Deutsche Bank,CitiBank HongKong,12594,95158,-82564
2010-03-01,Deutsche Bank,CitiBank HongKong,18153,97634,-79481
2010-04-01,Deutsche Bank,CitiBank HongKong,19893,93773,-73880
2010-05-01,Deutsche Bank,CitiBank HongKong,14686,98257,-83571
2010-06-01,Deutsche Bank,CitiBank HongKong,12713,95545,-82832
2010-07-01,Deutsche Bank,CitiBank HongKong,14117,94664,-80547
2010-08-01,Deutsche Bank,CitiBank HongKong,13458,99347,-85889
2010-09-01,Deutsche Bank,CitiBank HongKong,15651,95943,-80292
2010-10-01,Deutsche Bank,CitiBank HongKong,18448,92726,-74278
2010-11-01,Deutsche Bank,CitiBank HongKong,25562,95155,-69593
2010-12-01,Deutsche Bank,CitiBank HongKong,29196,97519,-68323
2011-01-01,Deutsche Bank,CitiBank HongKong,28813,97738,-68925
2011-02-01,Deutsche Bank,CitiBank HongKong,27231,96852,-69621
2011-03-01,Deutsche Bank,CitiBank HongKong,23546,95761,-72215
2011-04-01,Deutsche Bank,CitiBank HongKong,21295,99524,-78229
2011-05-01,Deutsche Bank,CitiBank HongKong,24239,94723,-70484
2011-06-01,Deutsche Bank,CitiBank HongKong,25943,99676,-73733
2011-07-01,Deutsche Bank,CitiBank HongKong,29416,92195,-62779
2011-08-01,Deutsche Bank,CitiBank HongKong,24221,91888,-67667
2011-09-01,Deutsche Bank,CitiBank HongKong,32984,89768,-56784
2011-10-01,Deutsche Bank,CitiBank HongKong,33276,83812,-50536
2011-11-01,Deutsche Bank,CitiBank HongKong,37182,87672,-50490
2011-12-01,Deutsche Bank,CitiBank HongKong,36567,86995,-50428
2012-01-01,Deutsche Bank,CitiBank HongKong,33594,89753,-56159
2012-02-01,Deutsche Bank,CitiBank HongKong,39749,84686,-44937
2012-03-01,Deutsche Bank,CitiBank HongKong,31728,87677,-55949
2012-04-01,Deutsche Bank,CitiBank HongKong,39867,88111,-48244
2012-05-01,Deutsche Bank,CitiBank HongKong,37833,84952,-47119
2012-06-01,Deutsche Bank,CitiBank HongKong,38931,89733,-50802
2012-07-01,Deutsche Bank,CitiBank HongKong,42554,85867,-43313
2012-08-01,Deutsche Bank,CitiBank HongKong,41657,86872,-45215
2012-09-01,Deutsche Bank,CitiBank HongKong,46265,87646,-41381
2012-10-01,Deutsche Bank,CitiBank HongKong,49593,87594,-38001
2012-11-01,Deutsche Bank,CitiBank HongKong,47266,89398,-42132
2012-12-01,Deutsche Bank,CitiBank HongKong,41449,88622,-47173
2013-01-01,Deutsche Bank,CitiBank HongKong,42825,85824,-42999
2013-02-01,Deutsche Bank,CitiBank HongKong,45465,81669,-36204
2013-03-01,Deutsche Bank,CitiBank HongKong,43592,84177,-40585
2013-04-01,Deutsche Bank,CitiBank HongKong,48716,85437,-36721
2013-05-01,Deutsche Bank,CitiBank HongKong,54483,72786,-18303
2013-06-01,Deutsche Bank,CitiBank HongKong,53481,75426,-21945
2013-07-01,Deutsche Bank,CitiBank HongKong,51174,72794,-21620
2013-08-01,Deutsche Bank,CitiBank HongKong,55466,77381,-21915
2013-09-01,Deutsche Bank,CitiBank HongKong,59672,78752,-19080
2013-10-01,Deutsche Bank,CitiBank HongKong,59153,72395,-13242
2013-11-01,Deutsche Bank,CitiBank HongKong,51458,75391,-23933
2013-12-01,Deutsche Bank,CitiBank HongKong,52622,71557,-18935
2014-01-01,Deutsche Bank,CitiBank HongKong,52485,78464,-25979
2014-02-01,Deutsche Bank,CitiBank HongKong,54858,79496,-24638
2014-03-01,Deutsche Bank,CitiBank HongKong,62877,71264,-8387
2014-04-01,Deutsche Bank,CitiBank HongKong,62368,75589,-13221
2014-05-01,Deutsche Bank,CitiBank HongKong,64672,75696,-11024
2014-06-01,Deutsche Bank,CitiBank HongKong,67393,72963,-5570
2014-07-01,Deutsche Bank,CitiBank HongKong,66552,73277,-6725
2014-08-01,Deutsche Bank,CitiBank HongKong,68519,77787,-9268
2014-09-01,Deutsche Bank,CitiBank HongKong,66724,72159,-5435
2014-10-01,Deutsche Bank,CitiBank HongKong,68748,77827,-9079
2014-11-01,Deutsche Bank,CitiBank HongKong,61246,77488,-16242
2014-12-01,Deutsche Bank,CitiBank HongKong,66518,78767,-12249
2015-01-01,Deutsche Bank,CitiBank HongKong,75186,67289,7897
2015-02-01,Deutsche Bank,CitiBank HongKong,71715,61252,10463
2015-03-01,Deutsche Bank,CitiBank HongKong,71582,66978,4604
2015-04-01,Deutsche Bank,CitiBank HongKong,77276,65372,11904
2015-05-01,Deutsche Bank,CitiBank HongKong,79528,69736,9792
2015-06-01,Deutsche Bank,CitiBank HongKong,79419,64461,14958
2015-07-01,Deutsche Bank,CitiBank HongKong,72445,64797,7648
2015-08-01,Deutsche Bank,CitiBank HongKong,77137,65467,11670
2015-09-01,Deutsche Bank,CitiBank HongKong,75432,67621,7811
2015-10-01,Deutsche Bank,CitiBank HongKong,79567,68435,11132
2015-11-01,Deutsche Bank,CitiBank HongKong,88592,61617,26975
2015-12-01,Deutsche Bank,CitiBank HongKong,84516,61261,23255
2016-01-01,Deutsche Bank,CitiBank HongKong,85883,66672,19211
2016-02-01,Deutsche Bank,CitiBank HongKong,89648,69631,20017
2016-03-01,Deutsche Bank,CitiBank HongKong,86427,66914,19513
2016-04-01,Deutsche Bank,CitiBank HongKong,87151,69528,17623
2016-05-01,Deutsche Bank,CitiBank HongKong,82434,61165,21269
2016-06-01,Deutsche Bank,CitiBank HongKong,82224,67877,14347
2016-07-01,Deutsche Bank,CitiBank HongKong,87747,64866,22881
2016-08-01,Deutsche Bank,CitiBank HongKong,86174,68533,17641
2016-09-01,Deutsche Bank,CitiBank HongKong,96517,51613,44904
2016-10-01,Deutsche Bank,CitiBank HongKong,97483,57389,40094
2016-11-01,Deutsche Bank,CitiBank HongKong,94686,53652,41034
2016-12-01,Deutsche Bank,CitiBank HongKong,98323,51663,46660
2017-01-01,Deutsche Bank,CitiBank HongKong,98254,58437,39817
2017-02-01,Deutsche Bank,CitiBank HongKong,97829,55257,42572
2017-03-01,Deutsche Bank,CitiBank HongKong,99981,56693,43288
2017-04-01,Deutsche Bank,CitiBank HongKong,99254,52867,46387
2017-05-01,Deutsche Bank,CitiBank HongKong,91998,58954,33044
2017-06-01,Deutsche Bank,CitiBank HongKong,95998,51365,44633
2017-07-01,Deutsche Bank,CitiBank HongKong,101231,56399,44832
2017-08-01,Deutsche Bank,CitiBank HongKong,105243,56788,48455
2017-09-01,Deutsche Bank,CitiBank HongKong,105825,55475,50350
2017-10-01,Deutsche Bank,CitiBank HongKong,101542,51798,49744
2017-11-01,Deutsche Bank,CitiBank HongKong,109791,54177,55614
2017-12-01,Deutsche Bank,CitiBank HongKong,106219,58827,47392
2018-01-01,Deutsche Bank,CitiBank HongKong,106239,57524,48715
2018-02-01,Deutsche Bank,CitiBank HongKong,107372,54949,52423
2018-03-01,Deutsche Bank,CitiBank HongKong,101562,59244,42318
2018-04-01,Deutsche Bank,CitiBank HongKong,101298,56195,45103
2010-01-01,JP Morgan,CitiBank New York,17829,96443,-78614
2010-02-01,JP Morgan,CitiBank New York,15311,95424,-80113
2010-03-01,JP Morgan,CitiBank New York,12646,99234,-86588
2010-04-01,JP Morgan,CitiBank New York,14819,94256,-79437
2010-05-01,JP Morgan,CitiBank New York,15518,92493,-76975
2010-06-01,JP Morgan,CitiBank New York,18496,95143,-76647
2010-07-01,JP Morgan,CitiBank New York,15863,95892,-80029
2010-08-01,JP Morgan,CitiBank New York,14416,91288,-76872
2010-09-01,JP Morgan,CitiBank New York,11212,96264,-85052
2010-10-01,JP Morgan,CitiBank New York,18273,92968,-74695
2010-11-01,JP Morgan,CitiBank New York,23191,95879,-72688
2010-12-01,JP Morgan,CitiBank New York,24239,97758,-73519
2011-01-01,JP Morgan,CitiBank New York,23533,97223,-73690
2011-02-01,JP Morgan,CitiBank New York,26458,93636,-67178
2011-03-01,JP Morgan,CitiBank New York,22161,97134,-74973
2011-04-01,JP Morgan,CitiBank New York,23824,99711,-75887
2011-05-01,JP Morgan,CitiBank New York,29353,93684,-64331
2011-06-01,JP Morgan,CitiBank New York,27336,96583,-69247
2011-07-01,JP Morgan,CitiBank New York,25525,92564,-67039
2011-08-01,JP Morgan,CitiBank New York,29467,99295,-69828
2011-09-01,JP Morgan,CitiBank New York,37222,81622,-44400
2011-10-01,JP Morgan,CitiBank New York,33554,84329,-50775
2011-11-01,JP Morgan,CitiBank New York,33491,83613,-50122
2011-12-01,JP Morgan,CitiBank New York,34395,87531,-53136
2012-01-01,JP Morgan,CitiBank New York,33882,84973,-51091
2012-02-01,JP Morgan,CitiBank New York,33562,89596,-56034
2012-03-01,JP Morgan,CitiBank New York,39724,89615,-49891
2012-04-01,JP Morgan,CitiBank New York,31551,87813,-56262
2012-05-01,JP Morgan,CitiBank New York,36895,82676,-45781
2012-06-01,JP Morgan,CitiBank New York,33878,86814,-52936
2012-07-01,JP Morgan,CitiBank New York,48438,84428,-35990
2012-08-01,JP Morgan,CitiBank New York,45835,84674,-38839
2012-09-01,JP Morgan,CitiBank New York,41329,86727,-45398
2012-10-01,JP Morgan,CitiBank New York,46929,89186,-42257
2012-11-01,JP Morgan,CitiBank New York,41867,85182,-43315
2012-12-01,JP Morgan,CitiBank New York,48279,82478,-34199
2013-01-01,JP Morgan,CitiBank New York,46632,85181,-38549
2013-02-01,JP Morgan,CitiBank New York,47531,89927,-42396
2013-03-01,JP Morgan,CitiBank New York,41663,87346,-45683
2013-04-01,JP Morgan,CitiBank New York,44629,85334,-40705
2013-05-01,JP Morgan,CitiBank New York,58343,78649,-20306
2013-06-01,JP Morgan,CitiBank New York,53612,74997,-21385
2013-07-01,JP Morgan,CitiBank New York,55562,79447,-23885
2013-08-01,JP Morgan,CitiBank New York,57626,73975,-16349
2013-09-01,JP Morgan,CitiBank New York,53221,75914,-22693
2013-10-01,JP Morgan,CitiBank New York,54868,79329,-24461
2013-11-01,JP Morgan,CitiBank New York,53619,75358,-21739
2013-12-01,JP Morgan,CitiBank New York,56774,78456,-21682
2014-01-01,JP Morgan,CitiBank New York,53262,74827,-21565
2014-02-01,JP Morgan,CitiBank New York,52565,72111,-19546
2014-03-01,JP Morgan,CitiBank New York,65772,78716,-12944
2014-04-01,JP Morgan,CitiBank New York,62238,74297,-12059
2014-05-01,JP Morgan,CitiBank New York,67815,78877,-11062
2014-06-01,JP Morgan,CitiBank New York,67484,78419,-10935
2014-07-01,JP Morgan,CitiBank New York,63597,78859,-15262
2014-08-01,JP Morgan,CitiBank New York,64392,76498,-12106
2014-09-01,JP Morgan,CitiBank New York,68528,75398,-6870
2014-10-01,JP Morgan,CitiBank New York,65778,76376,-10598
2014-11-01,JP Morgan,CitiBank New York,65342,75781,-10439
2014-12-01,JP Morgan,CitiBank New York,68196,74157,-5961
2015-01-01,JP Morgan,CitiBank New York,77936,62654,15282
2015-02-01,JP Morgan,CitiBank New York,77729,67593,10136
2015-03-01,JP Morgan,CitiBank New York,77188,67435,9753
2015-04-01,JP Morgan,CitiBank New York,79952,63849,16103
2015-05-01,JP Morgan,CitiBank New York,76759,69113,7646
2015-06-01,JP Morgan,CitiBank New York,71816,65157,6659
2015-07-01,JP Morgan,CitiBank New York,78163,62387,15776
2015-08-01,JP Morgan,CitiBank New York,79864,63849,16015
2015-09-01,JP Morgan,CitiBank New York,79824,67294,12530
2015-10-01,JP Morgan,CitiBank New York,74182,63997,10185
2015-11-01,JP Morgan,CitiBank New York,86786,68621,18165
2015-12-01,JP Morgan,CitiBank New York,86832,63491,23341
2016-01-01,JP Morgan,CitiBank New York,87218,67849,19369
2016-02-01,JP Morgan,CitiBank New York,83826,69449,14377
2016-03-01,JP Morgan,CitiBank New York,86721,63244,23477
2016-04-01,JP Morgan,CitiBank New York,82438,67827,14611
2016-05-01,JP Morgan,CitiBank New York,85283,61512,23771
2016-06-01,JP Morgan,CitiBank New York,81711,64268,17443
2016-07-01,JP Morgan,CitiBank New York,82361,61382,20979
2016-08-01,JP Morgan,CitiBank New York,88811,66458,22353
2016-09-01,JP Morgan,CitiBank New York,92732,53727,39005
2016-10-01,JP Morgan,CitiBank New York,97728,53447,44281
2016-11-01,JP Morgan,CitiBank New York,95172,57265,37907
2016-12-01,JP Morgan,CitiBank New York,97147,53491,43656
2017-01-01,JP Morgan,CitiBank New York,94434,56319,38115
2017-02-01,JP Morgan,CitiBank New York,96433,54788,41645
2017-03-01,JP Morgan,CitiBank New York,96818,58692,38126
2017-04-01,JP Morgan,CitiBank New York,95112,52391,42721
2017-05-01,JP Morgan,CitiBank New York,96353,59569,36784
2017-06-01,JP Morgan,CitiBank New York,96337,51192,45145
2017-07-01,JP Morgan,CitiBank New York,104617,58349,46268
2017-08-01,JP Morgan,CitiBank New York,108444,56157,52287
2017-09-01,JP Morgan,CitiBank New York,105461,54365,51096
2017-10-01,JP Morgan,CitiBank New York,107614,54412,53202
2017-11-01,JP Morgan,CitiBank New York,106284,54964,51320
2017-12-01,JP Morgan,CitiBank New York,107867,51433,56434
2018-01-01,JP Morgan,CitiBank New York,103251,54535,48716
2018-02-01,JP Morgan,CitiBank New York,107747,53342,54405
2018-03-01,JP Morgan,CitiBank New York,107323,52873,54450
2018-04-01,JP Morgan,CitiBank New York,102926,51453,51473
2010-01-01,JP Morgan,CitiBank London,19645,96337,-76692
2010-02-01,JP Morgan,CitiBank London,15136,92959,-77823
2010-03-01,JP Morgan,CitiBank London,18677,99245,-80568
2010-04-01,JP Morgan,CitiBank London,16629,97661,-81032
2010-05-01,JP Morgan,CitiBank London,11814,99625,-87811
2010-06-01,JP Morgan,CitiBank London,11528,99813,-88285
2010-07-01,JP Morgan,CitiBank London,13385,94548,-81163
2010-08-01,JP Morgan,CitiBank London,15339,95739,-80400
2010-09-01,JP Morgan,CitiBank London,17543,91163,-73620
2010-10-01,JP Morgan,CitiBank London,18411,99355,-80944
2010-11-01,JP Morgan,CitiBank London,29145,97588,-68443
2010-12-01,JP Morgan,CitiBank London,29986,99928,-69942
2011-01-01,JP Morgan,CitiBank London,25695,98444,-72749
2011-02-01,JP Morgan,CitiBank London,27723,97673,-69950
2011-03-01,JP Morgan,CitiBank London,28688,96786,-68098
2011-04-01,JP Morgan,CitiBank London,26696,98615,-71919
2011-05-01,JP Morgan,CitiBank London,22283,91866,-69583
2011-06-01,JP Morgan,CitiBank London,21289,98645,-77356
2011-07-01,JP Morgan,CitiBank London,23763,96226,-72463
2011-08-01,JP Morgan,CitiBank London,28987,95528,-66541
2011-09-01,JP Morgan,CitiBank London,36315,82292,-45977
2011-10-01,JP Morgan,CitiBank London,32366,86549,-54183
2011-11-01,JP Morgan,CitiBank London,35941,86544,-50603
2011-12-01,JP Morgan,CitiBank London,31442,84885,-53443
2012-01-01,JP Morgan,CitiBank London,32479,83616,-51137
2012-02-01,JP Morgan,CitiBank London,34345,86385,-52040
2012-03-01,JP Morgan,CitiBank London,32966,87747,-54781
2012-04-01,JP Morgan,CitiBank London,39349,85422,-46073
2012-05-01,JP Morgan,CitiBank London,39467,88615,-49148
2012-06-01,JP Morgan,CitiBank London,38719,87659,-48940
2012-07-01,JP Morgan,CitiBank London,42863,84461,-41598
2012-08-01,JP Morgan,CitiBank London,44561,86834,-42273
2012-09-01,JP Morgan,CitiBank London,42681,82163,-39482
2012-10-01,JP Morgan,CitiBank London,41126,84335,-43209
2012-11-01,JP Morgan,CitiBank London,48894,82715,-33821
2012-12-01,JP Morgan,CitiBank London,47522,84653,-37131
2013-01-01,JP Morgan,CitiBank London,42613,82274,-39661
2013-02-01,JP Morgan,CitiBank London,47921,89476,-41555
2013-03-01,JP Morgan,CitiBank London,47966,81752,-33786
2013-04-01,JP Morgan,CitiBank London,43524,82952,-39428
2013-05-01,JP Morgan,CitiBank London,51922,79697,-27775
2013-06-01,JP Morgan,CitiBank London,59718,71359,-11641
2013-07-01,JP Morgan,CitiBank London,57245,73279,-16034
2013-08-01,JP Morgan,CitiBank London,51821,74137,-22316
2013-09-01,JP Morgan,CitiBank London,56586,75969,-19383
2013-10-01,JP Morgan,CitiBank London,59974,78748,-18774
2013-11-01,JP Morgan,CitiBank London,54476,71717,-17241
2013-12-01,JP Morgan,CitiBank London,52672,75349,-22677
2014-01-01,JP Morgan,CitiBank London,58588,79454,-20866
2014-02-01,JP Morgan,CitiBank London,51882,79544,-27662
2014-03-01,JP Morgan,CitiBank London,62914,78474,-15560
2014-04-01,JP Morgan,CitiBank London,65934,73815,-7881
2014-05-01,JP Morgan,CitiBank London,65571,79717,-14146
2014-06-01,JP Morgan,CitiBank London,64434,74177,-9743
2014-07-01,JP Morgan,CitiBank London,64958,75939,-10981
2014-08-01,JP Morgan,CitiBank London,65779,77125,-11346
2014-09-01,JP Morgan,CitiBank London,62788,71424,-8636
2014-10-01,JP Morgan,CitiBank London,68617,72792,-4175
2014-11-01,JP Morgan,CitiBank London,63279,78697,-15418
2014-12-01,JP Morgan,CitiBank London,66232,76142,-9910
2015-01-01,JP Morgan,CitiBank London,77319,66214,11105
2015-02-01,JP Morgan,CitiBank London,71398,62594,8804
2015-03-01,JP Morgan,CitiBank London,71371,63113,8258
2015-04-01,JP Morgan,CitiBank London,77765,64759,13006
2015-05-01,JP Morgan,CitiBank London,71449,65716,5733
2015-06-01,JP Morgan,CitiBank London,79688,66132,13556
2015-07-01,JP Morgan,CitiBank London,79723,66395,13328
2015-08-01,JP Morgan,CitiBank London,77594,68852,8742
2015-09-01,JP Morgan,CitiBank London,71754,66717,5037
2015-10-01,JP Morgan,CitiBank London,78231,62316,15915
2015-11-01,JP Morgan,CitiBank London,85987,67772,18215
2015-12-01,JP Morgan,CitiBank London,85615,67963,17652
2016-01-01,JP Morgan,CitiBank London,88627,64849,23778
2016-02-01,JP Morgan,CitiBank London,88385,66134,22251
2016-03-01,JP Morgan,CitiBank London,88218,62755,25463
2016-04-01,JP Morgan,CitiBank London,85961,66425,19536
2016-05-01,JP Morgan,CitiBank London,82569,62435,20134
2016-06-01,JP Morgan,CitiBank London,83114,66772,16342
2016-07-01,JP Morgan,CitiBank London,85557,66837,18720
2016-08-01,JP Morgan,CitiBank London,84774,67725,17049
2016-09-01,JP Morgan,CitiBank London,98852,52146,46706
2016-10-01,JP Morgan,CitiBank London,93933,59968,33965
2016-11-01,JP Morgan,CitiBank London,93698,52144,41554
2016-12-01,JP Morgan,CitiBank London,96495,52795,43700
2017-01-01,JP Morgan,CitiBank London,97747,52273,45474
2017-02-01,JP Morgan,CitiBank London,95273,54276,40997
2017-03-01,JP Morgan,CitiBank London,95712,59871,35841
2017-04-01,JP Morgan,CitiBank London,97858,55457,42401
2017-05-01,JP Morgan,CitiBank London,96535,58247,38288
2017-06-01,JP Morgan,CitiBank London,99855,51373,48482
2017-07-01,JP Morgan,CitiBank London,102718,54634,48084
2017-08-01,JP Morgan,CitiBank London,109924,51251,58673
2017-09-01,JP Morgan,CitiBank London,109533,58199,51334
2017-10-01,JP Morgan,CitiBank London,108264,54728,53536
2017-11-01,JP Morgan,CitiBank London,108553,54739,53814
2017-12-01,JP Morgan,CitiBank London,106427,54843,51584
2018-01-01,JP Morgan,CitiBank London,104556,56694,47862
2018-02-01,JP Morgan,CitiBank London,101479,57237,44242
2018-03-01,JP Morgan,CitiBank London,104936,53912,51024
2018-04-01,JP Morgan,CitiBank London,101738,58423,43315
2010-01-01,JP Morgan,CitiBank Pune,16716,99486,-82770
2010-02-01,JP Morgan,CitiBank Pune,16844,96135,-79291
2010-03-01,JP Morgan,CitiBank Pune,18498,98413,-79915
2010-04-01,JP Morgan,CitiBank Pune,17734,99843,-82109
2010-05-01,JP Morgan,CitiBank Pune,12579,93446,-80867
2010-06-01,JP Morgan,CitiBank Pune,17214,91614,-74400
2010-07-01,JP Morgan,CitiBank Pune,19411,99819,-80408
2010-08-01,JP Morgan,CitiBank Pune,19489,93295,-73806
2010-09-01,JP Morgan,CitiBank Pune,11978,95758,-83780
2010-10-01,JP Morgan,CitiBank Pune,11759,91284,-79525
2010-11-01,JP Morgan,CitiBank Pune,28783,96423,-67640
2010-12-01,JP Morgan,CitiBank Pune,24327,97385,-73058
2011-01-01,JP Morgan,CitiBank Pune,29489,92856,-63367
2011-02-01,JP Morgan,CitiBank Pune,28531,93473,-64942
2011-03-01,JP Morgan,CitiBank Pune,29325,96646,-67321
2011-04-01,JP Morgan,CitiBank Pune,26384,96588,-70204
2011-05-01,JP Morgan,CitiBank Pune,24337,91293,-66956
2011-06-01,JP Morgan,CitiBank Pune,21391,93156,-71765
2011-07-01,JP Morgan,CitiBank Pune,27612,96331,-68719
2011-08-01,JP Morgan,CitiBank Pune,22822,91648,-68826
2011-09-01,JP Morgan,CitiBank Pune,33343,85113,-51770
2011-10-01,JP Morgan,CitiBank Pune,38263,89389,-51126
2011-11-01,JP Morgan,CitiBank Pune,38849,82948,-44099
2011-12-01,JP Morgan,CitiBank Pune,33971,89157,-55186
2012-01-01,JP Morgan,CitiBank Pune,34768,85847,-51079
2012-02-01,JP Morgan,CitiBank Pune,37814,89434,-51620
2012-03-01,JP Morgan,CitiBank Pune,37368,82692,-45324
2012-04-01,JP Morgan,CitiBank Pune,33248,86275,-53027
2012-05-01,JP Morgan,CitiBank Pune,36281,83873,-47592
2012-06-01,JP Morgan,CitiBank Pune,36371,83826,-47455
2012-07-01,JP Morgan,CitiBank Pune,49827,81476,-31649
2012-08-01,JP Morgan,CitiBank Pune,45263,84744,-39481
2012-09-01,JP Morgan,CitiBank Pune,46255,89341,-43086
2012-10-01,JP Morgan,CitiBank Pune,44358,88262,-43904
2012-11-01,JP Morgan,CitiBank Pune,47633,82887,-35254
2012-12-01,JP Morgan,CitiBank Pune,41852,89165,-47313
2013-01-01,JP Morgan,CitiBank Pune,44947,83647,-38700
2013-02-01,JP Morgan,CitiBank Pune,46334,81153,-34819
2013-03-01,JP Morgan,CitiBank Pune,49586,82393,-32807
2013-04-01,JP Morgan,CitiBank Pune,47849,85887,-38038
2013-05-01,JP Morgan,CitiBank Pune,51358,76552,-25194
2013-06-01,JP Morgan,CitiBank Pune,52453,76566,-24113
2013-07-01,JP Morgan,CitiBank Pune,58512,73178,-14666
2013-08-01,JP Morgan,CitiBank Pune,54413,75116,-20703
2013-09-01,JP Morgan,CitiBank Pune,53151,74715,-21564
2013-10-01,JP Morgan,CitiBank Pune,57136,71457,-14321
2013-11-01,JP Morgan,CitiBank Pune,56526,76236,-19710
2013-12-01,JP Morgan,CitiBank Pune,56261,72784,-16523
2014-01-01,JP Morgan,CitiBank Pune,55591,76547,-20956
2014-02-01,JP Morgan,CitiBank Pune,59291,72115,-12824
2014-03-01,JP Morgan,CitiBank Pune,61779,76112,-14333
2014-04-01,JP Morgan,CitiBank Pune,68213,75798,-7585
2014-05-01,JP Morgan,CitiBank Pune,63684,79911,-16227
2014-06-01,JP Morgan,CitiBank Pune,68381,72389,-4008
2014-07-01,JP Morgan,CitiBank Pune,63141,73379,-10238
2014-08-01,JP Morgan,CitiBank Pune,64313,73993,-9680
2014-09-01,JP Morgan,CitiBank Pune,62247,77259,-15012
2014-10-01,JP Morgan,CitiBank Pune,63514,73154,-9640
2014-11-01,JP Morgan,CitiBank Pune,66366,79928,-13562
2014-12-01,JP Morgan,CitiBank Pune,66719,79631,-12912
2015-01-01,JP Morgan,CitiBank Pune,71128,62819,8309
2015-02-01,JP Morgan,CitiBank Pune,79681,61785,17896
2015-03-01,JP Morgan,CitiBank Pune,77673,64419,13254
2015-04-01,JP Morgan,CitiBank Pune,75286,63471,11815
2015-05-01,JP Morgan,CitiBank Pune,74123,67431,6692
2015-06-01,JP Morgan,CitiBank Pune,78325,66132,12193
2015-07-01,JP Morgan,CitiBank Pune,77476,63455,14021
2015-08-01,JP Morgan,CitiBank Pune,77458,61369,16089
2015-09-01,JP Morgan,CitiBank Pune,71725,61467,10258
2015-10-01,JP Morgan,CitiBank Pune,74296,69191,5105
2015-11-01,JP Morgan,CitiBank Pune,83733,68426,15307
2015-12-01,JP Morgan,CitiBank Pune,83379,62729,20650
2016-01-01,JP Morgan,CitiBank Pune,88663,64734,23929
2016-02-01,JP Morgan,CitiBank Pune,82198,61685,20513
2016-03-01,JP Morgan,CitiBank Pune,81349,69234,12115
2016-04-01,JP Morgan,CitiBank Pune,86826,62327,24499
2016-05-01,JP Morgan,CitiBank Pune,88374,64687,23687
2016-06-01,JP Morgan,CitiBank Pune,82356,63332,19024
2016-07-01,JP Morgan,CitiBank Pune,82631,65685,16946
2016-08-01,JP Morgan,CitiBank Pune,88362,61387,26975
2016-09-01,JP Morgan,CitiBank Pune,99869,53179,46690
2016-10-01,JP Morgan,CitiBank Pune,99595,55657,43938
2016-11-01,JP Morgan,CitiBank Pune,92838,55248,37590
2016-12-01,JP Morgan,CitiBank Pune,99489,52953,46536
2017-01-01,JP Morgan,CitiBank Pune,96241,53197,43044
2017-02-01,JP Morgan,CitiBank Pune,99217,51887,47330
2017-03-01,JP Morgan,CitiBank Pune,99874,53832,46042
2017-04-01,JP Morgan,CitiBank Pune,96311,57892,38419
2017-05-01,JP Morgan,CitiBank Pune,94327,55891,38436
2017-06-01,JP Morgan,CitiBank Pune,95377,56819,38558
2017-07-01,JP Morgan,CitiBank Pune,103461,56646,46815
2017-08-01,JP Morgan,CitiBank Pune,101671,57695,43976
2017-09-01,JP Morgan,CitiBank Pune,107474,52418,55056
2017-10-01,JP Morgan,CitiBank Pune,102522,57284,45238
2017-11-01,JP Morgan,CitiBank Pune,101152,51574,49578
2017-12-01,JP Morgan,CitiBank Pune,102736,56725,46011
2018-01-01,JP Morgan,CitiBank Pune,108275,54858,53417
2018-02-01,JP Morgan,CitiBank Pune,106336,57138,49198
2018-03-01,JP Morgan,CitiBank Pune,103452,58597,44855
2018-04-01,JP Morgan,CitiBank Pune,109361,59717,49644
2010-01-01,JP Morgan,CitiBank Singapore,14172,92251,-78079
2010-02-01,JP Morgan,CitiBank Singapore,17767,99325,-81558
2010-03-01,JP Morgan,CitiBank Singapore,15496,95114,-79618
2010-04-01,JP Morgan,CitiBank Singapore,19641,94824,-75183
2010-05-01,JP Morgan,CitiBank Singapore,14458,94673,-80215
2010-06-01,JP Morgan,CitiBank Singapore,17163,94411,-77248
2010-07-01,JP Morgan,CitiBank Singapore,15774,91156,-75382
2010-08-01,JP Morgan,CitiBank Singapore,13299,94165,-80866
2010-09-01,JP Morgan,CitiBank Singapore,14451,98149,-83698
2010-10-01,JP Morgan,CitiBank Singapore,17388,94157,-76769
2010-11-01,JP Morgan,CitiBank Singapore,29592,92863,-63271
2010-12-01,JP Morgan,CitiBank Singapore,27176,96592,-69416
2011-01-01,JP Morgan,CitiBank Singapore,23787,96843,-73056
2011-02-01,JP Morgan,CitiBank Singapore,21862,94518,-72656
2011-03-01,JP Morgan,CitiBank Singapore,24546,98378,-73832
2011-04-01,JP Morgan,CitiBank Singapore,28253,92392,-64139
2011-05-01,JP Morgan,CitiBank Singapore,25264,91914,-66650
2011-06-01,JP Morgan,CitiBank Singapore,29427,91578,-62151
2011-07-01,JP Morgan,CitiBank Singapore,21354,93664,-72310
2011-08-01,JP Morgan,CitiBank Singapore,22871,96513,-73642
2011-09-01,JP Morgan,CitiBank Singapore,37441,87893,-50452
2011-10-01,JP Morgan,CitiBank Singapore,37446,83264,-45818
2011-11-01,JP Morgan,CitiBank Singapore,34781,89664,-54883
2011-12-01,JP Morgan,CitiBank Singapore,35387,84925,-49538
2012-01-01,JP Morgan,CitiBank Singapore,34461,86498,-52037
2012-02-01,JP Morgan,CitiBank Singapore,32248,89311,-57063
2012-03-01,JP Morgan,CitiBank Singapore,36647,82369,-45722
2012-04-01,JP Morgan,CitiBank Singapore,38241,82859,-44618
2012-05-01,JP Morgan,CitiBank Singapore,39642,83117,-43475
2012-06-01,JP Morgan,CitiBank Singapore,31323,82183,-50860
2012-07-01,JP Morgan,CitiBank Singapore,49796,82174,-32378
2012-08-01,JP Morgan,CitiBank Singapore,47344,85155,-37811
2012-09-01,JP Morgan,CitiBank Singapore,45296,81345,-36049
2012-10-01,JP Morgan,CitiBank Singapore,43571,89787,-46216
2012-11-01,JP Morgan,CitiBank Singapore,48421,85362,-36941
2012-12-01,JP Morgan,CitiBank Singapore,42956,87854,-44898
2013-01-01,JP Morgan,CitiBank Singapore,46828,82476,-35648
2013-02-01,JP Morgan,CitiBank Singapore,45764,87138,-41374
2013-03-01,JP Morgan,CitiBank Singapore,47832,85365,-37533
2013-04-01,JP Morgan,CitiBank Singapore,42213,89985,-47772
2013-05-01,JP Morgan,CitiBank Singapore,54535,73566,-19031
2013-06-01,JP Morgan,CitiBank Singapore,57757,72167,-14410
2013-07-01,JP Morgan,CitiBank Singapore,57972,72511,-14539
2013-08-01,JP Morgan,CitiBank Singapore,54979,73832,-18853
2013-09-01,JP Morgan,CitiBank Singapore,54993,79678,-24685
2013-10-01,JP Morgan,CitiBank Singapore,53814,73283,-19469
2013-11-01,JP Morgan,CitiBank Singapore,56789,71595,-14806
2013-12-01,JP Morgan,CitiBank Singapore,56946,77142,-20196
2014-01-01,JP Morgan,CitiBank Singapore,55674,73419,-17745
2014-02-01,JP Morgan,CitiBank Singapore,58177,75795,-17618
2014-03-01,JP Morgan,CitiBank Singapore,68185,75511,-7326
2014-04-01,JP Morgan,CitiBank Singapore,69791,78456,-8665
2014-05-01,JP Morgan,CitiBank Singapore,64146,76913,-12767
2014-06-01,JP Morgan,CitiBank Singapore,61644,71145,-9501
2014-07-01,JP Morgan,CitiBank Singapore,61958,78962,-17004
2014-08-01,JP Morgan,CitiBank Singapore,62288,71473,-9185
2014-09-01,JP Morgan,CitiBank Singapore,65868,74441,-8573
2014-10-01,JP Morgan,CitiBank Singapore,67536,76833,-9297
2014-11-01,JP Morgan,CitiBank Singapore,65113,76559,-11446
2014-12-01,JP Morgan,CitiBank Singapore,68843,77745,-8902
2015-01-01,JP Morgan,CitiBank Singapore,72347,64223,8124
2015-02-01,JP Morgan,CitiBank Singapore,76136,66564,9572
2015-03-01,JP Morgan,CitiBank Singapore,71468,62491,8977
2015-04-01,JP Morgan,CitiBank Singapore,74164,68515,5649
2015-05-01,JP Morgan,CitiBank Singapore,75547,62357,13190
2015-06-01,JP Morgan,CitiBank Singapore,75955,66194,9761
2015-07-01,JP Morgan,CitiBank Singapore,79271,68632,10639
2015-08-01,JP Morgan,CitiBank Singapore,79774,68149,11625
2015-09-01,JP Morgan,CitiBank Singapore,77213,65733,11480
2015-10-01,JP Morgan,CitiBank Singapore,74336,65161,9175
2015-11-01,JP Morgan,CitiBank Singapore,83468,69863,13605
2015-12-01,JP Morgan,CitiBank Singapore,86647,62139,24508
2016-01-01,JP Morgan,CitiBank Singapore,88538,68116,20422
2016-02-01,JP Morgan,CitiBank Singapore,82217,69737,12480
2016-03-01,JP Morgan,CitiBank Singapore,84142,65464,18678
2016-04-01,JP Morgan,CitiBank Singapore,86751,64343,22408
2016-05-01,JP Morgan,CitiBank Singapore,89669,61165,28504
2016-06-01,JP Morgan,CitiBank Singapore,81335,65944,15391
2016-07-01,JP Morgan,CitiBank Singapore,89766,62942,26824
2016-08-01,JP Morgan,CitiBank Singapore,88894,62716,26178
2016-09-01,JP Morgan,CitiBank Singapore,97245,58453,38792
2016-10-01,JP Morgan,CitiBank Singapore,92331,53477,38854
2016-11-01,JP Morgan,CitiBank Singapore,96283,58593,37690
2016-12-01,JP Morgan,CitiBank Singapore,95847,59828,36019
2017-01-01,JP Morgan,CitiBank Singapore,97542,57155,40387
2017-02-01,JP Morgan,CitiBank Singapore,91646,53265,38381
2017-03-01,JP Morgan,CitiBank Singapore,93723,58279,35444
2017-04-01,JP Morgan,CitiBank Singapore,99731,52818,46913
2017-05-01,JP Morgan,CitiBank Singapore,97887,56183,41704
2017-06-01,JP Morgan,CitiBank Singapore,98557,54682,43875
2017-07-01,JP Morgan,CitiBank Singapore,104915,52855,52060
2017-08-01,JP Morgan,CitiBank Singapore,105251,58135,47116
2017-09-01,JP Morgan,CitiBank Singapore,101976,54219,47757
2017-10-01,JP Morgan,CitiBank Singapore,106395,57666,48729
2017-11-01,JP Morgan,CitiBank Singapore,109778,55118,54660
2017-12-01,JP Morgan,CitiBank Singapore,107473,54452,53021
2018-01-01,JP Morgan,CitiBank Singapore,102558,57165,45393
2018-02-01,JP Morgan,CitiBank Singapore,109743,51548,58195
2018-03-01,JP Morgan,CitiBank Singapore,108288,53968,54320
2018-04-01,JP Morgan,CitiBank Singapore,108333,55772,52561
2010-01-01,JP Morgan,CitiBank HongKong,11691,93421,-81730
2010-02-01,JP Morgan,CitiBank HongKong,11578,96475,-84897
2010-03-01,JP Morgan,CitiBank HongKong,18699,97224,-78525
2010-04-01,JP Morgan,CitiBank HongKong,17129,92247,-75118
2010-05-01,JP Morgan,CitiBank HongKong,19915,97589,-77674
2010-06-01,JP Morgan,CitiBank HongKong,14522,93572,-79050
2010-07-01,JP Morgan,CitiBank HongKong,14295,99791,-85496
2010-08-01,JP Morgan,CitiBank HongKong,14999,96572,-81573
2010-09-01,JP Morgan,CitiBank HongKong,15165,94488,-79323
2010-10-01,JP Morgan,CitiBank HongKong,19965,98544,-78579
2010-11-01,JP Morgan,CitiBank HongKong,27585,93133,-65548
2010-12-01,JP Morgan,CitiBank HongKong,28479,98556,-70077
2011-01-01,JP Morgan,CitiBank HongKong,24983,99286,-74303
2011-02-01,JP Morgan,CitiBank HongKong,24692,93337,-68645
2011-03-01,JP Morgan,CitiBank HongKong,28849,93791,-64942
2011-04-01,JP Morgan,CitiBank HongKong,24668,91467,-66799
2011-05-01,JP Morgan,CitiBank HongKong,21932,95732,-73800
2011-06-01,JP Morgan,CitiBank HongKong,21311,94531,-73220
2011-07-01,JP Morgan,CitiBank HongKong,26141,98922,-72781
2011-08-01,JP Morgan,CitiBank HongKong,25962,91449,-65487
2011-09-01,JP Morgan,CitiBank HongKong,36574,82367,-45793
2011-10-01,JP Morgan,CitiBank HongKong,33112,88259,-55147
2011-11-01,JP Morgan,CitiBank HongKong,35511,85534,-50023
2011-12-01,JP Morgan,CitiBank HongKong,33637,89543,-55906
2012-01-01,JP Morgan,CitiBank HongKong,37854,83498,-45644
2012-02-01,JP Morgan,CitiBank HongKong,31876,88246,-56370
2012-03-01,JP Morgan,CitiBank HongKong,38114,84217,-46103
2012-04-01,JP Morgan,CitiBank HongKong,39678,83137,-43459
2012-05-01,JP Morgan,CitiBank HongKong,34624,89518,-54894
2012-06-01,JP Morgan,CitiBank HongKong,36827,82755,-45928
2012-07-01,JP Morgan,CitiBank HongKong,48191,84185,-35994
2012-08-01,JP Morgan,CitiBank HongKong,47463,81961,-34498
2012-09-01,JP Morgan,CitiBank HongKong,42494,82821,-40327
2012-10-01,JP Morgan,CitiBank HongKong,42773,88298,-45525
2012-11-01,JP Morgan,CitiBank HongKong,41673,87797,-46124
2012-12-01,JP Morgan,CitiBank HongKong,49336,89267,-39931
2013-01-01,JP Morgan,CitiBank HongKong,41888,86154,-44266
2013-02-01,JP Morgan,CitiBank HongKong,45372,85211,-39839
2013-03-01,JP Morgan,CitiBank HongKong,45577,89564,-43987
2013-04-01,JP Morgan,CitiBank HongKong,47322,89953,-42631
2013-05-01,JP Morgan,CitiBank HongKong,56213,79347,-23134
2013-06-01,JP Morgan,CitiBank HongKong,53737,72741,-19004
2013-07-01,JP Morgan,CitiBank HongKong,57919,73171,-15252
2013-08-01,JP Morgan,CitiBank HongKong,57915,72859,-14944
2013-09-01,JP Morgan,CitiBank HongKong,54952,75823,-20871
2013-10-01,JP Morgan,CitiBank HongKong,59719,78779,-19060
2013-11-01,JP Morgan,CitiBank HongKong,51564,78231,-26667
2013-12-01,JP Morgan,CitiBank HongKong,54498,73241,-18743
2014-01-01,JP Morgan,CitiBank HongKong,59565,72957,-13392
2014-02-01,JP Morgan,CitiBank HongKong,57336,73938,-16602
2014-03-01,JP Morgan,CitiBank HongKong,61394,73734,-12340
2014-04-01,JP Morgan,CitiBank HongKong,64611,73293,-8682
2014-05-01,JP Morgan,CitiBank HongKong,67151,72138,-4987
2014-06-01,JP Morgan,CitiBank HongKong,61515,76535,-15020
2014-07-01,JP Morgan,CitiBank HongKong,65617,76226,-10609
2014-08-01,JP Morgan,CitiBank HongKong,64866,78529,-13663
2014-09-01,JP Morgan,CitiBank HongKong,61216,75922,-14706
2014-10-01,JP Morgan,CitiBank HongKong,69695,73276,-3581
2014-11-01,JP Morgan,CitiBank HongKong,69676,76757,-7081
2014-12-01,JP Morgan,CitiBank HongKong,68764,73751,-4987
2015-01-01,JP Morgan,CitiBank HongKong,72737,66181,6556
2015-02-01,JP Morgan,CitiBank HongKong,76338,62813,13525
2015-03-01,JP Morgan,CitiBank HongKong,74958,67553,7405
2015-04-01,JP Morgan,CitiBank HongKong,74736,66655,8081
2015-05-01,JP Morgan,CitiBank HongKong,75387,66515,8872
2015-06-01,JP Morgan,CitiBank HongKong,76733,67853,8880
2015-07-01,JP Morgan,CitiBank HongKong,77617,69641,7976
2015-08-01,JP Morgan,CitiBank HongKong,74349,62724,11625
2015-09-01,JP Morgan,CitiBank HongKong,77583,67349,10234
2015-10-01,JP Morgan,CitiBank HongKong,74456,61556,12900
2015-11-01,JP Morgan,CitiBank HongKong,85142,62877,22265
2015-12-01,JP Morgan,CitiBank HongKong,82533,62481,20052
2016-01-01,JP Morgan,CitiBank HongKong,81982,64168,17814
2016-02-01,JP Morgan,CitiBank HongKong,84742,64532,20210
2016-03-01,JP Morgan,CitiBank HongKong,81843,63358,18485
2016-04-01,JP Morgan,CitiBank HongKong,87675,64812,22863
2016-05-01,JP Morgan,CitiBank HongKong,85919,63992,21927
2016-06-01,JP Morgan,CitiBank HongKong,82322,67326,14996
2016-07-01,JP Morgan,CitiBank HongKong,86662,62938,23724
2016-08-01,JP Morgan,CitiBank HongKong,88619,61868,26751
2016-09-01,JP Morgan,CitiBank HongKong,92862,57983,34879
2016-10-01,JP Morgan,CitiBank HongKong,97768,54346,43422
2016-11-01,JP Morgan,CitiBank HongKong,99249,54173,45076
2016-12-01,JP Morgan,CitiBank HongKong,94394,56135,38259
2017-01-01,JP Morgan,CitiBank HongKong,93723,56259,37464
2017-02-01,JP Morgan,CitiBank HongKong,95694,59927,35767
2017-03-01,JP Morgan,CitiBank HongKong,98758,56874,41884
2017-04-01,JP Morgan,CitiBank HongKong,92125,56658,35467
2017-05-01,JP Morgan,CitiBank HongKong,96273,57164,39109
2017-06-01,JP Morgan,CitiBank HongKong,99281,55296,43985
2017-07-01,JP Morgan,CitiBank HongKong,103828,55572,48256
2017-08-01,JP Morgan,CitiBank HongKong,105577,53329,52248
2017-09-01,JP Morgan,CitiBank HongKong,108187,52938,55249
2017-10-01,JP Morgan,CitiBank HongKong,103136,56851,46285
2017-11-01,JP Morgan,CitiBank HongKong,109271,51215,58056
2017-12-01,JP Morgan,CitiBank HongKong,103458,51896,51562
2018-01-01,JP Morgan,CitiBank HongKong,104163,51474,52689
2018-02-01,JP Morgan,CitiBank HongKong,109747,56972,52775
2018-03-01,JP Morgan,CitiBank HongKong,107948,57381,50567
2018-04-01,JP Morgan,CitiBank HongKong,102542,58353,44189
2010-01-01,Bank of America,CitiBank New York,12743,98759,-86016
2010-02-01,Bank of America,CitiBank New York,15375,91483,-76108
2010-03-01,Bank of America,CitiBank New York,19285,96961,-77676
2010-04-01,Bank of America,CitiBank New York,19244,95181,-75937
2010-05-01,Bank of America,CitiBank New York,18531,97533,-79002
2010-06-01,Bank of America,CitiBank New York,17293,94139,-76846
2010-07-01,Bank of America,CitiBank New York,12781,94993,-82212
2010-08-01,Bank of America,CitiBank New York,19947,94968,-75021
2010-09-01,Bank of America,CitiBank New York,18767,96769,-78002
2010-10-01,Bank of America,CitiBank New York,19434,93122,-73688
2010-11-01,Bank of America,CitiBank New York,29698,97543,-67845
2010-12-01,Bank of America,CitiBank New York,24475,93284,-68809
2011-01-01,Bank of America,CitiBank New York,25381,95325,-69944
2011-02-01,Bank of America,CitiBank New York,23979,94252,-70273
2011-03-01,Bank of America,CitiBank New York,26651,99834,-73183
2011-04-01,Bank of America,CitiBank New York,29892,98289,-68397
2011-05-01,Bank of America,CitiBank New York,27491,94522,-67031
2011-06-01,Bank of America,CitiBank New York,24252,97454,-73202
2011-07-01,Bank of America,CitiBank New York,26361,98837,-72476
2011-08-01,Bank of America,CitiBank New York,27597,92434,-64837
2011-09-01,Bank of America,CitiBank New York,39228,83779,-44551
2011-10-01,Bank of America,CitiBank New York,31447,81113,-49666
2011-11-01,Bank of America,CitiBank New York,32556,87176,-54620
2011-12-01,Bank of America,CitiBank New York,33612,81292,-47680
2012-01-01,Bank of America,CitiBank New York,31291,86611,-55320
2012-02-01,Bank of America,CitiBank New York,36352,85768,-49416
2012-03-01,Bank of America,CitiBank New York,33717,86554,-52837
2012-04-01,Bank of America,CitiBank New York,38583,88473,-49890
2012-05-01,Bank of America,CitiBank New York,36664,86368,-49704
2012-06-01,Bank of America,CitiBank New York,33127,86877,-53750
2012-07-01,Bank of America,CitiBank New York,44668,83411,-38743
2012-08-01,Bank of America,CitiBank New York,49819,82349,-32530
2012-09-01,Bank of America,CitiBank New York,48454,81368,-32914
2012-10-01,Bank of America,CitiBank New York,46991,88197,-41206
2012-11-01,Bank of America,CitiBank New York,46144,84345,-38201
2012-12-01,Bank of America,CitiBank New York,48192,83963,-35771
2013-01-01,Bank of America,CitiBank New York,42897,86726,-43829
2013-02-01,Bank of America,CitiBank New York,41773,82978,-41205
2013-03-01,Bank of America,CitiBank New York,44325,85566,-41241
2013-04-01,Bank of America,CitiBank New York,42288,87822,-45534
2013-05-01,Bank of America,CitiBank New York,51324,74743,-23419
2013-06-01,Bank of America,CitiBank New York,56787,76123,-19336
2013-07-01,Bank of America,CitiBank New York,51236,74274,-23038
2013-08-01,Bank of America,CitiBank New York,53968,79892,-25924
2013-09-01,Bank of America,CitiBank New York,55254,75647,-20393
2013-10-01,Bank of America,CitiBank New York,59779,72388,-12609
2013-11-01,Bank of America,CitiBank New York,53675,78712,-25037
2013-12-01,Bank of America,CitiBank New York,55483,72217,-16734
2014-01-01,Bank of America,CitiBank New York,54497,79627,-25130
2014-02-01,Bank of America,CitiBank New York,54916,79285,-24369
2014-03-01,Bank of America,CitiBank New York,65746,71524,-5778
2014-04-01,Bank of America,CitiBank New York,67458,79913,-12455
2014-05-01,Bank of America,CitiBank New York,64389,74869,-10480
2014-06-01,Bank of America,CitiBank New York,64395,75243,-10848
2014-07-01,Bank of America,CitiBank New York,65932,71879,-5947
2014-08-01,Bank of America,CitiBank New York,64469,78556,-14087
2014-09-01,Bank of America,CitiBank New York,69987,76167,-6180
2014-10-01,Bank of America,CitiBank New York,64276,76776,-12500
2014-11-01,Bank of America,CitiBank New York,63541,77283,-13742
2014-12-01,Bank of America,CitiBank New York,62551,71338,-8787
2015-01-01,Bank of America,CitiBank New York,71616,62964,8652
2015-02-01,Bank of America,CitiBank New York,78642,67172,11470
2015-03-01,Bank of America,CitiBank New York,76113,66218,9895
2015-04-01,Bank of America,CitiBank New York,71474,61187,10287
2015-05-01,Bank of America,CitiBank New York,77544,67476,10068
2015-06-01,Bank of America,CitiBank New York,76266,68767,7499
2015-07-01,Bank of America,CitiBank New York,77196,62311,14885
2015-08-01,Bank of America,CitiBank New York,79394,61185,18209
2015-09-01,Bank of America,CitiBank New York,75443,63234,12209
2015-10-01,Bank of America,CitiBank New York,76739,65672,11067
2015-11-01,Bank of America,CitiBank New York,87663,62977,24686
2015-12-01,Bank of America,CitiBank New York,87771,68692,19079
2016-01-01,Bank of America,CitiBank New York,82291,65414,16877
2016-02-01,Bank of America,CitiBank New York,83873,69739,14134
2016-03-01,Bank of America,CitiBank New York,88596,69213,19383
2016-04-01,Bank of America,CitiBank New York,87278,64992,22286
2016-05-01,Bank of America,CitiBank New York,84239,62169,22070
2016-06-01,Bank of America,CitiBank New York,81168,61666,19502
2016-07-01,Bank of America,CitiBank New York,88664,63515,25149
2016-08-01,Bank of America,CitiBank New York,83518,68414,15104
2016-09-01,Bank of America,CitiBank New York,95923,53631,42292
2016-10-01,Bank of America,CitiBank New York,97167,57693,39474
2016-11-01,Bank of America,CitiBank New York,95345,59766,35579
2016-12-01,Bank of America,CitiBank New York,98543,56591,41952
2017-01-01,Bank of America,CitiBank New York,99833,55241,44592
2017-02-01,Bank of America,CitiBank New York,91271,56138,35133
2017-03-01,Bank of America,CitiBank New York,99356,52933,46423
2017-04-01,Bank of America,CitiBank New York,96521,54214,42307
2017-05-01,Bank of America,CitiBank New York,98465,57573,40892
2017-06-01,Bank of America,CitiBank New York,95912,56162,39750
2017-07-01,Bank of America,CitiBank New York,103582,56549,47033
2017-08-01,Bank of America,CitiBank New York,103818,59958,43860
2017-09-01,Bank of America,CitiBank New York,107865,57722,50143
2017-10-01,Bank of America,CitiBank New York,109449,57749,51700
2017-11-01,Bank of America,CitiBank New York,107536,53724,53812
2017-12-01,Bank of America,CitiBank New York,108178,54562,53616
2018-01-01,Bank of America,CitiBank New York,106131,58473,47658
2018-02-01,Bank of America,CitiBank New York,104544,56555,47989
2018-03-01,Bank of America,CitiBank New York,109586,53464,56122
2018-04-01,Bank of America,CitiBank New York,103838,58976,44862
2010-01-01,Bank of America,CitiBank London,16473,95916,-79443
2010-02-01,Bank of America,CitiBank London,11737,99374,-87637
2010-03-01,Bank of America,CitiBank London,18614,91489,-72875
2010-04-01,Bank of America,CitiBank London,12844,94947,-82103
2010-05-01,Bank of America,CitiBank London,12579,92566,-79987
2010-06-01,Bank of America,CitiBank London,17588,95585,-77997
2010-07-01,Bank of America,CitiBank London,14525,98253,-83728
2010-08-01,Bank of America,CitiBank London,16449,91413,-74964
2010-09-01,Bank of America,CitiBank London,15739,98273,-82534
2010-10-01,Bank of America,CitiBank London,13291,93282,-79991
2010-11-01,Bank of America,CitiBank London,23784,98635,-74851
2010-12-01,Bank of America,CitiBank London,24598,91272,-66674
2011-01-01,Bank of America,CitiBank London,23652,96644,-72992
2011-02-01,Bank of America,CitiBank London,28842,95879,-67037
2011-03-01,Bank of America,CitiBank London,27852,94839,-66987
2011-04-01,Bank of America,CitiBank London,21662,94392,-72730
2011-05-01,Bank of America,CitiBank London,28516,93681,-65165
2011-06-01,Bank of America,CitiBank London,22136,96245,-74109
2011-07-01,Bank of America,CitiBank London,29297,91418,-62121
2011-08-01,Bank of America,CitiBank London,23444,97559,-74115
2011-09-01,Bank of America,CitiBank London,38284,89513,-51229
2011-10-01,Bank of America,CitiBank London,35218,84529,-49311
2011-11-01,Bank of America,CitiBank London,37336,82561,-45225
2011-12-01,Bank of America,CitiBank London,33816,84243,-50427
2012-01-01,Bank of America,CitiBank London,34887,86117,-51230
2012-02-01,Bank of America,CitiBank London,38418,81575,-43157
2012-03-01,Bank of America,CitiBank London,33615,86987,-53372
2012-04-01,Bank of America,CitiBank London,36698,87489,-50791
2012-05-01,Bank of America,CitiBank London,33921,89365,-55444
2012-06-01,Bank of America,CitiBank London,33689,86473,-52784
2012-07-01,Bank of America,CitiBank London,42228,88136,-45908
2012-08-01,Bank of America,CitiBank London,49983,88279,-38296
2012-09-01,Bank of America,CitiBank London,48847,83673,-34826
2012-10-01,Bank of America,CitiBank London,49954,82574,-32620
2012-11-01,Bank of America,CitiBank London,46169,85948,-39779
2012-12-01,Bank of America,CitiBank London,41242,86553,-45311
2013-01-01,Bank of America,CitiBank London,42475,87613,-45138
2013-02-01,Bank of America,CitiBank London,45673,81378,-35705
2013-03-01,Bank of America,CitiBank London,42558,86259,-43701
2013-04-01,Bank of America,CitiBank London,47575,88658,-41083
2013-05-01,Bank of America,CitiBank London,57363,77423,-20060
2013-06-01,Bank of America,CitiBank London,58668,71613,-12945
2013-07-01,Bank of America,CitiBank London,57933,72595,-14662
2013-08-01,Bank of America,CitiBank London,56538,76283,-19745
2013-09-01,Bank of America,CitiBank London,56627,72951,-16324
2013-10-01,Bank of America,CitiBank London,54233,71163,-16930
2013-11-01,Bank of America,CitiBank London,59837,78885,-19048
2013-12-01,Bank of America,CitiBank London,51791,74252,-22461
2014-01-01,Bank of America,CitiBank London,54919,78346,-23427
2014-02-01,Bank of America,CitiBank London,53926,71976,-18050
2014-03-01,Bank of America,CitiBank London,63712,71694,-7982
2014-04-01,Bank of America,CitiBank London,67919,75663,-7744
2014-05-01,Bank of America,CitiBank London,65969,78925,-12956
2014-06-01,Bank of America,CitiBank London,67923,76263,-8340
2014-07-01,Bank of America,CitiBank London,66662,79238,-12576
2014-08-01,Bank of America,CitiBank London,68734,72812,-4078
2014-09-01,Bank of America,CitiBank London,64478,77197,-12719
2014-10-01,Bank of America,CitiBank London,67394,77883,-10489
2014-11-01,Bank of America,CitiBank London,68953,71633,-2680
2014-12-01,Bank of America,CitiBank London,69296,73883,-4587
2015-01-01,Bank of America,CitiBank London,73455,63267,10188
2015-02-01,Bank of America,CitiBank London,73637,64911,8726
2015-03-01,Bank of America,CitiBank London,77335,66966,10369
2015-04-01,Bank of America,CitiBank London,76366,68972,7394
2015-05-01,Bank of America,CitiBank London,78611,66264,12347
2015-06-01,Bank of America,CitiBank London,73889,67439,6450
2015-07-01,Bank of America,CitiBank London,72175,63274,8901
2015-08-01,Bank of America,CitiBank London,71735,68342,3393
2015-09-01,Bank of America,CitiBank London,74941,61947,12994
2015-10-01,Bank of America,CitiBank London,75456,68448,7008
2015-11-01,Bank of America,CitiBank London,86747,69215,17532
2015-12-01,Bank of America,CitiBank London,88496,63951,24545
2016-01-01,Bank of America,CitiBank London,85832,69177,16655
2016-02-01,Bank of America,CitiBank London,87639,64824,22815
2016-03-01,Bank of America,CitiBank London,82921,65915,17006
2016-04-01,Bank of America,CitiBank London,83822,62412,21410
2016-05-01,Bank of America,CitiBank London,85649,67658,17991
2016-06-01,Bank of America,CitiBank London,82969,61456,21513
2016-07-01,Bank of America,CitiBank London,83164,67731,15433
2016-08-01,Bank of America,CitiBank London,85943,64447,21496
2016-09-01,Bank of America,CitiBank London,95144,51343,43801
2016-10-01,Bank of America,CitiBank London,97713,58184,39529
2016-11-01,Bank of America,CitiBank London,92265,58946,33319
2016-12-01,Bank of America,CitiBank London,94814,55376,39438
2017-01-01,Bank of America,CitiBank London,93282,57842,35440
2017-02-01,Bank of America,CitiBank London,92841,59288,33553
2017-03-01,Bank of America,CitiBank London,99517,59617,39900
2017-04-01,Bank of America,CitiBank London,99213,55414,43799
2017-05-01,Bank of America,CitiBank London,93741,55521,38220
2017-06-01,Bank of America,CitiBank London,93387,58246,35141
2017-07-01,Bank of America,CitiBank London,106994,57369,49625
2017-08-01,Bank of America,CitiBank London,108742,51559,57183
2017-09-01,Bank of America,CitiBank London,102428,51813,50615
2017-10-01,Bank of America,CitiBank London,108579,57255,51324
2017-11-01,Bank of America,CitiBank London,103145,58684,44461
2017-12-01,Bank of America,CitiBank London,102374,59524,42850
2018-01-01,Bank of America,CitiBank London,106792,51376,55416
2018-02-01,Bank of America,CitiBank London,104578,55155,49423
2018-03-01,Bank of America,CitiBank London,103894,52375,51519
2018-04-01,Bank of America,CitiBank London,108259,58586,49673
2010-01-01,Bank of America,CitiBank Pune,12576,91579,-79003
2010-02-01,Bank of America,CitiBank Pune,17323,94771,-77448
2010-03-01,Bank of America,CitiBank Pune,15797,94185,-78388
2010-04-01,Bank of America,CitiBank Pune,14886,91217,-76331
2010-05-01,Bank of America,CitiBank Pune,18117,95637,-77520
2010-06-01,Bank of America,CitiBank Pune,16493,94798,-78305
2010-07-01,Bank of America,CitiBank Pune,18272,91671,-73399
2010-08-01,Bank of America,CitiBank Pune,18289,91979,-73690
2010-09-01,Bank of America,CitiBank Pune,11168,97993,-86825
2010-10-01,Bank of America,CitiBank Pune,13388,95833,-82445
2010-11-01,Bank of America,CitiBank Pune,22467,96354,-73887
2010-12-01,Bank of America,CitiBank Pune,26379,94579,-68200
2011-01-01,Bank of America,CitiBank Pune,22321,99995,-77674
2011-02-01,Bank of America,CitiBank Pune,24631,92975,-68344
2011-03-01,Bank of America,CitiBank Pune,27762,94691,-66929
2011-04-01,Bank of America,CitiBank Pune,25732,93655,-67923
2011-05-01,Bank of America,CitiBank Pune,29522,93179,-63657
2011-06-01,Bank of America,CitiBank Pune,25226,97286,-72060
2011-07-01,Bank of America,CitiBank Pune,21173,92894,-71721
2011-08-01,Bank of America,CitiBank Pune,23838,95119,-71281
2011-09-01,Bank of America,CitiBank Pune,35652,84879,-49227
2011-10-01,Bank of America,CitiBank Pune,35518,84493,-48975
2011-11-01,Bank of America,CitiBank Pune,32473,86223,-53750
2011-12-01,Bank of America,CitiBank Pune,36944,85244,-48300
2012-01-01,Bank of America,CitiBank Pune,35691,86847,-51156
2012-02-01,Bank of America,CitiBank Pune,38694,85178,-46484
2012-03-01,Bank of America,CitiBank Pune,34283,89348,-55065
2012-04-01,Bank of America,CitiBank Pune,36259,82879,-46620
2012-05-01,Bank of America,CitiBank Pune,35116,87133,-52017
2012-06-01,Bank of America,CitiBank Pune,36782,85363,-48581
2012-07-01,Bank of America,CitiBank Pune,41229,88136,-46907
2012-08-01,Bank of America,CitiBank Pune,42296,85556,-43260
2012-09-01,Bank of America,CitiBank Pune,48558,84269,-35711
2012-10-01,Bank of America,CitiBank Pune,45666,84498,-38832
2012-11-01,Bank of America,CitiBank Pune,49395,89982,-40587
2012-12-01,Bank of America,CitiBank Pune,42554,82868,-40314
2013-01-01,Bank of America,CitiBank Pune,46279,82167,-35888
2013-02-01,Bank of America,CitiBank Pune,44553,88953,-44400
2013-03-01,Bank of America,CitiBank Pune,48265,88832,-40567
2013-04-01,Bank of America,CitiBank Pune,45163,83863,-38700
2013-05-01,Bank of America,CitiBank Pune,54465,76598,-22133
2013-06-01,Bank of America,CitiBank Pune,58872,77516,-18644
2013-07-01,Bank of America,CitiBank Pune,58115,79411,-21296
2013-08-01,Bank of America,CitiBank Pune,59155,78232,-19077
2013-09-01,Bank of America,CitiBank Pune,58177,71322,-13145
2013-10-01,Bank of America,CitiBank Pune,51457,75573,-24116
2013-11-01,Bank of America,CitiBank Pune,58279,71637,-13358
2013-12-01,Bank of America,CitiBank Pune,59272,73729,-14457
2014-01-01,Bank of America,CitiBank Pune,59193,79541,-20348
2014-02-01,Bank of America,CitiBank Pune,59348,75289,-15941
2014-03-01,Bank of America,CitiBank Pune,66194,74335,-8141
2014-04-01,Bank of America,CitiBank Pune,67432,74384,-6952
2014-05-01,Bank of America,CitiBank Pune,65237,78249,-13012
2014-06-01,Bank of America,CitiBank Pune,66537,74484,-7947
2014-07-01,Bank of America,CitiBank Pune,63582,72692,-9110
2014-08-01,Bank of America,CitiBank Pune,69356,74849,-5493
2014-09-01,Bank of America,CitiBank Pune,69277,76124,-6847
2014-10-01,Bank of America,CitiBank Pune,65835,73131,-7296
2014-11-01,Bank of America,CitiBank Pune,64712,78671,-13959
2014-12-01,Bank of America,CitiBank Pune,63532,74838,-11306
2015-01-01,Bank of America,CitiBank Pune,77499,68958,8541
2015-02-01,Bank of America,CitiBank Pune,76713,63988,12725
2015-03-01,Bank of America,CitiBank Pune,71125,61591,9534
2015-04-01,Bank of America,CitiBank Pune,75695,67436,8259
2015-05-01,Bank of America,CitiBank Pune,75491,69221,6270
2015-06-01,Bank of America,CitiBank Pune,71818,61844,9974
2015-07-01,Bank of America,CitiBank Pune,73688,63298,10390
2015-08-01,Bank of America,CitiBank Pune,77134,68579,8555
2015-09-01,Bank of America,CitiBank Pune,76993,67888,9105
2015-10-01,Bank of America,CitiBank Pune,74129,67385,6744
2015-11-01,Bank of America,CitiBank Pune,88158,69264,18894
2015-12-01,Bank of America,CitiBank Pune,82829,64788,18041
2016-01-01,Bank of America,CitiBank Pune,81962,63626,18336
2016-02-01,Bank of America,CitiBank Pune,86342,67666,18676
2016-03-01,Bank of America,CitiBank Pune,88136,62152,25984
2016-04-01,Bank of America,CitiBank Pune,86265,69131,17134
2016-05-01,Bank of America,CitiBank Pune,81482,62369,19113
2016-06-01,Bank of America,CitiBank Pune,84269,61421,22848
2016-07-01,Bank of America,CitiBank Pune,84413,67549,16864
2016-08-01,Bank of America,CitiBank Pune,84514,69887,14627
2016-09-01,Bank of America,CitiBank Pune,99469,56257,43212
2016-10-01,Bank of America,CitiBank Pune,97268,55498,41770
2016-11-01,Bank of America,CitiBank Pune,91458,53774,37684
2016-12-01,Bank of America,CitiBank Pune,99738,53764,45974
2017-01-01,Bank of America,CitiBank Pune,98221,51743,46478
2017-02-01,Bank of America,CitiBank Pune,94183,54428,39755
2017-03-01,Bank of America,CitiBank Pune,93425,52684,40741
2017-04-01,Bank of America,CitiBank Pune,91352,56181,35171
2017-05-01,Bank of America,CitiBank Pune,94772,53274,41498
2017-06-01,Bank of America,CitiBank Pune,99245,55567,43678
2017-07-01,Bank of America,CitiBank Pune,108516,54189,54327
2017-08-01,Bank of America,CitiBank Pune,102475,59861,42614
2017-09-01,Bank of America,CitiBank Pune,107116,58339,48777
2017-10-01,Bank of America,CitiBank Pune,107911,59913,47998
2017-11-01,Bank of America,CitiBank Pune,109115,56836,52279
2017-12-01,Bank of America,CitiBank Pune,107628,53648,53980
2018-01-01,Bank of America,CitiBank Pune,101411,54171,47240
2018-02-01,Bank of America,CitiBank Pune,101346,59777,41569
2018-03-01,Bank of America,CitiBank Pune,105464,56635,48829
2018-04-01,Bank of America,CitiBank Pune,101618,53797,47821
2010-01-01,Bank of America,CitiBank Singapore,11361,95486,-84125
2010-02-01,Bank of America,CitiBank Singapore,17442,98737,-81295
2010-03-01,Bank of America,CitiBank Singapore,13429,98916,-85487
2010-04-01,Bank of America,CitiBank Singapore,18815,97545,-78730
2010-05-01,Bank of America,CitiBank Singapore,13132,99924,-86792
2010-06-01,Bank of America,CitiBank Singapore,15886,95482,-79596
2010-07-01,Bank of America,CitiBank Singapore,18588,95367,-76779
2010-08-01,Bank of America,CitiBank Singapore,17772,92554,-74782
2010-09-01,Bank of America,CitiBank Singapore,14789,95243,-80454
2010-10-01,Bank of America,CitiBank Singapore,14576,95119,-80543
2010-11-01,Bank of America,CitiBank Singapore,28542,96835,-68293
2010-12-01,Bank of America,CitiBank Singapore,21783,96418,-74635
2011-01-01,Bank of America,CitiBank Singapore,28956,97987,-69031
2011-02-01,Bank of America,CitiBank Singapore,21446,98687,-77241
2011-03-01,Bank of America,CitiBank Singapore,24356,93651,-69295
2011-04-01,Bank of America,CitiBank Singapore,22241,92584,-70343
2011-05-01,Bank of America,CitiBank Singapore,22294,96258,-73964
2011-06-01,Bank of America,CitiBank Singapore,22665,96428,-73763
2011-07-01,Bank of America,CitiBank Singapore,22344,98316,-75972
2011-08-01,Bank of America,CitiBank Singapore,25693,94744,-69051
2011-09-01,Bank of America,CitiBank Singapore,34666,87339,-52673
2011-10-01,Bank of America,CitiBank Singapore,36892,83215,-46323
2011-11-01,Bank of America,CitiBank Singapore,34478,85566,-51088
2011-12-01,Bank of America,CitiBank Singapore,37879,81267,-43388
2012-01-01,Bank of America,CitiBank Singapore,39583,85363,-45780
2012-02-01,Bank of America,CitiBank Singapore,36168,81781,-45613
2012-03-01,Bank of America,CitiBank Singapore,32168,83565,-51397
2012-04-01,Bank of America,CitiBank Singapore,33548,87143,-53595
2012-05-01,Bank of America,CitiBank Singapore,34279,89823,-55544
2012-06-01,Bank of America,CitiBank Singapore,35373,84314,-48941
2012-07-01,Bank of America,CitiBank Singapore,46568,89227,-42659
2012-08-01,Bank of America,CitiBank Singapore,41221,83615,-42394
2012-09-01,Bank of America,CitiBank Singapore,49867,83112,-33245
2012-10-01,Bank of America,CitiBank Singapore,42566,82823,-40257
2012-11-01,Bank of America,CitiBank Singapore,43928,84557,-40629
2012-12-01,Bank of America,CitiBank Singapore,48542,81833,-33291
2013-01-01,Bank of America,CitiBank Singapore,49526,82471,-32945
2013-02-01,Bank of America,CitiBank Singapore,41383,89736,-48353
2013-03-01,Bank of America,CitiBank Singapore,48326,89642,-41316
2013-04-01,Bank of America,CitiBank Singapore,45933,82666,-36733
2013-05-01,Bank of America,CitiBank Singapore,51247,76792,-25545
2013-06-01,Bank of America,CitiBank Singapore,53386,73596,-20210
2013-07-01,Bank of America,CitiBank Singapore,53487,73845,-20358
2013-08-01,Bank of America,CitiBank Singapore,51223,79439,-28216
2013-09-01,Bank of America,CitiBank Singapore,53921,76618,-22697
2013-10-01,Bank of America,CitiBank Singapore,52216,72246,-20030
2013-11-01,Bank of America,CitiBank Singapore,57128,75498,-18370
2013-12-01,Bank of America,CitiBank Singapore,58176,75193,-17017
2014-01-01,Bank of America,CitiBank Singapore,52474,76214,-23740
2014-02-01,Bank of America,CitiBank Singapore,53396,72538,-19142
2014-03-01,Bank of America,CitiBank Singapore,63524,74359,-10835
2014-04-01,Bank of America,CitiBank Singapore,62875,76684,-13809
2014-05-01,Bank of America,CitiBank Singapore,62984,77877,-14893
2014-06-01,Bank of America,CitiBank Singapore,68894,74398,-5504
2014-07-01,Bank of America,CitiBank Singapore,64965,71168,-6203
2014-08-01,Bank of America,CitiBank Singapore,63367,77674,-14307
2014-09-01,Bank of America,CitiBank Singapore,65286,71447,-6161
2014-10-01,Bank of America,CitiBank Singapore,67177,77227,-10050
2014-11-01,Bank of America,CitiBank Singapore,63433,77951,-14518
2014-12-01,Bank of America,CitiBank Singapore,63749,71923,-8174
2015-01-01,Bank of America,CitiBank Singapore,76271,64269,12002
2015-02-01,Bank of America,CitiBank Singapore,78156,62636,15520
2015-03-01,Bank of America,CitiBank Singapore,79471,61276,18195
2015-04-01,Bank of America,CitiBank Singapore,71525,65661,5864
2015-05-01,Bank of America,CitiBank Singapore,76275,63864,12411
2015-06-01,Bank of America,CitiBank Singapore,71351,64963,6388
2015-07-01,Bank of America,CitiBank Singapore,73345,62524,10821
2015-08-01,Bank of America,CitiBank Singapore,72695,61742,10953
2015-09-01,Bank of America,CitiBank Singapore,79366,65723,13643
2015-10-01,Bank of America,CitiBank Singapore,78467,65152,13315
2015-11-01,Bank of America,CitiBank Singapore,87941,62239,25702
2015-12-01,Bank of America,CitiBank Singapore,83388,67652,15736
2016-01-01,Bank of America,CitiBank Singapore,83313,65879,17434
2016-02-01,Bank of America,CitiBank Singapore,86242,67528,18714
2016-03-01,Bank of America,CitiBank Singapore,87683,64992,22691
2016-04-01,Bank of America,CitiBank Singapore,85198,63841,21357
2016-05-01,Bank of America,CitiBank Singapore,84279,63775,20504
2016-06-01,Bank of America,CitiBank Singapore,89972,63952,26020
2016-07-01,Bank of America,CitiBank Singapore,89164,67351,21813
2016-08-01,Bank of America,CitiBank Singapore,86274,61697,24577
2016-09-01,Bank of America,CitiBank Singapore,92777,51728,41049
2016-10-01,Bank of America,CitiBank Singapore,93598,51146,42452
2016-11-01,Bank of America,CitiBank Singapore,97749,56459,41290
2016-12-01,Bank of America,CitiBank Singapore,97599,52415,45184
2017-01-01,Bank of America,CitiBank Singapore,93734,52166,41568
2017-02-01,Bank of America,CitiBank Singapore,93435,52613,40822
2017-03-01,Bank of America,CitiBank Singapore,91926,51553,40373
2017-04-01,Bank of America,CitiBank Singapore,92995,51276,41719
2017-05-01,Bank of America,CitiBank Singapore,98224,58899,39325
2017-06-01,Bank of America,CitiBank Singapore,99114,56932,42182
2017-07-01,Bank of America,CitiBank Singapore,103715,56145,47570
2017-08-01,Bank of America,CitiBank Singapore,101841,55973,45868
2017-09-01,Bank of America,CitiBank Singapore,108538,54317,54221
2017-10-01,Bank of America,CitiBank Singapore,108742,57673,51069
2017-11-01,Bank of America,CitiBank Singapore,109143,55179,53964
2017-12-01,Bank of America,CitiBank Singapore,107211,59447,47764
2018-01-01,Bank of America,CitiBank Singapore,101931,55542,46389
2018-02-01,Bank of America,CitiBank Singapore,102537,52199,50338
2018-03-01,Bank of America,CitiBank Singapore,109746,54712,55034
2018-04-01,Bank of America,CitiBank Singapore,105246,56416,48830
2010-01-01,Bank of America,CitiBank HongKong,15956,99251,-83295
2010-02-01,Bank of America,CitiBank HongKong,15615,93396,-77781
2010-03-01,Bank of America,CitiBank HongKong,13246,96346,-83100
2010-04-01,Bank of America,CitiBank HongKong,16395,95135,-78740
2010-05-01,Bank of America,CitiBank HongKong,13875,95349,-81474
2010-06-01,Bank of America,CitiBank HongKong,11658,91813,-80155
2010-07-01,Bank of America,CitiBank HongKong,15695,93817,-78122
2010-08-01,Bank of America,CitiBank HongKong,15377,97647,-82270
2010-09-01,Bank of America,CitiBank HongKong,13696,91341,-77645
2010-10-01,Bank of America,CitiBank HongKong,14726,95251,-80525
2010-11-01,Bank of America,CitiBank HongKong,24333,91198,-66865
2010-12-01,Bank of America,CitiBank HongKong,28971,94129,-65158
2011-01-01,Bank of America,CitiBank HongKong,25239,93847,-68608
2011-02-01,Bank of America,CitiBank HongKong,26654,99592,-72938
2011-03-01,Bank of America,CitiBank HongKong,21596,98461,-76865
2011-04-01,Bank of America,CitiBank HongKong,21347,94123,-72776
2011-05-01,Bank of America,CitiBank HongKong,25275,94632,-69357
2011-06-01,Bank of America,CitiBank HongKong,22867,93158,-70291
2011-07-01,Bank of America,CitiBank HongKong,25629,93695,-68066
2011-08-01,Bank of America,CitiBank HongKong,28926,92928,-64002
2011-09-01,Bank of America,CitiBank HongKong,39627,83788,-44161
2011-10-01,Bank of America,CitiBank HongKong,31688,89672,-57984
2011-11-01,Bank of America,CitiBank HongKong,36584,86327,-49743
2011-12-01,Bank of America,CitiBank HongKong,39421,89649,-50228
2012-01-01,Bank of America,CitiBank HongKong,38797,82153,-43356
2012-02-01,Bank of America,CitiBank HongKong,35778,86792,-51014
2012-03-01,Bank of America,CitiBank HongKong,39513,87818,-48305
2012-04-01,Bank of America,CitiBank HongKong,37612,88962,-51350
2012-05-01,Bank of America,CitiBank HongKong,34915,81399,-46484
2012-06-01,Bank of America,CitiBank HongKong,37441,85369,-47928
2012-07-01,Bank of America,CitiBank HongKong,48363,89511,-41148
2012-08-01,Bank of America,CitiBank HongKong,49722,81336,-31614
2012-09-01,Bank of America,CitiBank HongKong,48846,88812,-39966
2012-10-01,Bank of America,CitiBank HongKong,46345,89399,-43054
2012-11-01,Bank of America,CitiBank HongKong,42737,81155,-38418
2012-12-01,Bank of America,CitiBank HongKong,47546,85266,-37720
2013-01-01,Bank of America,CitiBank HongKong,45216,84938,-39722
2013-02-01,Bank of America,CitiBank HongKong,43365,89155,-45790
2013-03-01,Bank of America,CitiBank HongKong,44732,83826,-39094
2013-04-01,Bank of America,CitiBank HongKong,45998,85837,-39839
2013-05-01,Bank of America,CitiBank HongKong,55189,79393,-24204
2013-06-01,Bank of America,CitiBank HongKong,51969,71768,-19799
2013-07-01,Bank of America,CitiBank HongKong,58442,79591,-21149
2013-08-01,Bank of America,CitiBank HongKong,59373,73452,-14079
2013-09-01,Bank of America,CitiBank HongKong,53797,72946,-19149
2013-10-01,Bank of America,CitiBank HongKong,57525,73872,-16347
2013-11-01,Bank of America,CitiBank HongKong,59146,72437,-13291
2013-12-01,Bank of America,CitiBank HongKong,56374,74271,-17897
2014-01-01,Bank of America,CitiBank HongKong,59248,77847,-18599
2014-02-01,Bank of America,CitiBank HongKong,59778,72843,-13065
2014-03-01,Bank of America,CitiBank HongKong,64127,74773,-10646
2014-04-01,Bank of America,CitiBank HongKong,63265,75232,-11967
2014-05-01,Bank of America,CitiBank HongKong,62333,79357,-17024
2014-06-01,Bank of America,CitiBank HongKong,67219,72592,-5373
2014-07-01,Bank of America,CitiBank HongKong,67686,77239,-9553
2014-08-01,Bank of America,CitiBank HongKong,61773,73923,-12150
2014-09-01,Bank of America,CitiBank HongKong,67982,73376,-5394
2014-10-01,Bank of America,CitiBank HongKong,63181,75997,-12816
2014-11-01,Bank of America,CitiBank HongKong,69517,75326,-5809
2014-12-01,Bank of America,CitiBank HongKong,64394,72277,-7883
2015-01-01,Bank of America,CitiBank HongKong,72587,66916,5671
2015-02-01,Bank of America,CitiBank HongKong,74834,61284,13550
2015-03-01,Bank of America,CitiBank HongKong,79579,67677,11902
2015-04-01,Bank of America,CitiBank HongKong,71499,63895,7604
2015-05-01,Bank of America,CitiBank HongKong,79156,68264,10892
2015-06-01,Bank of America,CitiBank HongKong,76654,63657,12997
2015-07-01,Bank of America,CitiBank HongKong,76851,64445,12406
2015-08-01,Bank of America,CitiBank HongKong,76412,62131,14281
2015-09-01,Bank of America,CitiBank HongKong,78356,63743,14613
2015-10-01,Bank of America,CitiBank HongKong,74879,62484,12395
2015-11-01,Bank of America,CitiBank HongKong,89834,68835,20999
2015-12-01,Bank of America,CitiBank HongKong,89161,69962,19199
2016-01-01,Bank of America,CitiBank HongKong,84147,69984,14163
2016-02-01,Bank of America,CitiBank HongKong,89434,68452,20982
2016-03-01,Bank of America,CitiBank HongKong,81157,66116,15041
2016-04-01,Bank of America,CitiBank HongKong,82888,69365,13523
2016-05-01,Bank of America,CitiBank HongKong,86441,69927,16514
2016-06-01,Bank of America,CitiBank HongKong,82668,67535,15133
2016-07-01,Bank of America,CitiBank HongKong,85322,64552,20770
2016-08-01,Bank of America,CitiBank HongKong,82697,65285,17412
2016-09-01,Bank of America,CitiBank HongKong,91381,53412,37969
2016-10-01,Bank of America,CitiBank HongKong,99296,59478,39818
2016-11-01,Bank of America,CitiBank HongKong,99179,55595,43584
2016-12-01,Bank of America,CitiBank HongKong,97937,53915,44022
2017-01-01,Bank of America,CitiBank HongKong,96214,51719,44495
2017-02-01,Bank of America,CitiBank HongKong,97222,52115,45107
2017-03-01,Bank of America,CitiBank HongKong,95933,51699,44234
2017-04-01,Bank of America,CitiBank HongKong,92465,51796,40669
2017-05-01,Bank of America,CitiBank HongKong,97479,52771,44708
2017-06-01,Bank of America,CitiBank HongKong,91249,51986,39263
2017-07-01,Bank of America,CitiBank HongKong,106584,56454,50130
2017-08-01,Bank of America,CitiBank HongKong,109429,54226,55203
2017-09-01,Bank of America,CitiBank HongKong,108992,57184,51808
2017-10-01,Bank of America,CitiBank HongKong,104721,52648,52073
2017-11-01,Bank of America,CitiBank HongKong,105254,55571,49683
2017-12-01,Bank of America,CitiBank HongKong,102274,53534,48740
2018-01-01,Bank of America,CitiBank HongKong,107749,54642,53107
2018-02-01,Bank of America,CitiBank HongKong,103488,58967,44521
2018-03-01,Bank of America,CitiBank HongKong,107897,54729,53168
2018-04-01,Bank of America,CitiBank HongKong,108361,55691,52670
2010-01-01,Barclays,CitiBank New York,13819,92732,-78913
2010-02-01,Barclays,CitiBank New York,11868,91381,-79513
2010-03-01,Barclays,CitiBank New York,13268,96872,-83604
2010-04-01,Barclays,CitiBank New York,16918,96325,-79407
2010-05-01,Barclays,CitiBank New York,15593,98957,-83364
2010-06-01,Barclays,CitiBank New York,18151,93929,-75778
2010-07-01,Barclays,CitiBank New York,11826,94688,-82862
2010-08-01,Barclays,CitiBank New York,19544,93664,-74120
2010-09-01,Barclays,CitiBank New York,14982,91126,-76144
2010-10-01,Barclays,CitiBank New York,14817,93654,-78837
2010-11-01,Barclays,CitiBank New York,24779,91817,-67038
2010-12-01,Barclays,CitiBank New York,23934,92394,-68460
2011-01-01,Barclays,CitiBank New York,23741,98688,-74947
2011-02-01,Barclays,CitiBank New York,24675,92275,-67600
2011-03-01,Barclays,CitiBank New York,25269,95455,-70186
2011-04-01,Barclays,CitiBank New York,28661,94973,-66312
2011-05-01,Barclays,CitiBank New York,21834,91668,-69834
2011-06-01,Barclays,CitiBank New York,22645,91431,-68786
2011-07-01,Barclays,CitiBank New York,26585,97452,-70867
2011-08-01,Barclays,CitiBank New York,25942,98962,-73020
2011-09-01,Barclays,CitiBank New York,32791,86373,-53582
2011-10-01,Barclays,CitiBank New York,35588,86639,-51051
2011-11-01,Barclays,CitiBank New York,32798,86832,-54034
2011-12-01,Barclays,CitiBank New York,33793,85328,-51535
2012-01-01,Barclays,CitiBank New York,34132,89331,-55199
2012-02-01,Barclays,CitiBank New York,38915,89549,-50634
2012-03-01,Barclays,CitiBank New York,36316,84182,-47866
2012-04-01,Barclays,CitiBank New York,31953,88481,-56528
2012-05-01,Barclays,CitiBank New York,39227,82258,-43031
2012-06-01,Barclays,CitiBank New York,31394,88346,-56952
2012-07-01,Barclays,CitiBank New York,46654,89718,-43064
2012-08-01,Barclays,CitiBank New York,45582,82467,-36885
2012-09-01,Barclays,CitiBank New York,47429,89363,-41934
2012-10-01,Barclays,CitiBank New York,45651,85184,-39533
2012-11-01,Barclays,CitiBank New York,46369,86615,-40246
2012-12-01,Barclays,CitiBank New York,48116,81696,-33580
2013-01-01,Barclays,CitiBank New York,42681,85829,-43148
2013-02-01,Barclays,CitiBank New York,48244,83759,-35515
2013-03-01,Barclays,CitiBank New York,46338,81591,-35253
2013-04-01,Barclays,CitiBank New York,44284,86326,-42042
2013-05-01,Barclays,CitiBank New York,54437,78525,-24088
2013-06-01,Barclays,CitiBank New York,59743,78441,-18698
2013-07-01,Barclays,CitiBank New York,54271,78989,-24718
2013-08-01,Barclays,CitiBank New York,51619,71259,-19640
2013-09-01,Barclays,CitiBank New York,56547,75282,-18735
2013-10-01,Barclays,CitiBank New York,51998,74925,-22927
2013-11-01,Barclays,CitiBank New York,53678,78975,-25297
2013-12-01,Barclays,CitiBank New York,56732,75969,-19237
2014-01-01,Barclays,CitiBank New York,52899,71854,-18955
2014-02-01,Barclays,CitiBank New York,53465,79672,-26207
2014-03-01,Barclays,CitiBank New York,62993,74529,-11536
2014-04-01,Barclays,CitiBank New York,65137,73734,-8597
2014-05-01,Barclays,CitiBank New York,68545,76276,-7731
2014-06-01,Barclays,CitiBank New York,65153,71624,-6471
2014-07-01,Barclays,CitiBank New York,62729,79756,-17027
2014-08-01,Barclays,CitiBank New York,67238,78657,-11419
2014-09-01,Barclays,CitiBank New York,61134,76933,-15799
2014-10-01,Barclays,CitiBank New York,67489,72636,-5147
2014-11-01,Barclays,CitiBank New York,64856,76336,-11480
2014-12-01,Barclays,CitiBank New York,62129,79696,-17567
2015-01-01,Barclays,CitiBank New York,74231,68715,5516
2015-02-01,Barclays,CitiBank New York,76717,69141,7576
2015-03-01,Barclays,CitiBank New York,78669,67375,11294
2015-04-01,Barclays,CitiBank New York,72575,69266,3309
2015-05-01,Barclays,CitiBank New York,79783,63221,16562
2015-06-01,Barclays,CitiBank New York,79495,64195,15300
2015-07-01,Barclays,CitiBank New York,71564,67864,3700
2015-08-01,Barclays,CitiBank New York,71861,64778,7083
2015-09-01,Barclays,CitiBank New York,77163,66395,10768
2015-10-01,Barclays,CitiBank New York,79142,61689,17453
2015-11-01,Barclays,CitiBank New York,88556,66888,21668
2015-12-01,Barclays,CitiBank New York,88184,66244,21940
2016-01-01,Barclays,CitiBank New York,88481,69911,18570
2016-02-01,Barclays,CitiBank New York,84113,68127,15986
2016-03-01,Barclays,CitiBank New York,86424,69264,17160
2016-04-01,Barclays,CitiBank New York,85398,62139,23259
2016-05-01,Barclays,CitiBank New York,84133,69387,14746
2016-06-01,Barclays,CitiBank New York,87136,67645,19491
2016-07-01,Barclays,CitiBank New York,88744,63546,25198
2016-08-01,Barclays,CitiBank New York,85652,65775,19877
2016-09-01,Barclays,CitiBank New York,98291,54117,44174
2016-10-01,Barclays,CitiBank New York,92927,53814,39113
2016-11-01,Barclays,CitiBank New York,95267,53385,41882
2016-12-01,Barclays,CitiBank New York,97942,54429,43513
2017-01-01,Barclays,CitiBank New York,95255,56194,39061
2017-02-01,Barclays,CitiBank New York,96199,56639,39560
2017-03-01,Barclays,CitiBank New York,94475,57183,37292
2017-04-01,Barclays,CitiBank New York,98123,55829,42294
2017-05-01,Barclays,CitiBank New York,96276,52696,43580
2017-06-01,Barclays,CitiBank New York,93591,51528,42063
2017-07-01,Barclays,CitiBank New York,106866,53252,53614
2017-08-01,Barclays,CitiBank New York,104217,59655,44562
2017-09-01,Barclays,CitiBank New York,108455,56622,51833
2017-10-01,Barclays,CitiBank New York,105694,51362,54332
2017-11-01,Barclays,CitiBank New York,103682,54435,49247
2017-12-01,Barclays,CitiBank New York,106581,57786,48795
2018-01-01,Barclays,CitiBank New York,109713,59769,49944
2018-02-01,Barclays,CitiBank New York,106693,53956,52737
2018-03-01,Barclays,CitiBank New York,103745,58447,45298
2018-04-01,Barclays,CitiBank New York,102166,59518,42648
2010-01-01,Barclays,CitiBank London,15483,99584,-84101
2010-02-01,Barclays,CitiBank London,14254,96888,-82634
2010-03-01,Barclays,CitiBank London,19918,98184,-78266
2010-04-01,Barclays,CitiBank London,18979,92272,-73293
2010-05-01,Barclays,CitiBank London,15818,91826,-76008
2010-06-01,Barclays,CitiBank London,12179,96894,-84715
2010-07-01,Barclays,CitiBank London,12716,91454,-78738
2010-08-01,Barclays,CitiBank London,19752,94613,-74861
2010-09-01,Barclays,CitiBank London,15442,94442,-79000
2010-10-01,Barclays,CitiBank London,14458,95781,-81323
2010-11-01,Barclays,CitiBank London,25322,94217,-68895
2010-12-01,Barclays,CitiBank London,26823,95972,-69149
2011-01-01,Barclays,CitiBank London,26325,92723,-66398
2011-02-01,Barclays,CitiBank London,21484,93542,-72058
2011-03-01,Barclays,CitiBank London,23917,93854,-69937
2011-04-01,Barclays,CitiBank London,21621,92234,-70613
2011-05-01,Barclays,CitiBank London,27658,98828,-71170
2011-06-01,Barclays,CitiBank London,21563,91974,-70411
2011-07-01,Barclays,CitiBank London,23385,93445,-70060
2011-08-01,Barclays,CitiBank London,26449,98868,-72419
2011-09-01,Barclays,CitiBank London,35424,89426,-54002
2011-10-01,Barclays,CitiBank London,34917,86147,-51230
2011-11-01,Barclays,CitiBank London,33811,85796,-51985
2011-12-01,Barclays,CitiBank London,39837,81243,-41406
2012-01-01,Barclays,CitiBank London,36416,85991,-49575
2012-02-01,Barclays,CitiBank London,39897,88147,-48250
2012-03-01,Barclays,CitiBank London,34318,83379,-49061
2012-04-01,Barclays,CitiBank London,37599,89163,-51564
2012-05-01,Barclays,CitiBank London,32223,89722,-57499
2012-06-01,Barclays,CitiBank London,34796,83936,-49140
2012-07-01,Barclays,CitiBank London,43814,85584,-41770
2012-08-01,Barclays,CitiBank London,45343,84178,-38835
2012-09-01,Barclays,CitiBank London,46189,88817,-42628
2012-10-01,Barclays,CitiBank London,41154,86911,-45757
2012-11-01,Barclays,CitiBank London,42237,83944,-41707
2012-12-01,Barclays,CitiBank London,43251,89162,-45911
2013-01-01,Barclays,CitiBank London,47475,84947,-37472
2013-02-01,Barclays,CitiBank London,42368,81829,-39461
2013-03-01,Barclays,CitiBank London,49396,82354,-32958
2013-04-01,Barclays,CitiBank London,47324,88742,-41418
2013-05-01,Barclays,CitiBank London,53782,78425,-24643
2013-06-01,Barclays,CitiBank London,55989,73935,-17946
2013-07-01,Barclays,CitiBank London,53412,77562,-24150
2013-08-01,Barclays,CitiBank London,57435,75625,-18190
2013-09-01,Barclays,CitiBank London,58562,76947,-18385
2013-10-01,Barclays,CitiBank London,58552,76253,-17701
2013-11-01,Barclays,CitiBank London,59811,79711,-19900
2013-12-01,Barclays,CitiBank London,54991,73214,-18223
2014-01-01,Barclays,CitiBank London,56823,73511,-16688
2014-02-01,Barclays,CitiBank London,52151,72644,-20493
2014-03-01,Barclays,CitiBank London,63892,76722,-12830
2014-04-01,Barclays,CitiBank London,69686,74639,-4953
2014-05-01,Barclays,CitiBank London,67458,72351,-4893
2014-06-01,Barclays,CitiBank London,66175,72576,-6401
2014-07-01,Barclays,CitiBank London,66645,78391,-11746
2014-08-01,Barclays,CitiBank London,62332,72961,-10629
2014-09-01,Barclays,CitiBank London,68741,71759,-3018
2014-10-01,Barclays,CitiBank London,68812,78645,-9833
2014-11-01,Barclays,CitiBank London,61948,71368,-9420
2014-12-01,Barclays,CitiBank London,68135,74459,-6324
2015-01-01,Barclays,CitiBank London,72657,66298,6359
2015-02-01,Barclays,CitiBank London,71692,64469,7223
2015-03-01,Barclays,CitiBank London,71863,63231,8632
2015-04-01,Barclays,CitiBank London,75372,66532,8840
2015-05-01,Barclays,CitiBank London,76794,64599,12195
2015-06-01,Barclays,CitiBank London,75968,63421,12547
2015-07-01,Barclays,CitiBank London,79884,63914,15970
2015-08-01,Barclays,CitiBank London,73525,63592,9933
2015-09-01,Barclays,CitiBank London,71952,63339,8613
2015-10-01,Barclays,CitiBank London,73186,62247,10939
2015-11-01,Barclays,CitiBank London,89494,64324,25170
2015-12-01,Barclays,CitiBank London,85216,68489,16727
2016-01-01,Barclays,CitiBank London,85226,62976,22250
2016-02-01,Barclays,CitiBank London,87827,67857,19970
2016-03-01,Barclays,CitiBank London,89958,66484,23474
2016-04-01,Barclays,CitiBank London,87139,63648,23491
2016-05-01,Barclays,CitiBank London,86917,62678,24239
2016-06-01,Barclays,CitiBank London,86157,68656,17501
2016-07-01,Barclays,CitiBank London,83474,61295,22179
2016-08-01,Barclays,CitiBank London,89813,65755,24058
2016-09-01,Barclays,CitiBank London,94864,56625,38239
2016-10-01,Barclays,CitiBank London,94934,51928,43006
2016-11-01,Barclays,CitiBank London,92574,54556,38018
2016-12-01,Barclays,CitiBank London,92338,55493,36845
2017-01-01,Barclays,CitiBank London,91234,59966,31268
2017-02-01,Barclays,CitiBank London,95411,51525,43886
2017-03-01,Barclays,CitiBank London,97161,54127,43034
2017-04-01,Barclays,CitiBank London,96292,51314,44978
2017-05-01,Barclays,CitiBank London,96839,56262,40577
2017-06-01,Barclays,CitiBank London,95582,54262,41320
2017-07-01,Barclays,CitiBank London,102747,55849,46898
2017-08-01,Barclays,CitiBank London,108862,59373,49489
2017-09-01,Barclays,CitiBank London,103742,59626,44116
2017-10-01,Barclays,CitiBank London,101519,58186,43333
2017-11-01,Barclays,CitiBank London,101576,51294,50282
2017-12-01,Barclays,CitiBank London,103721,55635,48086
2018-01-01,Barclays,CitiBank London,103531,53442,50089
2018-02-01,Barclays,CitiBank London,108817,53658,55159
2018-03-01,Barclays,CitiBank London,102792,53468,49324
2018-04-01,Barclays,CitiBank London,101115,56644,44471
2010-01-01,Barclays,CitiBank Pune,11782,98831,-87049
2010-02-01,Barclays,CitiBank Pune,12335,92744,-80409
2010-03-01,Barclays,CitiBank Pune,11832,93252,-81420
2010-04-01,Barclays,CitiBank Pune,13587,96583,-82996
2010-05-01,Barclays,CitiBank Pune,13834,97352,-83518
2010-06-01,Barclays,CitiBank Pune,17242,99198,-81956
2010-07-01,Barclays,CitiBank Pune,17389,91761,-74372
2010-08-01,Barclays,CitiBank Pune,17796,96881,-79085
2010-09-01,Barclays,CitiBank Pune,16179,96421,-80242
2010-10-01,Barclays,CitiBank Pune,19998,95726,-75728
2010-11-01,Barclays,CitiBank Pune,29994,92594,-62600
2010-12-01,Barclays,CitiBank Pune,26522,95421,-68899
2011-01-01,Barclays,CitiBank Pune,23944,94833,-70889
2011-02-01,Barclays,CitiBank Pune,21127,95944,-74817
2011-03-01,Barclays,CitiBank Pune,29425,95595,-66170
2011-04-01,Barclays,CitiBank Pune,28337,99748,-71411
2011-05-01,Barclays,CitiBank Pune,26823,94391,-67568
2011-06-01,Barclays,CitiBank Pune,25261,99662,-74401
2011-07-01,Barclays,CitiBank Pune,24567,96343,-71776
2011-08-01,Barclays,CitiBank Pune,21473,93866,-72393
2011-09-01,Barclays,CitiBank Pune,31914,84662,-52748
2011-10-01,Barclays,CitiBank Pune,35652,82974,-47322
2011-11-01,Barclays,CitiBank Pune,38897,87196,-48299
2011-12-01,Barclays,CitiBank Pune,32673,83349,-50676
2012-01-01,Barclays,CitiBank Pune,37496,85214,-47718
2012-02-01,Barclays,CitiBank Pune,38536,86855,-48319
2012-03-01,Barclays,CitiBank Pune,33727,88473,-54746
2012-04-01,Barclays,CitiBank Pune,39976,87395,-47419
2012-05-01,Barclays,CitiBank Pune,37437,88396,-50959
2012-06-01,Barclays,CitiBank Pune,39182,81845,-42663
2012-07-01,Barclays,CitiBank Pune,45314,84771,-39457
2012-08-01,Barclays,CitiBank Pune,43164,88939,-45775
2012-09-01,Barclays,CitiBank Pune,41737,83355,-41618
2012-10-01,Barclays,CitiBank Pune,41744,81676,-39932
2012-11-01,Barclays,CitiBank Pune,49793,87328,-37535
2012-12-01,Barclays,CitiBank Pune,45736,83312,-37576
2013-01-01,Barclays,CitiBank Pune,41526,82399,-40873
2013-02-01,Barclays,CitiBank Pune,47795,88985,-41190
2013-03-01,Barclays,CitiBank Pune,44139,87945,-43806
2013-04-01,Barclays,CitiBank Pune,45714,85576,-39862
2013-05-01,Barclays,CitiBank Pune,57398,76612,-19214
2013-06-01,Barclays,CitiBank Pune,58735,79995,-21260
2013-07-01,Barclays,CitiBank Pune,54126,72746,-18620
2013-08-01,Barclays,CitiBank Pune,55119,78466,-23347
2013-09-01,Barclays,CitiBank Pune,55722,73819,-18097
2013-10-01,Barclays,CitiBank Pune,55647,76616,-20969
2013-11-01,Barclays,CitiBank Pune,55621,78264,-22643
2013-12-01,Barclays,CitiBank Pune,54733,71129,-16396
2014-01-01,Barclays,CitiBank Pune,55361,73564,-18203
2014-02-01,Barclays,CitiBank Pune,52392,77144,-24752
2014-03-01,Barclays,CitiBank Pune,61878,79834,-17956
2014-04-01,Barclays,CitiBank Pune,66366,74162,-7796
2014-05-01,Barclays,CitiBank Pune,61276,77458,-16182
2014-06-01,Barclays,CitiBank Pune,68757,78991,-10234
2014-07-01,Barclays,CitiBank Pune,66759,76821,-10062
2014-08-01,Barclays,CitiBank Pune,65658,78246,-12588
2014-09-01,Barclays,CitiBank Pune,68967,76961,-7994
2014-10-01,Barclays,CitiBank Pune,67754,72459,-4705
2014-11-01,Barclays,CitiBank Pune,61439,73776,-12337
2014-12-01,Barclays,CitiBank Pune,64482,71863,-7381
2015-01-01,Barclays,CitiBank Pune,76885,63852,13033
2015-02-01,Barclays,CitiBank Pune,73285,61537,11748
2015-03-01,Barclays,CitiBank Pune,74688,64951,9737
2015-04-01,Barclays,CitiBank Pune,74993,66489,8504
2015-05-01,Barclays,CitiBank Pune,78799,63676,15123
2015-06-01,Barclays,CitiBank Pune,73141,63513,9628
2015-07-01,Barclays,CitiBank Pune,78593,66134,12459
2015-08-01,Barclays,CitiBank Pune,79816,61528,18288
2015-09-01,Barclays,CitiBank Pune,76444,67737,8707
2015-10-01,Barclays,CitiBank Pune,72444,63991,8453
2015-11-01,Barclays,CitiBank Pune,85665,66348,19317
2015-12-01,Barclays,CitiBank Pune,84516,68552,15964
2016-01-01,Barclays,CitiBank Pune,81543,63294,18249
2016-02-01,Barclays,CitiBank Pune,83511,68444,15067
2016-03-01,Barclays,CitiBank Pune,86424,64536,21888
2016-04-01,Barclays,CitiBank Pune,81535,67269,14266
2016-05-01,Barclays,CitiBank Pune,81344,66118,15226
2016-06-01,Barclays,CitiBank Pune,87324,65925,21399
2016-07-01,Barclays,CitiBank Pune,81122,65235,15887
2016-08-01,Barclays,CitiBank Pune,86372,62228,24144
2016-09-01,Barclays,CitiBank Pune,98763,54486,44277
2016-10-01,Barclays,CitiBank Pune,92596,52424,40172
2016-11-01,Barclays,CitiBank Pune,95441,56846,38595
2016-12-01,Barclays,CitiBank Pune,96545,54587,41958
2017-01-01,Barclays,CitiBank Pune,98476,57918,40558
2017-02-01,Barclays,CitiBank Pune,95646,57795,37851
2017-03-01,Barclays,CitiBank Pune,94694,59635,35059
2017-04-01,Barclays,CitiBank Pune,93263,57576,35687
2017-05-01,Barclays,CitiBank Pune,95347,59793,35554
2017-06-01,Barclays,CitiBank Pune,94969,53374,41595
2017-07-01,Barclays,CitiBank Pune,104621,59586,45035
2017-08-01,Barclays,CitiBank Pune,106685,52988,53697
2017-09-01,Barclays,CitiBank Pune,107186,51814,55372
2017-10-01,Barclays,CitiBank Pune,108823,56775,52048
2017-11-01,Barclays,CitiBank Pune,101165,58612,42553
2017-12-01,Barclays,CitiBank Pune,108174,54459,53715
2018-01-01,Barclays,CitiBank Pune,103741,57136,46605
2018-02-01,Barclays,CitiBank Pune,109427,51919,57508
2018-03-01,Barclays,CitiBank Pune,109815,52334,57481
2018-04-01,Barclays,CitiBank Pune,104579,57497,47082
2010-01-01,Barclays,CitiBank Singapore,12663,99742,-87079
2010-02-01,Barclays,CitiBank Singapore,15811,95366,-79555
2010-03-01,Barclays,CitiBank Singapore,12156,97636,-85480
2010-04-01,Barclays,CitiBank Singapore,19483,93447,-73964
2010-05-01,Barclays,CitiBank Singapore,18585,97112,-78527
2010-06-01,Barclays,CitiBank Singapore,19679,97861,-78182
2010-07-01,Barclays,CitiBank Singapore,12927,91717,-78790
2010-08-01,Barclays,CitiBank Singapore,16448,96668,-80220
2010-09-01,Barclays,CitiBank Singapore,16552,98547,-81995
2010-10-01,Barclays,CitiBank Singapore,12296,94192,-81896
2010-11-01,Barclays,CitiBank Singapore,22858,92172,-69314
2010-12-01,Barclays,CitiBank Singapore,22725,98315,-75590
2011-01-01,Barclays,CitiBank Singapore,23871,96713,-72842
2011-02-01,Barclays,CitiBank Singapore,27239,97925,-70686
2011-03-01,Barclays,CitiBank Singapore,25593,96437,-70844
2011-04-01,Barclays,CitiBank Singapore,25986,97512,-71526
2011-05-01,Barclays,CitiBank Singapore,28642,97716,-69074
2011-06-01,Barclays,CitiBank Singapore,28378,98813,-70435
2011-07-01,Barclays,CitiBank Singapore,29613,94754,-65141
2011-08-01,Barclays,CitiBank Singapore,24282,96977,-72695
2011-09-01,Barclays,CitiBank Singapore,36881,87736,-50855
2011-10-01,Barclays,CitiBank Singapore,39528,88614,-49086
2011-11-01,Barclays,CitiBank Singapore,36336,82961,-46625
2011-12-01,Barclays,CitiBank Singapore,35898,86623,-50725
2012-01-01,Barclays,CitiBank Singapore,35557,88983,-53426
2012-02-01,Barclays,CitiBank Singapore,37748,89437,-51689
2012-03-01,Barclays,CitiBank Singapore,37229,82588,-45359
2012-04-01,Barclays,CitiBank Singapore,39727,87934,-48207
2012-05-01,Barclays,CitiBank Singapore,34142,84267,-50125
2012-06-01,Barclays,CitiBank Singapore,38132,85721,-47589
2012-07-01,Barclays,CitiBank Singapore,47972,89313,-41341
2012-08-01,Barclays,CitiBank Singapore,43993,87852,-43859
2012-09-01,Barclays,CitiBank Singapore,48727,88279,-39552
2012-10-01,Barclays,CitiBank Singapore,46477,84439,-37962
2012-11-01,Barclays,CitiBank Singapore,41997,83123,-41126
2012-12-01,Barclays,CitiBank Singapore,44372,84842,-40470
2013-01-01,Barclays,CitiBank Singapore,45393,87287,-41894
2013-02-01,Barclays,CitiBank Singapore,49964,85462,-35498
2013-03-01,Barclays,CitiBank Singapore,49466,89956,-40490
2013-04-01,Barclays,CitiBank Singapore,44818,89738,-44920
2013-05-01,Barclays,CitiBank Singapore,59742,73964,-14222
2013-06-01,Barclays,CitiBank Singapore,52865,76276,-23411
2013-07-01,Barclays,CitiBank Singapore,53644,73314,-19670
2013-08-01,Barclays,CitiBank Singapore,58671,72453,-13782
2013-09-01,Barclays,CitiBank Singapore,57374,77712,-20338
2013-10-01,Barclays,CitiBank Singapore,53289,76792,-23503
2013-11-01,Barclays,CitiBank Singapore,56772,77476,-20704
2013-12-01,Barclays,CitiBank Singapore,53286,76688,-23402
2014-01-01,Barclays,CitiBank Singapore,56831,73212,-16381
2014-02-01,Barclays,CitiBank Singapore,56523,77251,-20728
2014-03-01,Barclays,CitiBank Singapore,63194,75652,-12458
2014-04-01,Barclays,CitiBank Singapore,68181,74485,-6304
2014-05-01,Barclays,CitiBank Singapore,61169,75377,-14208
2014-06-01,Barclays,CitiBank Singapore,65314,77877,-12563
2014-07-01,Barclays,CitiBank Singapore,68444,74776,-6332
2014-08-01,Barclays,CitiBank Singapore,63644,74392,-10748
2014-09-01,Barclays,CitiBank Singapore,68985,77721,-8736
2014-10-01,Barclays,CitiBank Singapore,62447,76975,-14528
2014-11-01,Barclays,CitiBank Singapore,63887,79265,-15378
2014-12-01,Barclays,CitiBank Singapore,65362,72923,-7561
2015-01-01,Barclays,CitiBank Singapore,72998,69126,3872
2015-02-01,Barclays,CitiBank Singapore,72698,67165,5533
2015-03-01,Barclays,CitiBank Singapore,79864,61964,17900
2015-04-01,Barclays,CitiBank Singapore,71161,65776,5385
2015-05-01,Barclays,CitiBank Singapore,73194,69275,3919
2015-06-01,Barclays,CitiBank Singapore,73258,64446,8812
2015-07-01,Barclays,CitiBank Singapore,77946,66885,11061
2015-08-01,Barclays,CitiBank Singapore,79565,67199,12366
2015-09-01,Barclays,CitiBank Singapore,76622,63493,13129
2015-10-01,Barclays,CitiBank Singapore,76455,63657,12798
2015-11-01,Barclays,CitiBank Singapore,81864,65321,16543
2015-12-01,Barclays,CitiBank Singapore,83497,62686,20811
2016-01-01,Barclays,CitiBank Singapore,85889,62663,23226
2016-02-01,Barclays,CitiBank Singapore,89726,61961,27765
2016-03-01,Barclays,CitiBank Singapore,85234,67659,17575
2016-04-01,Barclays,CitiBank Singapore,84869,65721,19148
2016-05-01,Barclays,CitiBank Singapore,86813,65744,21069
2016-06-01,Barclays,CitiBank Singapore,89214,69924,19290
2016-07-01,Barclays,CitiBank Singapore,85469,66347,19122
2016-08-01,Barclays,CitiBank Singapore,89737,67827,21910
2016-09-01,Barclays,CitiBank Singapore,99618,53951,45667
2016-10-01,Barclays,CitiBank Singapore,91589,55512,36077
2016-11-01,Barclays,CitiBank Singapore,92649,55484,37165
2016-12-01,Barclays,CitiBank Singapore,98799,57957,40842
2017-01-01,Barclays,CitiBank Singapore,98382,56238,42144
2017-02-01,Barclays,CitiBank Singapore,93558,54376,39182
2017-03-01,Barclays,CitiBank Singapore,91127,54237,36890
2017-04-01,Barclays,CitiBank Singapore,96658,54145,42513
2017-05-01,Barclays,CitiBank Singapore,99285,57528,41757
2017-06-01,Barclays,CitiBank Singapore,91999,56852,35147
2017-07-01,Barclays,CitiBank Singapore,105274,52664,52610
2017-08-01,Barclays,CitiBank Singapore,105966,57456,48510
2017-09-01,Barclays,CitiBank Singapore,106831,58131,48700
2017-10-01,Barclays,CitiBank Singapore,103272,51781,51491
2017-11-01,Barclays,CitiBank Singapore,106342,55984,50358
2017-12-01,Barclays,CitiBank Singapore,108939,58298,50641
2018-01-01,Barclays,CitiBank Singapore,108459,53124,55335
2018-02-01,Barclays,CitiBank Singapore,105888,54939,50949
2018-03-01,Barclays,CitiBank Singapore,102396,57895,44501
2018-04-01,Barclays,CitiBank Singapore,106169,56293,49876
2010-01-01,Barclays,CitiBank HongKong,15517,98499,-82982
2010-02-01,Barclays,CitiBank HongKong,19713,95679,-75966
2010-03-01,Barclays,CitiBank HongKong,19189,92627,-73438
2010-04-01,Barclays,CitiBank HongKong,13124,93554,-80430
2010-05-01,Barclays,CitiBank HongKong,19586,99223,-79637
2010-06-01,Barclays,CitiBank HongKong,19869,95166,-75297
2010-07-01,Barclays,CitiBank HongKong,11423,96388,-84965
2010-08-01,Barclays,CitiBank HongKong,13149,98328,-85179
2010-09-01,Barclays,CitiBank HongKong,18143,96572,-78429
2010-10-01,Barclays,CitiBank HongKong,15891,91547,-75656
2010-11-01,Barclays,CitiBank HongKong,29253,98658,-69405
2010-12-01,Barclays,CitiBank HongKong,29622,99366,-69744
2011-01-01,Barclays,CitiBank HongKong,23741,99323,-75582
2011-02-01,Barclays,CitiBank HongKong,27421,96578,-69157
2011-03-01,Barclays,CitiBank HongKong,29233,98948,-69715
2011-04-01,Barclays,CitiBank HongKong,22939,95573,-72634
2011-05-01,Barclays,CitiBank HongKong,25163,99158,-73995
2011-06-01,Barclays,CitiBank HongKong,25166,93682,-68516
2011-07-01,Barclays,CitiBank HongKong,29973,97487,-67514
2011-08-01,Barclays,CitiBank HongKong,22414,97485,-75071
2011-09-01,Barclays,CitiBank HongKong,33823,89541,-55718
2011-10-01,Barclays,CitiBank HongKong,35817,89789,-53972
2011-11-01,Barclays,CitiBank HongKong,34818,83524,-48706
2011-12-01,Barclays,CitiBank HongKong,32696,87151,-54455
2012-01-01,Barclays,CitiBank HongKong,35364,87226,-51862
2012-02-01,Barclays,CitiBank HongKong,39573,87544,-47971
2012-03-01,Barclays,CitiBank HongKong,38448,81514,-43066
2012-04-01,Barclays,CitiBank HongKong,31536,87219,-55683
2012-05-01,Barclays,CitiBank HongKong,38333,84247,-45914
2012-06-01,Barclays,CitiBank HongKong,37429,84397,-46968
2012-07-01,Barclays,CitiBank HongKong,44268,82497,-38229
2012-08-01,Barclays,CitiBank HongKong,43327,81789,-38462
2012-09-01,Barclays,CitiBank HongKong,45734,85468,-39734
2012-10-01,Barclays,CitiBank HongKong,47819,87861,-40042
2012-11-01,Barclays,CitiBank HongKong,46672,82191,-35519
2012-12-01,Barclays,CitiBank HongKong,43319,85659,-42340
2013-01-01,Barclays,CitiBank HongKong,44653,84296,-39643
2013-02-01,Barclays,CitiBank HongKong,48783,81186,-32403
2013-03-01,Barclays,CitiBank HongKong,48813,86355,-37542
2013-04-01,Barclays,CitiBank HongKong,48763,81543,-32780
2013-05-01,Barclays,CitiBank HongKong,59878,73275,-13397
2013-06-01,Barclays,CitiBank HongKong,57787,79686,-21899
2013-07-01,Barclays,CitiBank HongKong,59935,77481,-17546
2013-08-01,Barclays,CitiBank HongKong,57966,76489,-18523
2013-09-01,Barclays,CitiBank HongKong,58911,79899,-20988
2013-10-01,Barclays,CitiBank HongKong,52621,75233,-22612
2013-11-01,Barclays,CitiBank HongKong,51568,73289,-21721
2013-12-01,Barclays,CitiBank HongKong,59197,73337,-14140
2014-01-01,Barclays,CitiBank HongKong,51334,76159,-24825
2014-02-01,Barclays,CitiBank HongKong,53781,76297,-22516
2014-03-01,Barclays,CitiBank HongKong,67331,77373,-10042
2014-04-01,Barclays,CitiBank HongKong,61686,76717,-15031
2014-05-01,Barclays,CitiBank HongKong,61174,77643,-16469
2014-06-01,Barclays,CitiBank HongKong,65782,79585,-13803
2014-07-01,Barclays,CitiBank HongKong,66511,76346,-9835
2014-08-01,Barclays,CitiBank HongKong,68913,77517,-8604
2014-09-01,Barclays,CitiBank HongKong,61391,77538,-16147
2014-10-01,Barclays,CitiBank HongKong,66634,71897,-5263
2014-11-01,Barclays,CitiBank HongKong,65376,73381,-8005
2014-12-01,Barclays,CitiBank HongKong,66145,78956,-12811
2015-01-01,Barclays,CitiBank HongKong,78219,65169,13050
2015-02-01,Barclays,CitiBank HongKong,78362,69418,8944
2015-03-01,Barclays,CitiBank HongKong,78461,65529,12932
2015-04-01,Barclays,CitiBank HongKong,71941,61163,10778
2015-05-01,Barclays,CitiBank HongKong,77788,63181,14607
2015-06-01,Barclays,CitiBank HongKong,78279,69913,8366
2015-07-01,Barclays,CitiBank HongKong,73374,61848,11526
2015-08-01,Barclays,CitiBank HongKong,77677,64688,12989
2015-09-01,Barclays,CitiBank HongKong,73539,61236,12303
2015-10-01,Barclays,CitiBank HongKong,72444,64974,7470
2015-11-01,Barclays,CitiBank HongKong,88693,67725,20968
2015-12-01,Barclays,CitiBank HongKong,82899,67589,15310
2016-01-01,Barclays,CitiBank HongKong,88163,68611,19552
2016-02-01,Barclays,CitiBank HongKong,88825,64117,24708
2016-03-01,Barclays,CitiBank HongKong,83455,66243,17212
2016-04-01,Barclays,CitiBank HongKong,82526,66943,15583
2016-05-01,Barclays,CitiBank HongKong,83162,68596,14566
2016-06-01,Barclays,CitiBank HongKong,84996,62825,22171
2016-07-01,Barclays,CitiBank HongKong,85655,66936,18719
2016-08-01,Barclays,CitiBank HongKong,85199,69393,15806
2016-09-01,Barclays,CitiBank HongKong,99417,53432,45985
2016-10-01,Barclays,CitiBank HongKong,97212,56687,40525
2016-11-01,Barclays,CitiBank HongKong,93699,55187,38512
2016-12-01,Barclays,CitiBank HongKong,92486,53516,38970
2017-01-01,Barclays,CitiBank HongKong,97359,57857,39502
2017-02-01,Barclays,CitiBank HongKong,91315,52266,39049
2017-03-01,Barclays,CitiBank HongKong,97733,59763,37970
2017-04-01,Barclays,CitiBank HongKong,91689,55659,36030
2017-05-01,Barclays,CitiBank HongKong,97546,57618,39928
2017-06-01,Barclays,CitiBank HongKong,95221,54228,40993
2017-07-01,Barclays,CitiBank HongKong,103367,54394,48973
2017-08-01,Barclays,CitiBank HongKong,101536,53547,47989
2017-09-01,Barclays,CitiBank HongKong,109661,59929,49732
2017-10-01,Barclays,CitiBank HongKong,101323,52158,49165
2017-11-01,Barclays,CitiBank HongKong,102554,59433,43121
2017-12-01,Barclays,CitiBank HongKong,102117,57849,44268
2018-01-01,Barclays,CitiBank HongKong,104945,55868,49077
2018-02-01,Barclays,CitiBank HongKong,108822,56779,52043
2018-03-01,Barclays,CitiBank HongKong,109469,52461,57008
2018-04-01,Barclays,CitiBank HongKong,102842,56336,46506
