Date,Client Name,Legal Entity,Received Amount,Delivered Amount,Net Amount
2010-01-01,HSBC,CitiBank New York,15868,28228,-12360
2010-02-01,HSBC,CitiBank New York,18189,91911,-73722
2010-03-01,HSBC,CitiBank New York,13649,64284,-50635
2010-04-01,HSBC,CitiBank New York,11167,33756,-22589
2010-05-01,HSBC,CitiBank New York,11818,65762,-53944
2010-06-01,HSBC,CitiBank New York,13767,29369,-15602
2010-07-01,HSBC,CitiBank New York,15578,56113,-40535
2010-08-01,HSBC,CitiBank New York,16431,45325,-28894
2010-09-01,HSBC,CitiBank New York,13465,41122,-27657
2010-10-01,HSBC,CitiBank New York,15511,65213,-49702
2010-11-01,HSBC,CitiBank New York,27511,59674,-32163
2010-12-01,HSBC,CitiBank New York,23489,51657,-28168
2011-01-01,HSBC,CitiBank New York,23416,69136,-45720
2011-02-01,HSBC,CitiBank New York,27996,11594,16402
2011-03-01,HSBC,CitiBank New York,25717,56846,-31129
2011-04-01,HSBC,CitiBank New York,28319,67973,-39654
2011-05-01,HSBC,CitiBank New York,25217,14296,10921
2011-06-01,HSBC,CitiBank New York,28938,28458,480
2011-07-01,HSBC,CitiBank New York,21629,62477,-40848
2011-08-01,HSBC,CitiBank New York,23952,74436,-50484
2011-09-01,HSBC,CitiBank New York,38194,32666,5528
2011-10-01,HSBC,CitiBank New York,39938,14496,25442
2011-11-01,HSBC,CitiBank New York,31542,47679,-16137
2011-12-01,HSBC,CitiBank New York,32985,81559,-48574
2012-01-01,HSBC,CitiBank New York,37395,67547,-30152
2012-02-01,HSBC,CitiBank New York,34136,27918,6218
2012-03-01,HSBC,CitiBank New York,37391,56124,-18733
2012-04-01,HSBC,CitiBank New York,33464,59142,-25678
2012-05-01,HSBC,CitiBank New York,37538,89626,-52088
2012-06-01,HSBC,CitiBank New York,36719,51918,-15199
2012-07-01,HSBC,CitiBank New York,49638,67958,-18320
2012-08-01,HSBC,CitiBank New York,44292,82734,-38442
2012-09-01,HSBC,CitiBank New York,48958,83833,-34875
2012-10-01,HSBC,CitiBank New York,43998,82159,-38161
2012-11-01,HSBC,CitiBank New York,43729,21722,22007
2012-12-01,HSBC,CitiBank New York,46994,64315,-17321
2013-01-01,HSBC,CitiBank New York,42254,73487,-31233
2013-02-01,HSBC,CitiBank New York,43577,16498,27079
2013-03-01,HSBC,CitiBank New York,43877,94818,-50941
2013-04-01,HSBC,CitiBank New York,43364,35492,7872
2013-05-01,HSBC,CitiBank New York,51237,94686,-43449
2013-06-01,HSBC,CitiBank New York,53549,63161,-9612
2013-07-01,HSBC,CitiBank New York,51996,92266,-40270
2013-08-01,HSBC,CitiBank New York,51124,44347,6777
2013-09-01,HSBC,CitiBank New York,51283,56938,-5655
2013-10-01,HSBC,CitiBank New York,56211,74575,-18364
2013-11-01,HSBC,CitiBank New York,55272,83568,-28296
2013-12-01,HSBC,CitiBank New York,54192,29514,24678
2014-01-01,HSBC,CitiBank New York,56788,61278,-4490
2014-02-01,HSBC,CitiBank New York,58554,25874,32680
2014-03-01,HSBC,CitiBank New York,67969,61473,6496
2014-04-01,HSBC,CitiBank New York,65424,29315,36109
2014-05-01,HSBC,CitiBank New York,63589,58361,5228
2014-06-01,HSBC,CitiBank New York,64458,21715,42743
2014-07-01,HSBC,CitiBank New York,64787,62449,2338
2014-08-01,HSBC,CitiBank New York,64189,97637,-33448
2014-09-01,HSBC,CitiBank New York,66546,71339,-4793
2014-10-01,HSBC,CitiBank New York,69167,83535,-14368
2014-11-01,HSBC,CitiBank New York,66791,78154,-11363
2014-12-01,HSBC,CitiBank New York,62656,18497,44159
2015-01-01,HSBC,CitiBank New York,75217,41193,34024
2015-02-01,HSBC,CitiBank New York,76542,27655,48887
2015-03-01,HSBC,CitiBank New York,76248,92258,-16010
2015-04-01,HSBC,CitiBank New York,74923,17384,57539
2015-05-01,HSBC,CitiBank New York,77973,24365,53608
2015-06-01,HSBC,CitiBank New York,71598,49966,21632
2015-07-01,HSBC,CitiBank New York,78515,82931,-4416
2015-08-01,HSBC,CitiBank New York,74338,67389,6949
2015-09-01,HSBC,CitiBank New York,74976,11399,63577
2015-10-01,HSBC,CitiBank New York,75188,23986,51202
2015-11-01,HSBC,CitiBank New York,88484,82154,6330
2015-12-01,HSBC,CitiBank New York,84532,47117,37415
2016-01-01,HSBC,CitiBank New York,86287,53994,32293
2016-02-01,HSBC,CitiBank New York,81437,47349,34088
2016-03-01,HSBC,CitiBank New York,84521,47338,37183
2016-04-01,HSBC,CitiBank New York,85864,43113,42751
2016-05-01,HSBC,CitiBank New York,86819,56981,29838
2016-06-01,HSBC,CitiBank New York,88999,58955,30044
2016-07-01,HSBC,CitiBank New York,89296,32284,57012
2016-08-01,HSBC,CitiBank New York,85691,37872,47819
2016-09-01,HSBC,CitiBank New York,91558,56846,34712
2016-10-01,HSBC,CitiBank New York,91215,63453,27762
2016-11-01,HSBC,CitiBank New York,92555,65877,26678
2016-12-01,HSBC,CitiBank New York,95767,23816,71951
2017-01-01,HSBC,CitiBank New York,93938,33664,60274
2017-02-01,HSBC,CitiBank New York,92444,85874,6570
2017-03-01,HSBC,CitiBank New York,96555,77235,19320
2017-04-01,HSBC,CitiBank New York,98543,55835,42708
2017-05-01,HSBC,CitiBank New York,95391,38618,56773
2017-06-01,HSBC,CitiBank New York,99256,13718,85538
2017-07-01,HSBC,CitiBank New York,105948,29479,76469
2017-08-01,HSBC,CitiBank New York,101755,99984,1771
2017-09-01,HSBC,CitiBank New York,101637,75959,25678
2017-10-01,HSBC,CitiBank New York,109286,29287,79999
2017-11-01,HSBC,CitiBank New York,102897,91769,11128
2017-12-01,HSBC,CitiBank New York,105236,53459,51777
2018-01-01,HSBC,CitiBank New York,105998,37522,68476
2018-02-01,HSBC,CitiBank New York,109533,82927,26606
2018-03-01,HSBC,CitiBank New York,105941,84934,21007
2018-04-01,HSBC,CitiBank New York,106617,82993,23624
2010-01-01,HSBC,CitiBank London,16257,96939,-80682
2010-02-01,HSBC,CitiBank London,12327,23689,-11362
2010-03-01,HSBC,CitiBank London,17586,74936,-57350
2010-04-01,HSBC,CitiBank London,14537,63613,-49076
2010-05-01,HSBC,CitiBank London,15732,27866,-12134
2010-06-01,HSBC,CitiBank London,15645,51772,-36127
2010-07-01,HSBC,CitiBank London,19342,89888,-70546
2010-08-01,HSBC,CitiBank London,11399,45438,-34039
2010-09-01,HSBC,CitiBank London,15556,63778,-48222
2010-10-01,HSBC,CitiBank London,16415,98184,-81769
2010-11-01,HSBC,CitiBank London,28723,85892,-57169
2010-12-01,HSBC,CitiBank London,25369,43596,-18227
2011-01-01,HSBC,CitiBank London,28623,18922,9701
2011-02-01,HSBC,CitiBank London,23623,35232,-11609
2011-03-01,HSBC,CitiBank London,26543,93512,-66969
2011-04-01,HSBC,CitiBank London,27595,25976,1619
2011-05-01,HSBC,CitiBank London,24321,93619,-69298
2011-06-01,HSBC,CitiBank London,24413,75146,-50733
2011-07-01,HSBC,CitiBank London,21396,55254,-33858
2011-08-01,HSBC,CitiBank London,22742,81725,-58983
2011-09-01,HSBC,CitiBank London,33348,34129,-781
2011-10-01,HSBC,CitiBank London,31614,91728,-60114
2011-11-01,HSBC,CitiBank London,34638,47155,-12517
2011-12-01,HSBC,CitiBank London,32624,46839,-14215
2012-01-01,HSBC,CitiBank London,37173,37789,-616
2012-02-01,HSBC,CitiBank London,37297,42922,-5625
2012-03-01,HSBC,CitiBank London,35877,45525,-9648
2012-04-01,HSBC,CitiBank London,35941,42686,-6745
2012-05-01,HSBC,CitiBank London,33841,83732,-49891
2012-06-01,HSBC,CitiBank London,34271,81145,-46874
2012-07-01,HSBC,CitiBank London,49597,71177,-21580
2012-08-01,HSBC,CitiBank London,41135,24754,16381
2012-09-01,HSBC,CitiBank London,45541,93822,-48281
2012-10-01,HSBC,CitiBank London,41768,18297,23471
2012-11-01,HSBC,CitiBank London,45861,58778,-12917
2012-12-01,HSBC,CitiBank London,48847,38474,10373
2013-01-01,HSBC,CitiBank London,42928,81321,-38393
2013-02-01,HSBC,CitiBank London,46329,99677,-53348
2013-03-01,HSBC,CitiBank London,42428,58556,-16128
2013-04-01,HSBC,CitiBank London,47216,71225,-24009
2013-05-01,HSBC,CitiBank London,54583,49412,5171
2013-06-01,HSBC,CitiBank London,52366,65344,-12978
2013-07-01,HSBC,CitiBank London,59939,76958,-17019
2013-08-01,HSBC,CitiBank London,51682,99592,-47910
2013-09-01,HSBC,CitiBank London,57725,59625,-1900
2013-10-01,HSBC,CitiBank London,54537,85277,-30740
2013-11-01,HSBC,CitiBank London,54458,23496,30962
2013-12-01,HSBC,CitiBank London,52947,75176,-22229
2014-01-01,HSBC,CitiBank London,59293,15384,43909
2014-02-01,HSBC,CitiBank London,59218,13172,46046
2014-03-01,HSBC,CitiBank London,69818,36839,32979
2014-04-01,HSBC,CitiBank London,61613,29223,32390
2014-05-01,HSBC,CitiBank London,62761,46368,16393
2014-06-01,HSBC,CitiBank London,66337,65679,658
2014-07-01,HSBC,CitiBank London,68818,86952,-18134
2014-08-01,HSBC,CitiBank London,61952,31376,30576
2014-09-01,HSBC,CitiBank London,65851,63299,2552
2014-10-01,HSBC,CitiBank London,67568,54521,13047
2014-11-01,HSBC,CitiBank London,67844,89292,-21448
2014-12-01,HSBC,CitiBank London,67411,18571,48840
2015-01-01,HSBC,CitiBank London,71423,16224,55199
2015-02-01,HSBC,CitiBank London,78758,81256,-2498
2015-03-01,HSBC,CitiBank London,76818,66362,10456
2015-04-01,HSBC,CitiBank London,78933,78963,-30
2015-05-01,HSBC,CitiBank London,79355,97845,-18490
2015-06-01,HSBC,CitiBank London,76926,44222,32704
2015-07-01,HSBC,CitiBank London,78973,29135,49838
2015-08-01,HSBC,CitiBank London,79787,57225,22562
2015-09-01,HSBC,CitiBank London,75784,68715,7069
2015-10-01,HSBC,CitiBank London,79143,74871,4272
2015-11-01,HSBC,CitiBank London,81553,69312,12241
2015-12-01,HSBC,CitiBank London,84647,45483,39164
2016-01-01,HSBC,CitiBank London,85866,35883,49983
2016-02-01,HSBC,CitiBank London,87152,14825,72327
2016-03-01,HSBC,CitiBank London,88288,29679,58609
2016-04-01,HSBC,CitiBank London,84598,64656,19942
2016-05-01,HSBC,CitiBank London,86487,95787,-9300
2016-06-01,HSBC,CitiBank London,83149,91887,-8738
2016-07-01,HSBC,CitiBank London,81537,13815,67722
2016-08-01,HSBC,CitiBank London,87647,12569,75078
2016-09-01,HSBC,CitiBank London,97626,41919,55707
2016-10-01,HSBC,CitiBank London,99558,14311,85247
2016-11-01,HSBC,CitiBank London,99765,61886,37879
2016-12-01,HSBC,CitiBank London,95815,33135,62680
2017-01-01,HSBC,CitiBank London,91427,11133,80294
2017-02-01,HSBC,CitiBank London,97854,88553,9301
2017-03-01,HSBC,CitiBank London,94263,37464,56799
2017-04-01,HSBC,CitiBank London,95812,51179,44633
2017-05-01,HSBC,CitiBank London,99969,16285,83684
2017-06-01,HSBC,CitiBank London,93954,62257,31697
2017-07-01,HSBC,CitiBank London,103375,34971,68404
2017-08-01,HSBC,CitiBank London,102599,32932,69667
2017-09-01,HSBC,CitiBank London,106522,28888,77634
2017-10-01,HSBC,CitiBank London,103162,66155,37007
2017-11-01,HSBC,CitiBank London,105938,32764,73174
2017-12-01,HSBC,CitiBank London,105894,79377,26517
2018-01-01,HSBC,CitiBank London,104762,42363,62399
2018-02-01,HSBC,CitiBank London,107965,46583,61382
2018-03-01,HSBC,CitiBank London,107716,71859,35857
2018-04-01,HSBC,CitiBank London,103892,62213,41679
2010-01-01,HSBC,CitiBank Pune,15179,26466,-11287
2010-02-01,HSBC,CitiBank Pune,15556,76438,-60882
2010-03-01,HSBC,CitiBank Pune,18152,79738,-61586
2010-04-01,HSBC,CitiBank Pune,16766,55382,-38616
2010-05-01,HSBC,CitiBank Pune,11718,11711,7
2010-06-01,HSBC,CitiBank Pune,13122,88513,-75391
2010-07-01,HSBC,CitiBank Pune,14535,69758,-55223
2010-08-01,HSBC,CitiBank Pune,14834,72725,-57891
2010-09-01,HSBC,CitiBank Pune,11345,69134,-57789
2010-10-01,HSBC,CitiBank Pune,14262,13734,528
2010-11-01,HSBC,CitiBank Pune,28157,55659,-27502
2010-12-01,HSBC,CitiBank Pune,28335,51432,-23097
2011-01-01,HSBC,CitiBank Pune,25948,17756,8192
2011-02-01,HSBC,CitiBank Pune,24728,96114,-71386
2011-03-01,HSBC,CitiBank Pune,26425,84914,-58489
2011-04-01,HSBC,CitiBank Pune,22136,11162,10974
2011-05-01,HSBC,CitiBank Pune,22994,52574,-29580
2011-06-01,HSBC,CitiBank Pune,24673,77788,-53115
2011-07-01,HSBC,CitiBank Pune,23954,98411,-74457
2011-08-01,HSBC,CitiBank Pune,24974,62836,-37862
2011-09-01,HSBC,CitiBank Pune,33838,26455,7383
2011-10-01,HSBC,CitiBank Pune,32292,79871,-47579
2011-11-01,HSBC,CitiBank Pune,39363,93433,-54070
2011-12-01,HSBC,CitiBank Pune,31579,99719,-68140
2012-01-01,HSBC,CitiBank Pune,31377,69549,-38172
2012-02-01,HSBC,CitiBank Pune,35713,16281,19432
2012-03-01,HSBC,CitiBank Pune,31761,56912,-25151
2012-04-01,HSBC,CitiBank Pune,39564,29918,9646
2012-05-01,HSBC,CitiBank Pune,37547,28463,9084
2012-06-01,HSBC,CitiBank Pune,34275,37162,-2887
2012-07-01,HSBC,CitiBank Pune,41248,31345,9903
2012-08-01,HSBC,CitiBank Pune,45542,56171,-10629
2012-09-01,HSBC,CitiBank Pune,42323,44316,-1993
2012-10-01,HSBC,CitiBank Pune,46989,19192,27797
2012-11-01,HSBC,CitiBank Pune,48225,62658,-14433
2012-12-01,HSBC,CitiBank Pune,47284,86416,-39132
2013-01-01,HSBC,CitiBank Pune,42932,35314,7618
2013-02-01,HSBC,CitiBank Pune,49457,37624,11833
2013-03-01,HSBC,CitiBank Pune,47612,81469,-33857
2013-04-01,HSBC,CitiBank Pune,47867,43847,4020
2013-05-01,HSBC,CitiBank Pune,58954,17289,41665
2013-06-01,HSBC,CitiBank Pune,51436,75748,-24312
2013-07-01,HSBC,CitiBank Pune,56768,11491,45277
2013-08-01,HSBC,CitiBank Pune,58261,85546,-27285
2013-09-01,HSBC,CitiBank Pune,55289,66419,-11130
2013-10-01,HSBC,CitiBank Pune,57627,31846,25781
2013-11-01,HSBC,CitiBank Pune,58948,98466,-39518
2013-12-01,HSBC,CitiBank Pune,53311,46586,6725
2014-01-01,HSBC,CitiBank Pune,54892,99142,-44250
2014-02-01,HSBC,CitiBank Pune,59425,58141,1284
2014-03-01,HSBC,CitiBank Pune,66819,54186,12633
2014-04-01,HSBC,CitiBank Pune,68938,95594,-26656
2014-05-01,HSBC,CitiBank Pune,61178,97767,-36589
2014-06-01,HSBC,CitiBank Pune,68454,34337,34117
2014-07-01,HSBC,CitiBank Pune,61131,77767,-16636
2014-08-01,HSBC,CitiBank Pune,64159,65367,-1208
2014-09-01,HSBC,CitiBank Pune,69284,42672,26612
2014-10-01,HSBC,CitiBank Pune,68984,43119,25865
2014-11-01,HSBC,CitiBank Pune,64179,88538,-24359
2014-12-01,HSBC,CitiBank Pune,69253,28369,40884
2015-01-01,HSBC,CitiBank Pune,71887,73882,-1995
2015-02-01,HSBC,CitiBank Pune,78577,47423,31154
2015-03-01,HSBC,CitiBank Pune,79934,63816,16118
2015-04-01,HSBC,CitiBank Pune,75956,56523,19433
2015-05-01,HSBC,CitiBank Pune,74591,22883,51708
2015-06-01,HSBC,CitiBank Pune,79299,42282,37017
2015-07-01,HSBC,CitiBank Pune,74948,27399,47549
2015-08-01,HSBC,CitiBank Pune,75858,56897,18961
2015-09-01,HSBC,CitiBank Pune,78767,83928,-5161
2015-10-01,HSBC,CitiBank Pune,76459,76354,105
2015-11-01,HSBC,CitiBank Pune,88545,23737,64808
2015-12-01,HSBC,CitiBank Pune,84685,32433,52252
2016-01-01,HSBC,CitiBank Pune,83539,66795,16744
2016-02-01,HSBC,CitiBank Pune,83225,25161,58064
2016-03-01,HSBC,CitiBank Pune,82417,62918,19499
2016-04-01,HSBC,CitiBank Pune,82252,92532,-10280
2016-05-01,HSBC,CitiBank Pune,88179,93798,-5619
2016-06-01,HSBC,CitiBank Pune,86483,63416,23067
2016-07-01,HSBC,CitiBank Pune,81694,33923,47771
2016-08-01,HSBC,CitiBank Pune,89465,65557,23908
2016-09-01,HSBC,CitiBank Pune,99525,44734,54791
2016-10-01,HSBC,CitiBank Pune,96419,56174,40245
2016-11-01,HSBC,CitiBank Pune,91637,89531,2106
2016-12-01,HSBC,CitiBank Pune,97731,14856,82875
2017-01-01,HSBC,CitiBank Pune,97966,75838,22128
2017-02-01,HSBC,CitiBank Pune,92664,28284,64380
2017-03-01,HSBC,CitiBank Pune,95698,94711,987
2017-04-01,HSBC,CitiBank Pune,98265,16855,81410
2017-05-01,HSBC,CitiBank Pune,98871,34753,64118
2017-06-01,HSBC,CitiBank Pune,94236,49324,44912
2017-07-01,HSBC,CitiBank Pune,104951,19585,85366
2017-08-01,HSBC,CitiBank Pune,101198,37833,63365
2017-09-01,HSBC,CitiBank Pune,103671,72296,31375
2017-10-01,HSBC,CitiBank Pune,108817,71698,37119
2017-11-01,HSBC,CitiBank Pune,104391,88113,16278
2017-12-01,HSBC,CitiBank Pune,101598,64244,37354
2018-01-01,HSBC,CitiBank Pune,102688,47237,55451
2018-02-01,HSBC,CitiBank Pune,101782,76693,25089
2018-03-01,HSBC,CitiBank Pune,109454,85769,23685
2018-04-01,HSBC,CitiBank Pune,104226,34958,69268
2010-01-01,HSBC,CitiBank Singapore,19964,81413,-61449
2010-02-01,HSBC,CitiBank Singapore,14486,74992,-60506
2010-03-01,HSBC,CitiBank Singapore,16417,22223,-5806
2010-04-01,HSBC,CitiBank Singapore,12431,57318,-44887
2010-05-01,HSBC,CitiBank Singapore,17157,64255,-47098
2010-06-01,HSBC,CitiBank Singapore,15999,93461,-77462
2010-07-01,HSBC,CitiBank Singapore,14783,57796,-43013
2010-08-01,HSBC,CitiBank Singapore,19822,88467,-68645
2010-09-01,HSBC,CitiBank Singapore,15169,61984,-46815
2010-10-01,HSBC,CitiBank Singapore,16489,15555,934
2010-11-01,HSBC,CitiBank Singapore,21383,75194,-53811
2010-12-01,HSBC,CitiBank Singapore,23924,24522,-598
2011-01-01,HSBC,CitiBank Singapore,25178,76811,-51633
2011-02-01,HSBC,CitiBank Singapore,21625,82123,-60498
2011-03-01,HSBC,CitiBank Singapore,21348,53777,-32429
2011-04-01,HSBC,CitiBank Singapore,25215,71322,-46107
2011-05-01,HSBC,CitiBank Singapore,26822,68683,-41861
2011-06-01,HSBC,CitiBank Singapore,22445,67468,-45023
2011-07-01,HSBC,CitiBank Singapore,23912,56596,-32684
2011-08-01,HSBC,CitiBank Singapore,24577,12177,12400
2011-09-01,HSBC,CitiBank Singapore,31758,68169,-36411
2011-10-01,HSBC,CitiBank Singapore,36835,38879,-2044
2011-11-01,HSBC,CitiBank Singapore,32674,44659,-11985
2011-12-01,HSBC,CitiBank Singapore,32464,61239,-28775
2012-01-01,HSBC,CitiBank Singapore,32597,67293,-34696
2012-02-01,HSBC,CitiBank Singapore,33346,67733,-34387
2012-03-01,HSBC,CitiBank Singapore,33535,45135,-11600
2012-04-01,HSBC,CitiBank Singapore,35488,88712,-53224
2012-05-01,HSBC,CitiBank Singapore,32874,18138,14736
2012-06-01,HSBC,CitiBank Singapore,39152,27231,11921
2012-07-01,HSBC,CitiBank Singapore,49351,32535,16816
2012-08-01,HSBC,CitiBank Singapore,49817,23762,26055
2012-09-01,HSBC,CitiBank Singapore,47449,66928,-19479
2012-10-01,HSBC,CitiBank Singapore,41826,76575,-34749
2012-11-01,HSBC,CitiBank Singapore,48212,62494,-14282
2012-12-01,HSBC,CitiBank Singapore,44339,83878,-39539
2013-01-01,HSBC,CitiBank Singapore,49889,78918,-29029
2013-02-01,HSBC,CitiBank Singapore,42263,56933,-14670
2013-03-01,HSBC,CitiBank Singapore,42235,51331,-9096
2013-04-01,HSBC,CitiBank Singapore,41979,86364,-44385
2013-05-01,HSBC,CitiBank Singapore,56745,49862,6883
2013-06-01,HSBC,CitiBank Singapore,52259,62291,-10032
2013-07-01,HSBC,CitiBank Singapore,51124,79367,-28243
2013-08-01,HSBC,CitiBank Singapore,52158,67591,-15433
2013-09-01,HSBC,CitiBank Singapore,53492,47946,5546
2013-10-01,HSBC,CitiBank Singapore,59363,14566,44797
2013-11-01,HSBC,CitiBank Singapore,51862,45381,6481
2013-12-01,HSBC,CitiBank Singapore,51177,13374,37803
2014-01-01,HSBC,CitiBank Singapore,54953,33172,21781
2014-02-01,HSBC,CitiBank Singapore,56649,62942,-6293
2014-03-01,HSBC,CitiBank Singapore,67126,68665,-1539
2014-04-01,HSBC,CitiBank Singapore,61523,95861,-34338
2014-05-01,HSBC,CitiBank Singapore,68617,11571,57046
2014-06-01,HSBC,CitiBank Singapore,64261,59337,4924
2014-07-01,HSBC,CitiBank Singapore,69236,41136,28100
2014-08-01,HSBC,CitiBank Singapore,63473,68997,-5524
2014-09-01,HSBC,CitiBank Singapore,66397,83972,-17575
2014-10-01,HSBC,CitiBank Singapore,64853,34243,30610
2014-11-01,HSBC,CitiBank Singapore,64572,15428,49144
2014-12-01,HSBC,CitiBank Singapore,63676,21695,41981
2015-01-01,HSBC,CitiBank Singapore,72447,19782,52665
2015-02-01,HSBC,CitiBank Singapore,78758,89376,-10618
2015-03-01,HSBC,CitiBank Singapore,75889,75193,696
2015-04-01,HSBC,CitiBank Singapore,74394,89214,-14820
2015-05-01,HSBC,CitiBank Singapore,72956,62759,10197
2015-06-01,HSBC,CitiBank Singapore,71574,61542,10032
2015-07-01,HSBC,CitiBank Singapore,71639,85864,-14225
2015-08-01,HSBC,CitiBank Singapore,79617,24431,55186
2015-09-01,HSBC,CitiBank Singapore,76338,41319,35019
2015-10-01,HSBC,CitiBank Singapore,78496,11995,66501
2015-11-01,HSBC,CitiBank Singapore,83452,11227,72225
2015-12-01,HSBC,CitiBank Singapore,86386,13195,73191
2016-01-01,HSBC,CitiBank Singapore,82211,56219,25992
2016-02-01,HSBC,CitiBank Singapore,88663,29857,58806
2016-03-01,HSBC,CitiBank Singapore,89747,79627,10120
2016-04-01,HSBC,CitiBank Singapore,81786,25811,55975
2016-05-01,HSBC,CitiBank Singapore,86861,94419,-7558
2016-06-01,HSBC,CitiBank Singapore,84465,41112,43353
2016-07-01,HSBC,CitiBank Singapore,85544,26844,58700
2016-08-01,HSBC,CitiBank Singapore,86592,23493,63099
2016-09-01,HSBC,CitiBank Singapore,92922,35353,57569
2016-10-01,HSBC,CitiBank Singapore,93297,89399,3898
2016-11-01,HSBC,CitiBank Singapore,97141,48347,48794
2016-12-01,HSBC,CitiBank Singapore,91972,58725,33247
2017-01-01,HSBC,CitiBank Singapore,97487,88985,8502
2017-02-01,HSBC,CitiBank Singapore,95945,91967,3978
2017-03-01,HSBC,CitiBank Singapore,93255,71916,21339
2017-04-01,HSBC,CitiBank Singapore,93731,66338,27393
2017-05-01,HSBC,CitiBank Singapore,95652,53276,42376
2017-06-01,HSBC,CitiBank Singapore,99251,87156,12095
2017-07-01,HSBC,CitiBank Singapore,103396,16388,87008
2017-08-01,HSBC,CitiBank Singapore,104134,83866,20268
2017-09-01,HSBC,CitiBank Singapore,107669,24633,83036
2017-10-01,HSBC,CitiBank Singapore,107925,59659,48266
2017-11-01,HSBC,CitiBank Singapore,103747,67526,36221
2017-12-01,HSBC,CitiBank Singapore,105866,78463,27403
2018-01-01,HSBC,CitiBank Singapore,108419,92953,15466
2018-02-01,HSBC,CitiBank Singapore,102615,78126,24489
2018-03-01,HSBC,CitiBank Singapore,105454,64455,40999
2018-04-01,HSBC,CitiBank Singapore,106978,18221,88757
2010-01-01,HSBC,CitiBank HongKong,11334,68326,-56992
2010-02-01,HSBC,CitiBank HongKong,13412,62939,-49527
2010-03-01,HSBC,CitiBank HongKong,15137,79552,-64415
2010-04-01,HSBC,CitiBank HongKong,19931,44344,-24413
2010-05-01,HSBC,CitiBank HongKong,15298,79946,-64648
2010-06-01,HSBC,CitiBank HongKong,18982,49394,-30412
2010-07-01,HSBC,CitiBank HongKong,15141,15763,-622
2010-08-01,HSBC,CitiBank HongKong,18527,69491,-50964
2010-09-01,HSBC,CitiBank HongKong,18783,59748,-40965
2010-10-01,HSBC,CitiBank HongKong,12794,13649,-855
2010-11-01,HSBC,CitiBank HongKong,25294,91274,-65980
2010-12-01,HSBC,CitiBank HongKong,29396,35244,-5848
2011-01-01,HSBC,CitiBank HongKong,22548,15373,7175
2011-02-01,HSBC,CitiBank HongKong,23811,92772,-68961
2011-03-01,HSBC,CitiBank HongKong,28345,33445,-5100
2011-04-01,HSBC,CitiBank HongKong,27923,34219,-6296
2011-05-01,HSBC,CitiBank HongKong,24942,14174,10768
2011-06-01,HSBC,CitiBank HongKong,29338,63649,-34311
2011-07-01,HSBC,CitiBank HongKong,28876,39457,-10581
2011-08-01,HSBC,CitiBank HongKong,27554,48431,-20877
2011-09-01,HSBC,CitiBank HongKong,39232,82586,-43354
2011-10-01,HSBC,CitiBank HongKong,36974,51844,-14870
2011-11-01,HSBC,CitiBank HongKong,33428,75151,-41723
2011-12-01,HSBC,CitiBank HongKong,38151,77812,-39661
2012-01-01,HSBC,CitiBank HongKong,35669,75676,-40007
2012-02-01,HSBC,CitiBank HongKong,31165,15228,15937
2012-03-01,HSBC,CitiBank HongKong,37829,88176,-50347
2012-04-01,HSBC,CitiBank HongKong,36911,33887,3024
2012-05-01,HSBC,CitiBank HongKong,34433,41319,-6886
2012-06-01,HSBC,CitiBank HongKong,39997,59447,-19450
2012-07-01,HSBC,CitiBank HongKong,41212,45547,-4335
2012-08-01,HSBC,CitiBank HongKong,48152,59715,-11563
2012-09-01,HSBC,CitiBank HongKong,43861,65288,-21427
2012-10-01,HSBC,CitiBank HongKong,48441,98325,-49884
2012-11-01,HSBC,CitiBank HongKong,44775,44852,-77
2012-12-01,HSBC,CitiBank HongKong,48281,53364,-5083
2013-01-01,HSBC,CitiBank HongKong,46664,55788,-9124
2013-02-01,HSBC,CitiBank HongKong,47979,66978,-18999
2013-03-01,HSBC,CitiBank HongKong,44882,36827,8055
2013-04-01,HSBC,CitiBank HongKong,41513,66931,-25418
2013-05-01,HSBC,CitiBank HongKong,54336,79115,-24779
2013-06-01,HSBC,CitiBank HongKong,56983,54834,2149
2013-07-01,HSBC,CitiBank HongKong,55494,23386,32108
2013-08-01,HSBC,CitiBank HongKong,53462,98122,-44660
2013-09-01,HSBC,CitiBank HongKong,55636,99127,-43491
2013-10-01,HSBC,CitiBank HongKong,52193,48748,3445
2013-11-01,HSBC,CitiBank HongKong,58718,97442,-38724
2013-12-01,HSBC,CitiBank HongKong,59754,53332,6422
2014-01-01,HSBC,CitiBank HongKong,55493,14814,40679
2014-02-01,HSBC,CitiBank HongKong,57653,36172,21481
2014-03-01,HSBC,CitiBank HongKong,65697,32262,33435
2014-04-01,HSBC,CitiBank HongKong,65663,16345,49318
2014-05-01,HSBC,CitiBank HongKong,67421,96843,-29422
2014-06-01,HSBC,CitiBank HongKong,66139,65966,173
2014-07-01,HSBC,CitiBank HongKong,63165,14892,48273
2014-08-01,HSBC,CitiBank HongKong,66732,73291,-6559
2014-09-01,HSBC,CitiBank HongKong,62414,33939,28475
2014-10-01,HSBC,CitiBank HongKong,66214,42926,23288
2014-11-01,HSBC,CitiBank HongKong,65544,55343,10201
2014-12-01,HSBC,CitiBank HongKong,68113,16278,51835
2015-01-01,HSBC,CitiBank HongKong,78828,74335,4493
2015-02-01,HSBC,CitiBank HongKong,75627,35364,40263
2015-03-01,HSBC,CitiBank HongKong,73955,28964,44991
2015-04-01,HSBC,CitiBank HongKong,73745,51927,21818
2015-05-01,HSBC,CitiBank HongKong,71517,22478,49039
2015-06-01,HSBC,CitiBank HongKong,72875,67165,5710
2015-07-01,HSBC,CitiBank HongKong,78653,19976,58677
2015-08-01,HSBC,CitiBank HongKong,71156,58589,12567
2015-09-01,HSBC,CitiBank HongKong,73265,69712,3553
2015-10-01,HSBC,CitiBank HongKong,75696,36561,39135
2015-11-01,HSBC,CitiBank HongKong,84358,23884,60474
2015-12-01,HSBC,CitiBank HongKong,81216,35418,45798
2016-01-01,HSBC,CitiBank HongKong,85214,55642,29572
2016-02-01,HSBC,CitiBank HongKong,84455,39393,45062
2016-03-01,HSBC,CitiBank HongKong,85726,62549,23177
2016-04-01,HSBC,CitiBank HongKong,86433,32742,53691
2016-05-01,HSBC,CitiBank HongKong,88532,97365,-8833
2016-06-01,HSBC,CitiBank HongKong,83747,77153,6594
2016-07-01,HSBC,CitiBank HongKong,81995,24379,57616
2016-08-01,HSBC,CitiBank HongKong,82535,48225,34310
2016-09-01,HSBC,CitiBank HongKong,92111,81863,10248
2016-10-01,HSBC,CitiBank HongKong,96182,88875,7307
2016-11-01,HSBC,CitiBank HongKong,99885,85529,14356
2016-12-01,HSBC,CitiBank HongKong,94494,51358,43136
2017-01-01,HSBC,CitiBank HongKong,99762,93765,5997
2017-02-01,HSBC,CitiBank HongKong,92968,89818,3150
2017-03-01,HSBC,CitiBank HongKong,98537,86522,12015
2017-04-01,HSBC,CitiBank HongKong,94461,76958,17503
2017-05-01,HSBC,CitiBank HongKong,92544,79225,13319
2017-06-01,HSBC,CitiBank HongKong,98828,95883,2945
2017-07-01,HSBC,CitiBank HongKong,108858,44468,64390
2017-08-01,HSBC,CitiBank HongKong,103627,79332,24295
2017-09-01,HSBC,CitiBank HongKong,101127,34743,66384
2017-10-01,HSBC,CitiBank HongKong,107867,25318,82549
2017-11-01,HSBC,CitiBank HongKong,101376,41393,59983
2017-12-01,HSBC,CitiBank HongKong,101385,72922,28463
2018-01-01,HSBC,CitiBank HongKong,108839,82911,25928
2018-02-01,HSBC,CitiBank HongKong,107471,12265,95206
2018-03-01,HSBC,CitiBank HongKong,105684,52643,53041
2018-04-01,HSBC,CitiBank HongKong,109148,23163,85985
2010-01-01,BNY Mellon,CitiBank New York,19728,28918,-9190
2010-02-01,BNY Mellon,CitiBank New York,18753,45684,-26931
2010-03-01,BNY Mellon,CitiBank New York,16575,72915,-56340
2010-04-01,BNY Mellon,CitiBank New York,17313,77486,-60173
2010-05-01,BNY Mellon,CitiBank New York,12854,81167,-68313
2010-06-01,BNY Mellon,CitiBank New York,12797,17538,-4741
2010-07-01,BNY Mellon,CitiBank New York,11168,13872,-2704
2010-08-01,BNY Mellon,CitiBank New York,15499,41986,-26487
2010-09-01,BNY Mellon,CitiBank New York,16277,91736,-75459
2010-10-01,BNY Mellon,CitiBank New York,17835,25775,-7940
2010-11-01,BNY Mellon,CitiBank New York,29372,41256,-11884
2010-12-01,BNY Mellon,CitiBank New York,27928,11492,16436
2011-01-01,BNY Mellon,CitiBank New York,25661,87651,-61990
2011-02-01,BNY Mellon,CitiBank New York,27528,93819,-66291
2011-03-01,BNY Mellon,CitiBank New York,27476,25952,1524
2011-04-01,BNY Mellon,CitiBank New York,24236,73819,-49583
2011-05-01,BNY Mellon,CitiBank New York,28477,14839,13638
2011-06-01,BNY Mellon,CitiBank New York,21928,39455,-17527
2011-07-01,BNY Mellon,CitiBank New York,28545,82572,-54027
2011-08-01,BNY Mellon,CitiBank New York,22739,55375,-32636
2011-09-01,BNY Mellon,CitiBank New York,31577,78972,-47395
2011-10-01,BNY Mellon,CitiBank New York,33165,93236,-60071
2011-11-01,BNY Mellon,CitiBank New York,39829,13441,26388
2011-12-01,BNY Mellon,CitiBank New York,32896,15336,17560
2012-01-01,BNY Mellon,CitiBank New York,33486,74839,-41353
2012-02-01,BNY Mellon,CitiBank New York,38359,15991,22368
2012-03-01,BNY Mellon,CitiBank New York,36776,26785,9991
2012-04-01,BNY Mellon,CitiBank New York,38421,58976,-20555
2012-05-01,BNY Mellon,CitiBank New York,38437,44212,-5775
2012-06-01,BNY Mellon,CitiBank New York,33744,15137,18607
2012-07-01,BNY Mellon,CitiBank New York,43192,23567,19625
2012-08-01,BNY Mellon,CitiBank New York,45151,96237,-51086
2012-09-01,BNY Mellon,CitiBank New York,47265,59342,-12077
2012-10-01,BNY Mellon,CitiBank New York,49938,65213,-15275
2012-11-01,BNY Mellon,CitiBank New York,45462,52576,-7114
2012-12-01,BNY Mellon,CitiBank New York,42358,31981,10377
2013-01-01,BNY Mellon,CitiBank New York,42264,74998,-32734
2013-02-01,BNY Mellon,CitiBank New York,43455,66245,-22790
2013-03-01,BNY Mellon,CitiBank New York,44417,69749,-25332
2013-04-01,BNY Mellon,CitiBank New York,42652,51497,-8845
2013-05-01,BNY Mellon,CitiBank New York,53351,47644,5707
2013-06-01,BNY Mellon,CitiBank New York,55296,19436,35860
2013-07-01,BNY Mellon,CitiBank New York,57838,36866,20972
2013-08-01,BNY Mellon,CitiBank New York,58917,81671,-22754
2013-09-01,BNY Mellon,CitiBank New York,59472,37121,22351
2013-10-01,BNY Mellon,CitiBank New York,55459,84518,-29059
2013-11-01,BNY Mellon,CitiBank New York,52388,18582,33806
2013-12-01,BNY Mellon,CitiBank New York,58645,77927,-19282
2014-01-01,BNY Mellon,CitiBank New York,57379,84439,-27060
2014-02-01,BNY Mellon,CitiBank New York,51513,54941,-3428
2014-03-01,BNY Mellon,CitiBank New York,68713,29776,38937
2014-04-01,BNY Mellon,CitiBank New York,66948,35157,31791
2014-05-01,BNY Mellon,CitiBank New York,65565,71593,-6028
2014-06-01,BNY Mellon,CitiBank New York,61842,66824,-4982
2014-07-01,BNY Mellon,CitiBank New York,64154,89213,-25059
2014-08-01,BNY Mellon,CitiBank New York,69261,95421,-26160
2014-09-01,BNY Mellon,CitiBank New York,65321,71861,-6540
2014-10-01,BNY Mellon,CitiBank New York,65947,36519,29428
2014-11-01,BNY Mellon,CitiBank New York,65565,58896,6669
2014-12-01,BNY Mellon,CitiBank New York,64277,28595,35682
2015-01-01,BNY Mellon,CitiBank New York,76879,14252,62627
2015-02-01,BNY Mellon,CitiBank New York,76936,54265,22671
2015-03-01,BNY Mellon,CitiBank New York,76334,13361,62973
2015-04-01,BNY Mellon,CitiBank New York,78323,38832,39491
2015-05-01,BNY Mellon,CitiBank New York,76665,94914,-18249
2015-06-01,BNY Mellon,CitiBank New York,73696,38872,34824
2015-07-01,BNY Mellon,CitiBank New York,79416,77758,1658
2015-08-01,BNY Mellon,CitiBank New York,71493,69995,1498
2015-09-01,BNY Mellon,CitiBank New York,79883,55822,24061
2015-10-01,BNY Mellon,CitiBank New York,79252,58382,20870
2015-11-01,BNY Mellon,CitiBank New York,83792,79378,4414
2015-12-01,BNY Mellon,CitiBank New York,85322,94643,-9321
2016-01-01,BNY Mellon,CitiBank New York,84696,78447,6249
2016-02-01,BNY Mellon,CitiBank New York,83535,71687,11848
2016-03-01,BNY Mellon,CitiBank New York,85937,74613,11324
2016-04-01,BNY Mellon,CitiBank New York,85143,15671,69472
2016-05-01,BNY Mellon,CitiBank New York,89352,77372,11980
2016-06-01,BNY Mellon,CitiBank New York,82434,81796,638
2016-07-01,BNY Mellon,CitiBank New York,88421,54816,33605
2016-08-01,BNY Mellon,CitiBank New York,85879,26739,59140
2016-09-01,BNY Mellon,CitiBank New York,93774,17635,76139
2016-10-01,BNY Mellon,CitiBank New York,96473,75457,21016
2016-11-01,BNY Mellon,CitiBank New York,94115,26787,67328
2016-12-01,BNY Mellon,CitiBank New York,99279,23897,75382
2017-01-01,BNY Mellon,CitiBank New York,98936,42385,56551
2017-02-01,BNY Mellon,CitiBank New York,93235,66688,26547
2017-03-01,BNY Mellon,CitiBank New York,99668,39614,60054
2017-04-01,BNY Mellon,CitiBank New York,94313,49558,44755
2017-05-01,BNY Mellon,CitiBank New York,98889,98276,613
2017-06-01,BNY Mellon,CitiBank New York,94948,77249,17699
2017-07-01,BNY Mellon,CitiBank New York,102613,18411,84202
2017-08-01,BNY Mellon,CitiBank New York,104218,53939,50279
2017-09-01,BNY Mellon,CitiBank New York,107428,58478,48950
2017-10-01,BNY Mellon,CitiBank New York,109317,77678,31639
2017-11-01,BNY Mellon,CitiBank New York,105341,43144,62197
2017-12-01,BNY Mellon,CitiBank New York,106329,69843,36486
2018-01-01,BNY Mellon,CitiBank New York,109627,17536,92091
2018-02-01,BNY Mellon,CitiBank New York,103423,32561,70862
2018-03-01,BNY Mellon,CitiBank New York,107915,79699,28216
2018-04-01,BNY Mellon,CitiBank New York,101694,89494,12200
2010-01-01,BNY Mellon,CitiBank London,12377,93991,-81614
2010-02-01,BNY Mellon,CitiBank London,19715,86698,-66983
2010-03-01,BNY Mellon,CitiBank London,17734,57351,-39617
2010-04-01,BNY Mellon,CitiBank London,15169,53668,-38499
2010-05-01,BNY Mellon,CitiBank London,14835,56565,-41730
2010-06-01,BNY Mellon,CitiBank London,19475,94468,-74993
2010-07-01,BNY Mellon,CitiBank London,11169,71158,-59989
2010-08-01,BNY Mellon,CitiBank London,13561,48373,-34812
2010-09-01,BNY Mellon,CitiBank London,14644,26288,-11644
2010-10-01,BNY Mellon,CitiBank London,16329,41129,-24800
2010-11-01,BNY Mellon,CitiBank London,22344,75682,-53338
2010-12-01,BNY Mellon,CitiBank London,27742,53856,-26114
2011-01-01,BNY Mellon,CitiBank London,23867,78253,-54386
2011-02-01,BNY Mellon,CitiBank London,29155,47331,-18176
2011-03-01,BNY Mellon,CitiBank London,27563,29266,-1703
2011-04-01,BNY Mellon,CitiBank London,22645,68924,-46279
2011-05-01,BNY Mellon,CitiBank London,21255,12546,8709
2011-06-01,BNY Mellon,CitiBank London,22851,49991,-27140
2011-07-01,BNY Mellon,CitiBank London,26453,24522,1931
2011-08-01,BNY Mellon,CitiBank London,28492,22213,6279
2011-09-01,BNY Mellon,CitiBank London,37137,66486,-29349
2011-10-01,BNY Mellon,CitiBank London,33461,95175,-61714
2011-11-01,BNY Mellon,CitiBank London,35363,47417,-12054
2011-12-01,BNY Mellon,CitiBank London,35114,61578,-26464
2012-01-01,BNY Mellon,CitiBank London,33189,65511,-32322
2012-02-01,BNY Mellon,CitiBank London,37225,18223,19002
2012-03-01,BNY Mellon,CitiBank London,35834,43845,-8011
2012-04-01,BNY Mellon,CitiBank London,31738,27739,3999
2012-05-01,BNY Mellon,CitiBank London,37186,46993,-9807
2012-06-01,BNY Mellon,CitiBank London,31384,75982,-44598
2012-07-01,BNY Mellon,CitiBank London,46441,39269,7172
2012-08-01,BNY Mellon,CitiBank London,48275,88748,-40473
2012-09-01,BNY Mellon,CitiBank London,48459,61798,-13339
2012-10-01,BNY Mellon,CitiBank London,44874,83741,-38867
2012-11-01,BNY Mellon,CitiBank London,45911,56721,-10810
2012-12-01,BNY Mellon,CitiBank London,43615,95445,-51830
2013-01-01,BNY Mellon,CitiBank London,46245,16819,29426
2013-02-01,BNY Mellon,CitiBank London,44524,22261,22263
2013-03-01,BNY Mellon,CitiBank London,45396,58933,-13537
2013-04-01,BNY Mellon,CitiBank London,48474,72779,-24305
2013-05-01,BNY Mellon,CitiBank London,54174,92229,-38055
2013-06-01,BNY Mellon,CitiBank London,51885,27721,24164
2013-07-01,BNY Mellon,CitiBank London,55314,49177,6137
2013-08-01,BNY Mellon,CitiBank London,55488,97681,-42193
2013-09-01,BNY Mellon,CitiBank London,58586,94627,-36041
2013-10-01,BNY Mellon,CitiBank London,53234,52244,990
2013-11-01,BNY Mellon,CitiBank London,55574,59842,-4268
2013-12-01,BNY Mellon,CitiBank London,58352,26571,31781
2014-01-01,BNY Mellon,CitiBank London,54823,81997,-27174
2014-02-01,BNY Mellon,CitiBank London,53151,48967,4184
2014-03-01,BNY Mellon,CitiBank London,61377,68575,-7198
2014-04-01,BNY Mellon,CitiBank London,65719,79586,-13867
2014-05-01,BNY Mellon,CitiBank London,64481,58374,6107
2014-06-01,BNY Mellon,CitiBank London,66881,57746,9135
2014-07-01,BNY Mellon,CitiBank London,67846,68925,-1079
2014-08-01,BNY Mellon,CitiBank London,63498,31993,31505
2014-09-01,BNY Mellon,CitiBank London,68654,28793,39861
2014-10-01,BNY Mellon,CitiBank London,68886,43149,25737
2014-11-01,BNY Mellon,CitiBank London,66328,82969,-16641
2014-12-01,BNY Mellon,CitiBank London,66867,94422,-27555
2015-01-01,BNY Mellon,CitiBank London,78868,41496,37372
2015-02-01,BNY Mellon,CitiBank London,79797,98774,-18977
2015-03-01,BNY Mellon,CitiBank London,72523,48874,23649
2015-04-01,BNY Mellon,CitiBank London,73797,69737,4060
2015-05-01,BNY Mellon,CitiBank London,79959,98414,-18455
2015-06-01,BNY Mellon,CitiBank London,73986,74533,-547
2015-07-01,BNY Mellon,CitiBank London,79545,24575,54970
2015-08-01,BNY Mellon,CitiBank London,73149,88774,-15625
2015-09-01,BNY Mellon,CitiBank London,74395,66215,8180
2015-10-01,BNY Mellon,CitiBank London,73528,53982,19546
2015-11-01,BNY Mellon,CitiBank London,83671,52783,30888
2015-12-01,BNY Mellon,CitiBank London,86948,71533,15415
2016-01-01,BNY Mellon,CitiBank London,87658,62495,25163
2016-02-01,BNY Mellon,CitiBank London,84465,34217,50248
2016-03-01,BNY Mellon,CitiBank London,88635,91114,-2479
2016-04-01,BNY Mellon,CitiBank London,84342,99783,-15441
2016-05-01,BNY Mellon,CitiBank London,88772,52655,36117
2016-06-01,BNY Mellon,CitiBank London,82654,72996,9658
2016-07-01,BNY Mellon,CitiBank London,85695,86293,-598
2016-08-01,BNY Mellon,CitiBank London,84814,88987,-4173
2016-09-01,BNY Mellon,CitiBank London,99326,44484,54842
2016-10-01,BNY Mellon,CitiBank London,99347,83619,15728
2016-11-01,BNY Mellon,CitiBank London,92583,32311,60272
2016-12-01,BNY Mellon,CitiBank London,99611,32396,67215
2017-01-01,BNY Mellon,CitiBank London,93564,52784,40780
2017-02-01,BNY Mellon,CitiBank London,92951,82918,10033
2017-03-01,BNY Mellon,CitiBank London,96433,58275,38158
2017-04-01,BNY Mellon,CitiBank London,96314,69736,26578
2017-05-01,BNY Mellon,CitiBank London,98433,84644,13789
2017-06-01,BNY Mellon,CitiBank London,91529,93364,-1835
2017-07-01,BNY Mellon,CitiBank London,102212,17784,84428
2017-08-01,BNY Mellon,CitiBank London,102782,85543,17239
2017-09-01,BNY Mellon,CitiBank London,103449,11978,91471
2017-10-01,BNY Mellon,CitiBank London,104411,73776,30635
2017-11-01,BNY Mellon,CitiBank London,101785,69482,32303
2017-12-01,BNY Mellon,CitiBank London,106765,26358,80407
2018-01-01,BNY Mellon,CitiBank London,101256,21927,79329
2018-02-01,BNY Mellon,CitiBank London,101154,93475,7679
2018-03-01,BNY Mellon,CitiBank London,104475,24419,80056
2018-04-01,BNY Mellon,CitiBank London,105426,74392,31034
2010-01-01,BNY Mellon,CitiBank Pune,17169,87666,-70497
2010-02-01,BNY Mellon,CitiBank Pune,18923,27792,-8869
2010-03-01,BNY Mellon,CitiBank Pune,17899,91969,-74070
2010-04-01,BNY Mellon,CitiBank Pune,19137,63935,-44798
2010-05-01,BNY Mellon,CitiBank Pune,12422,34854,-22432
2010-06-01,BNY Mellon,CitiBank Pune,15922,19224,-3302
2010-07-01,BNY Mellon,CitiBank Pune,13547,19848,-6301
2010-08-01,BNY Mellon,CitiBank Pune,16598,42162,-25564
2010-09-01,BNY Mellon,CitiBank Pune,16412,11922,4490
2010-10-01,BNY Mellon,CitiBank Pune,12562,94336,-81774
2010-11-01,BNY Mellon,CitiBank Pune,29129,96838,-67709
2010-12-01,BNY Mellon,CitiBank Pune,28919,16262,12657
2011-01-01,BNY Mellon,CitiBank Pune,21153,56994,-35841
2011-02-01,BNY Mellon,CitiBank Pune,29516,43741,-14225
2011-03-01,BNY Mellon,CitiBank Pune,26116,98881,-72765
2011-04-01,BNY Mellon,CitiBank Pune,27988,24387,3601
2011-05-01,BNY Mellon,CitiBank Pune,24436,53491,-29055
2011-06-01,BNY Mellon,CitiBank Pune,23232,51947,-28715
2011-07-01,BNY Mellon,CitiBank Pune,29363,52832,-23469
2011-08-01,BNY Mellon,CitiBank Pune,25992,38324,-12332
2011-09-01,BNY Mellon,CitiBank Pune,33222,96997,-63775
2011-10-01,BNY Mellon,CitiBank Pune,31857,86226,-54369
2011-11-01,BNY Mellon,CitiBank Pune,35464,19589,15875
2011-12-01,BNY Mellon,CitiBank Pune,33394,69467,-36073
2012-01-01,BNY Mellon,CitiBank Pune,34329,76781,-42452
2012-02-01,BNY Mellon,CitiBank Pune,34592,27273,7319
2012-03-01,BNY Mellon,CitiBank Pune,39728,39526,202
2012-04-01,BNY Mellon,CitiBank Pune,31169,65611,-34442
2012-05-01,BNY Mellon,CitiBank Pune,35792,23968,11824
2012-06-01,BNY Mellon,CitiBank Pune,31474,88882,-57408
2012-07-01,BNY Mellon,CitiBank Pune,42688,61946,-19258
2012-08-01,BNY Mellon,CitiBank Pune,41976,24745,17231
2012-09-01,BNY Mellon,CitiBank Pune,42826,52854,-10028
2012-10-01,BNY Mellon,CitiBank Pune,44316,91738,-47422
2012-11-01,BNY Mellon,CitiBank Pune,43949,92148,-48199
2012-12-01,BNY Mellon,CitiBank Pune,47655,18894,28761
2013-01-01,BNY Mellon,CitiBank Pune,46628,81381,-34753
2013-02-01,BNY Mellon,CitiBank Pune,41386,66172,-24786
2013-03-01,BNY Mellon,CitiBank Pune,45135,52373,-7238
2013-04-01,BNY Mellon,CitiBank Pune,44983,75444,-30461
2013-05-01,BNY Mellon,CitiBank Pune,59762,83918,-24156
2013-06-01,BNY Mellon,CitiBank Pune,53763,64187,-10424
2013-07-01,BNY Mellon,CitiBank Pune,51858,74144,-22286
2013-08-01,BNY Mellon,CitiBank Pune,52916,58782,-5866
2013-09-01,BNY Mellon,CitiBank Pune,57464,82282,-24818
2013-10-01,BNY Mellon,CitiBank Pune,56486,56275,211
2013-11-01,BNY Mellon,CitiBank Pune,56628,98634,-42006
2013-12-01,BNY Mellon,CitiBank Pune,54483,39295,15188
2014-01-01,BNY Mellon,CitiBank Pune,52522,47788,4734
2014-02-01,BNY Mellon,CitiBank Pune,57276,35763,21513
2014-03-01,BNY Mellon,CitiBank Pune,61147,67772,-6625
2014-04-01,BNY Mellon,CitiBank Pune,62816,26931,35885
2014-05-01,BNY Mellon,CitiBank Pune,65786,91424,-25638
2014-06-01,BNY Mellon,CitiBank Pune,65713,13977,51736
2014-07-01,BNY Mellon,CitiBank Pune,65486,34832,30654
2014-08-01,BNY Mellon,CitiBank Pune,65285,21795,43490
2014-09-01,BNY Mellon,CitiBank Pune,67454,51738,15716
2014-10-01,BNY Mellon,CitiBank Pune,65426,99152,-33726
2014-11-01,BNY Mellon,CitiBank Pune,68257,99972,-31715
2014-12-01,BNY Mellon,CitiBank Pune,69972,35556,34416
2015-01-01,BNY Mellon,CitiBank Pune,74854,14381,60473
2015-02-01,BNY Mellon,CitiBank Pune,73612,68912,4700
2015-03-01,BNY Mellon,CitiBank Pune,71796,21666,50130
2015-04-01,BNY Mellon,CitiBank Pune,78926,11312,67614
2015-05-01,BNY Mellon,CitiBank Pune,76836,62839,13997
2015-06-01,BNY Mellon,CitiBank Pune,79224,26316,52908
2015-07-01,BNY Mellon,CitiBank Pune,71234,82856,-11622
2015-08-01,BNY Mellon,CitiBank Pune,78835,78572,263
2015-09-01,BNY Mellon,CitiBank Pune,71236,27852,43384
2015-10-01,BNY Mellon,CitiBank Pune,73423,99392,-25969
2015-11-01,BNY Mellon,CitiBank Pune,88115,94829,-6714
2015-12-01,BNY Mellon,CitiBank Pune,86559,23827,62732
2016-01-01,BNY Mellon,CitiBank Pune,83581,11215,72366
2016-02-01,BNY Mellon,CitiBank Pune,86774,77657,9117
2016-03-01,BNY Mellon,CitiBank Pune,85159,41654,43505
2016-04-01,BNY Mellon,CitiBank Pune,81449,41746,39703
2016-05-01,BNY Mellon,CitiBank Pune,85987,17154,68833
2016-06-01,BNY Mellon,CitiBank Pune,88992,14725,74267
2016-07-01,BNY Mellon,CitiBank Pune,84419,83927,492
2016-08-01,BNY Mellon,CitiBank Pune,85338,69945,15393
2016-09-01,BNY Mellon,CitiBank Pune,92452,87551,4901
2016-10-01,BNY Mellon,CitiBank Pune,96675,57458,39217
2016-11-01,BNY Mellon,CitiBank Pune,95497,25442,70055
2016-12-01,BNY Mellon,CitiBank Pune,91369,75961,15408
2017-01-01,BNY Mellon,CitiBank Pune,94115,63372,30743
2017-02-01,BNY Mellon,CitiBank Pune,92819,86874,5945
2017-03-01,BNY Mellon,CitiBank Pune,94831,66949,27882
2017-04-01,BNY Mellon,CitiBank Pune,95534,93754,1780
2017-05-01,BNY Mellon,CitiBank Pune,95991,72655,23336
2017-06-01,BNY Mellon,CitiBank Pune,93488,92677,811
2017-07-01,BNY Mellon,CitiBank Pune,104122,49747,54375
2017-08-01,BNY Mellon,CitiBank Pune,106855,76554,30301
2017-09-01,BNY Mellon,CitiBank Pune,101118,35727,65391
2017-10-01,BNY Mellon,CitiBank Pune,107497,81741,25756
2017-11-01,BNY Mellon,CitiBank Pune,108991,11293,97698
2017-12-01,BNY Mellon,CitiBank Pune,109659,12666,96993
2018-01-01,BNY Mellon,CitiBank Pune,103455,23299,80156
2018-02-01,BNY Mellon,CitiBank Pune,105475,59167,46308
2018-03-01,BNY Mellon,CitiBank Pune,106288,31918,74370
2018-04-01,BNY Mellon,CitiBank Pune,106782,34742,72040
2010-01-01,BNY Mellon,CitiBank Singapore,12236,58224,-45988
2010-02-01,BNY Mellon,CitiBank Singapore,12981,81218,-68237
2010-03-01,BNY Mellon,CitiBank Singapore,16462,82653,-66191
2010-04-01,BNY Mellon,CitiBank Singapore,16817,63275,-46458
2010-05-01,BNY Mellon,CitiBank Singapore,15686,87515,-71829
2010-06-01,BNY Mellon,CitiBank Singapore,12993,94146,-81153
2010-07-01,BNY Mellon,CitiBank Singapore,17948,22357,-4409
2010-08-01,BNY Mellon,CitiBank Singapore,17516,88268,-70752
2010-09-01,BNY Mellon,CitiBank Singapore,11755,53759,-42004
2010-10-01,BNY Mellon,CitiBank Singapore,19317,48816,-29499
2010-11-01,BNY Mellon,CitiBank Singapore,27259,81562,-54303
2010-12-01,BNY Mellon,CitiBank Singapore,28392,24833,3559
2011-01-01,BNY Mellon,CitiBank Singapore,29877,67361,-37484
2011-02-01,BNY Mellon,CitiBank Singapore,29979,56972,-26993
2011-03-01,BNY Mellon,CitiBank Singapore,25781,88251,-62470
2011-04-01,BNY Mellon,CitiBank Singapore,28186,33832,-5646
2011-05-01,BNY Mellon,CitiBank Singapore,26218,69925,-43707
2011-06-01,BNY Mellon,CitiBank Singapore,21187,76323,-55136
2011-07-01,BNY Mellon,CitiBank Singapore,23277,68843,-45566
2011-08-01,BNY Mellon,CitiBank Singapore,26137,91483,-65346
2011-09-01,BNY Mellon,CitiBank Singapore,38433,93879,-55446
2011-10-01,BNY Mellon,CitiBank Singapore,37173,65371,-28198
2011-11-01,BNY Mellon,CitiBank Singapore,39394,24694,14700
2011-12-01,BNY Mellon,CitiBank Singapore,34881,83823,-48942
2012-01-01,BNY Mellon,CitiBank Singapore,36231,81348,-45117
2012-02-01,BNY Mellon,CitiBank Singapore,36368,49589,-13221
2012-03-01,BNY Mellon,CitiBank Singapore,36398,98488,-62090
2012-04-01,BNY Mellon,CitiBank Singapore,39921,17693,22228
2012-05-01,BNY Mellon,CitiBank Singapore,35626,85629,-50003
2012-06-01,BNY Mellon,CitiBank Singapore,36723,59391,-22668
2012-07-01,BNY Mellon,CitiBank Singapore,42274,58297,-16023
2012-08-01,BNY Mellon,CitiBank Singapore,44572,88362,-43790
2012-09-01,BNY Mellon,CitiBank Singapore,42196,42949,-753
2012-10-01,BNY Mellon,CitiBank Singapore,47315,81633,-34318
2012-11-01,BNY Mellon,CitiBank Singapore,45165,46748,-1583
2012-12-01,BNY Mellon,CitiBank Singapore,42943,79936,-36993
2013-01-01,BNY Mellon,CitiBank Singapore,47912,46615,1297
2013-02-01,BNY Mellon,CitiBank Singapore,49676,88448,-38772
2013-03-01,BNY Mellon,CitiBank Singapore,43897,77713,-33816
2013-04-01,BNY Mellon,CitiBank Singapore,45681,23731,21950
2013-05-01,BNY Mellon,CitiBank Singapore,56983,33657,23326
2013-06-01,BNY Mellon,CitiBank Singapore,51364,66313,-14949
2013-07-01,BNY Mellon,CitiBank Singapore,56815,19857,36958
2013-08-01,BNY Mellon,CitiBank Singapore,56589,97657,-41068
2013-09-01,BNY Mellon,CitiBank Singapore,51864,79634,-27770
2013-10-01,BNY Mellon,CitiBank Singapore,54292,13255,41037
2013-11-01,BNY Mellon,CitiBank Singapore,52413,71348,-18935
2013-12-01,BNY Mellon,CitiBank Singapore,56764,16329,40435
2014-01-01,BNY Mellon,CitiBank Singapore,54386,39148,15238
2014-02-01,BNY Mellon,CitiBank Singapore,51618,35666,15952
2014-03-01,BNY Mellon,CitiBank Singapore,61978,26672,35306
2014-04-01,BNY Mellon,CitiBank Singapore,68724,91955,-23231
2014-05-01,BNY Mellon,CitiBank Singapore,65916,58148,7768
2014-06-01,BNY Mellon,CitiBank Singapore,64145,66577,-2432
2014-07-01,BNY Mellon,CitiBank Singapore,62435,41498,20937
2014-08-01,BNY Mellon,CitiBank Singapore,68384,91854,-23470
2014-09-01,BNY Mellon,CitiBank Singapore,64948,62185,2763
2014-10-01,BNY Mellon,CitiBank Singapore,68282,27581,40701
2014-11-01,BNY Mellon,CitiBank Singapore,61527,21811,39716
2014-12-01,BNY Mellon,CitiBank Singapore,64759,68635,-3876
2015-01-01,BNY Mellon,CitiBank Singapore,76522,21931,54591
2015-02-01,BNY Mellon,CitiBank Singapore,73482,37939,35543
2015-03-01,BNY Mellon,CitiBank Singapore,73356,36696,36660
2015-04-01,BNY Mellon,CitiBank Singapore,72116,93175,-21059
2015-05-01,BNY Mellon,CitiBank Singapore,77362,92681,-15319
2015-06-01,BNY Mellon,CitiBank Singapore,74944,95477,-20533
2015-07-01,BNY Mellon,CitiBank Singapore,71491,88854,-17363
2015-08-01,BNY Mellon,CitiBank Singapore,72178,68599,3579
2015-09-01,BNY Mellon,CitiBank Singapore,76679,87247,-10568
2015-10-01,BNY Mellon,CitiBank Singapore,78542,48838,29704
2015-11-01,BNY Mellon,CitiBank Singapore,83226,91515,-8289
2015-12-01,BNY Mellon,CitiBank Singapore,88982,21563,67419
2016-01-01,BNY Mellon,CitiBank Singapore,84898,46784,38114
2016-02-01,BNY Mellon,CitiBank Singapore,85244,76637,8607
2016-03-01,BNY Mellon,CitiBank Singapore,84878,11994,72884
2016-04-01,BNY Mellon,CitiBank Singapore,89737,66325,23412
2016-05-01,BNY Mellon,CitiBank Singapore,83533,79255,4278
2016-06-01,BNY Mellon,CitiBank Singapore,84166,75262,8904
2016-07-01,BNY Mellon,CitiBank Singapore,84715,87864,-3149
2016-08-01,BNY Mellon,CitiBank Singapore,86519,72416,14103
2016-09-01,BNY Mellon,CitiBank Singapore,91695,25555,66140
2016-10-01,BNY Mellon,CitiBank Singapore,97648,53151,44497
2016-11-01,BNY Mellon,CitiBank Singapore,95474,23841,71633
2016-12-01,BNY Mellon,CitiBank Singapore,98417,91917,6500
2017-01-01,BNY Mellon,CitiBank Singapore,97769,89541,8228
2017-02-01,BNY Mellon,CitiBank Singapore,95497,75337,20160
2017-03-01,BNY Mellon,CitiBank Singapore,99375,31485,67890
2017-04-01,BNY Mellon,CitiBank Singapore,91471,75718,15753
2017-05-01,BNY Mellon,CitiBank Singapore,91614,52156,39458
2017-06-01,BNY Mellon,CitiBank Singapore,99437,12625,86812
2017-07-01,BNY Mellon,CitiBank Singapore,106874,81365,25509
2017-08-01,BNY Mellon,CitiBank Singapore,107678,79343,28335
2017-09-01,BNY Mellon,CitiBank Singapore,106933,56723,50210
2017-10-01,BNY Mellon,CitiBank Singapore,106361,35231,71130
2017-11-01,BNY Mellon,CitiBank Singapore,103121,76137,26984
2017-12-01,BNY Mellon,CitiBank Singapore,108658,89587,19071
2018-01-01,BNY Mellon,CitiBank Singapore,107332,95325,12007
2018-02-01,BNY Mellon,CitiBank Singapore,103376,13545,89831
2018-03-01,BNY Mellon,CitiBank Singapore,106479,81187,25292
2018-04-01,BNY Mellon,CitiBank Singapore,103299,96487,6812
2010-01-01,BNY Mellon,CitiBank HongKong,17342,94696,-77354
2010-02-01,BNY Mellon,CitiBank HongKong,16244,96594,-80350
2010-03-01,BNY Mellon,CitiBank HongKong,13453,93518,-80065
2010-04-01,BNY Mellon,CitiBank HongKong,16199,66986,-50787
2010-05-01,BNY Mellon,CitiBank HongKong,12559,23621,-11062
2010-06-01,BNY Mellon,CitiBank HongKong,17235,98637,-81402
2010-07-01,BNY Mellon,CitiBank HongKong,14976,55548,-40572
2010-08-01,BNY Mellon,CitiBank HongKong,13819,85842,-72023
2010-09-01,BNY Mellon,CitiBank HongKong,18623,94232,-75609
2010-10-01,BNY Mellon,CitiBank HongKong,18347,57438,-39091
2010-11-01,BNY Mellon,CitiBank HongKong,21827,27341,-5514
2010-12-01,BNY Mellon,CitiBank HongKong,29326,87156,-57830
2011-01-01,BNY Mellon,CitiBank HongKong,26587,44516,-17929
2011-02-01,BNY Mellon,CitiBank HongKong,29942,76733,-46791
2011-03-01,BNY Mellon,CitiBank HongKong,28232,75521,-47289
2011-04-01,BNY Mellon,CitiBank HongKong,23493,76458,-52965
2011-05-01,BNY Mellon,CitiBank HongKong,27479,44694,-17215
2011-06-01,BNY Mellon,CitiBank HongKong,22565,84811,-62246
2011-07-01,BNY Mellon,CitiBank HongKong,28341,65478,-37137
2011-08-01,BNY Mellon,CitiBank HongKong,29764,88768,-59004
2011-09-01,BNY Mellon,CitiBank HongKong,31557,24656,6901
2011-10-01,BNY Mellon,CitiBank HongKong,32942,22767,10175
2011-11-01,BNY Mellon,CitiBank HongKong,34191,33892,299
2011-12-01,BNY Mellon,CitiBank HongKong,32297,72418,-40121
2012-01-01,BNY Mellon,CitiBank HongKong,39222,31631,7591
2012-02-01,BNY Mellon,CitiBank HongKong,38341,45719,-7378
2012-03-01,BNY Mellon,CitiBank HongKong,36158,83645,-47487
2012-04-01,BNY Mellon,CitiBank HongKong,39462,89483,-50021
2012-05-01,BNY Mellon,CitiBank HongKong,31582,44553,-12971
2012-06-01,BNY Mellon,CitiBank HongKong,32333,47887,-15554
2012-07-01,BNY Mellon,CitiBank HongKong,45633,54286,-8653
2012-08-01,BNY Mellon,CitiBank HongKong,49887,42936,6951
2012-09-01,BNY Mellon,CitiBank HongKong,47738,55312,-7574
2012-10-01,BNY Mellon,CitiBank HongKong,43979,48433,-4454
2012-11-01,BNY Mellon,CitiBank HongKong,44512,66963,-22451
2012-12-01,BNY Mellon,CitiBank HongKong,42767,78667,-35900
2013-01-01,BNY Mellon,CitiBank HongKong,49781,68775,-18994
2013-02-01,BNY Mellon,CitiBank HongKong,41284,29389,11895
2013-03-01,BNY Mellon,CitiBank HongKong,46256,24845,21411
2013-04-01,BNY Mellon,CitiBank HongKong,45981,92132,-46151
2013-05-01,BNY Mellon,CitiBank HongKong,58968,12897,46071
2013-06-01,BNY Mellon,CitiBank HongKong,55467,86268,-30801
2013-07-01,BNY Mellon,CitiBank HongKong,55147,79688,-24541
2013-08-01,BNY Mellon,CitiBank HongKong,59528,78464,-18936
2013-09-01,BNY Mellon,CitiBank HongKong,56295,33488,22807
2013-10-01,BNY Mellon,CitiBank HongKong,52166,52925,-759
2013-11-01,BNY Mellon,CitiBank HongKong,54262,19228,35034
2013-12-01,BNY Mellon,CitiBank HongKong,59394,85379,-25985
2014-01-01,BNY Mellon,CitiBank HongKong,59492,13442,46050
2014-02-01,BNY Mellon,CitiBank HongKong,54297,39972,14325
2014-03-01,BNY Mellon,CitiBank HongKong,64636,99732,-35096
2014-04-01,BNY Mellon,CitiBank HongKong,68213,95315,-27102
2014-05-01,BNY Mellon,CitiBank HongKong,68895,48762,20133
2014-06-01,BNY Mellon,CitiBank HongKong,65136,74875,-9739
2014-07-01,BNY Mellon,CitiBank HongKong,66856,28216,38640
2014-08-01,BNY Mellon,CitiBank HongKong,62731,18849,43882
2014-09-01,BNY Mellon,CitiBank HongKong,69125,24935,44190
2014-10-01,BNY Mellon,CitiBank HongKong,66485,84666,-18181
2014-11-01,BNY Mellon,CitiBank HongKong,67476,43361,24115
2014-12-01,BNY Mellon,CitiBank HongKong,65342,86118,-20776
2015-01-01,BNY Mellon,CitiBank HongKong,74318,47637,26681
2015-02-01,BNY Mellon,CitiBank HongKong,71619,63965,7654
2015-03-01,BNY Mellon,CitiBank HongKong,71793,97613,-25820
2015-04-01,BNY Mellon,CitiBank HongKong,78592,36966,41626
2015-05-01,BNY Mellon,CitiBank HongKong,77126,51522,25604
2015-06-01,BNY Mellon,CitiBank HongKong,78147,38849,39298
2015-07-01,BNY Mellon,CitiBank HongKong,76766,98461,-21695
2015-08-01,BNY Mellon,CitiBank HongKong,71717,58518,13199
2015-09-01,BNY Mellon,CitiBank HongKong,71166,66813,4353
2015-10-01,BNY Mellon,CitiBank HongKong,72166,27876,44290
2015-11-01,BNY Mellon,CitiBank HongKong,87986,66126,21860
2015-12-01,BNY Mellon,CitiBank HongKong,85227,14297,70930
2016-01-01,BNY Mellon,CitiBank HongKong,85455,49619,35836
2016-02-01,BNY Mellon,CitiBank HongKong,88395,64936,23459
2016-03-01,BNY Mellon,CitiBank HongKong,84768,39936,44832
2016-04-01,BNY Mellon,CitiBank HongKong,82199,49919,32280
2016-05-01,BNY Mellon,CitiBank HongKong,81472,28791,52681
2016-06-01,BNY Mellon,CitiBank HongKong,85473,91118,-5645
2016-07-01,BNY Mellon,CitiBank HongKong,87632,18433,69199
2016-08-01,BNY Mellon,CitiBank HongKong,89744,17478,72266
2016-09-01,BNY Mellon,CitiBank HongKong,99928,48633,51295
2016-10-01,BNY Mellon,CitiBank HongKong,97185,52367,44818
2016-11-01,BNY Mellon,CitiBank HongKong,91396,25974,65422
2016-12-01,BNY Mellon,CitiBank HongKong,98532,64879,33653
2017-01-01,BNY Mellon,CitiBank HongKong,91594,28778,62816
2017-02-01,BNY Mellon,CitiBank HongKong,96972,88657,8315
2017-03-01,BNY Mellon,CitiBank HongKong,93391,96577,-3186
2017-04-01,BNY Mellon,CitiBank HongKong,91238,25466,65772
2017-05-01,BNY Mellon,CitiBank HongKong,93191,71482,21709
2017-06-01,BNY Mellon,CitiBank HongKong,97198,24124,73074
2017-07-01,BNY Mellon,CitiBank HongKong,108951,76278,32673
2017-08-01,BNY Mellon,CitiBank HongKong,103761,42723,61038
2017-09-01,BNY Mellon,CitiBank HongKong,101876,91926,9950
2017-10-01,BNY Mellon,CitiBank HongKong,107413,24128,83285
2017-11-01,BNY Mellon,CitiBank HongKong,106957,85352,21605
2017-12-01,BNY Mellon,CitiBank HongKong,101365,27886,73479
2018-01-01,BNY Mellon,CitiBank HongKong,105881,32318,73563
2018-02-01,BNY Mellon,CitiBank HongKong,105371,88538,16833
2018-03-01,BNY Mellon,CitiBank HongKong,107283,95548,11735
2018-04-01,BNY Mellon,CitiBank HongKong,107722,25642,82080
2010-01-01,Goldman Sachs,CitiBank New York,14114,66137,-52023
2010-02-01,Goldman Sachs,CitiBank New York,14484,73252,-58768
2010-03-01,Goldman Sachs,CitiBank New York,17939,94776,-76837
2010-04-01,Goldman Sachs,CitiBank New York,16965,62118,-45153
2010-05-01,Goldman Sachs,CitiBank New York,16966,46942,-29976
2010-06-01,Goldman Sachs,CitiBank New York,12644,54435,-41791
2010-07-01,Goldman Sachs,CitiBank New York,13169,86419,-73250
2010-08-01,Goldman Sachs,CitiBank New York,13651,62953,-49302
2010-09-01,Goldman Sachs,CitiBank New York,13521,77574,-64053
2010-10-01,Goldman Sachs,CitiBank New York,13667,65769,-52102
2010-11-01,Goldman Sachs,CitiBank New York,28438,12397,16041
2010-12-01,Goldman Sachs,CitiBank New York,29573,81359,-51786
2011-01-01,Goldman Sachs,CitiBank New York,27172,79981,-52809
2011-02-01,Goldman Sachs,CitiBank New York,28334,53756,-25422
2011-03-01,Goldman Sachs,CitiBank New York,24317,11553,12764
2011-04-01,Goldman Sachs,CitiBank New York,28938,78721,-49783
2011-05-01,Goldman Sachs,CitiBank New York,24228,87853,-63625
2011-06-01,Goldman Sachs,CitiBank New York,26359,29464,-3105
2011-07-01,Goldman Sachs,CitiBank New York,29764,82435,-52671
2011-08-01,Goldman Sachs,CitiBank New York,21887,77599,-55712
2011-09-01,Goldman Sachs,CitiBank New York,38756,92514,-53758
2011-10-01,Goldman Sachs,CitiBank New York,38186,64177,-25991
2011-11-01,Goldman Sachs,CitiBank New York,31361,38645,-7284
2011-12-01,Goldman Sachs,CitiBank New York,39343,64283,-24940
2012-01-01,Goldman Sachs,CitiBank New York,32621,43124,-10503
2012-02-01,Goldman Sachs,CitiBank New York,38639,98475,-59836
2012-03-01,Goldman Sachs,CitiBank New York,31761,33349,-1588
2012-04-01,Goldman Sachs,CitiBank New York,34818,16933,17885
2012-05-01,Goldman Sachs,CitiBank New York,36711,42178,-5467
2012-06-01,Goldman Sachs,CitiBank New York,31525,69281,-37756
2012-07-01,Goldman Sachs,CitiBank New York,43779,92428,-48649
2012-08-01,Goldman Sachs,CitiBank New York,42263,14323,27940
2012-09-01,Goldman Sachs,CitiBank New York,47812,26365,21447
2012-10-01,Goldman Sachs,CitiBank New York,42118,22557,19561
2012-11-01,Goldman Sachs,CitiBank New York,46866,85536,-38670
2012-12-01,Goldman Sachs,CitiBank New York,42423,63869,-21446
2013-01-01,Goldman Sachs,CitiBank New York,43688,61811,-18123
2013-02-01,Goldman Sachs,CitiBank New York,44142,49734,-5592
2013-03-01,Goldman Sachs,CitiBank New York,43429,56812,-13383
2013-04-01,Goldman Sachs,CitiBank New York,43781,88953,-45172
2013-05-01,Goldman Sachs,CitiBank New York,56198,27318,28880
2013-06-01,Goldman Sachs,CitiBank New York,57641,57581,60
2013-07-01,Goldman Sachs,CitiBank New York,55673,65229,-9556
2013-08-01,Goldman Sachs,CitiBank New York,57666,45389,12277
2013-09-01,Goldman Sachs,CitiBank New York,58842,79931,-21089
2013-10-01,Goldman Sachs,CitiBank New York,58291,86439,-28148
2013-11-01,Goldman Sachs,CitiBank New York,56353,91289,-34936
2013-12-01,Goldman Sachs,CitiBank New York,51413,66313,-14900
2014-01-01,Goldman Sachs,CitiBank New York,51827,96621,-44794
2014-02-01,Goldman Sachs,CitiBank New York,58779,86941,-28162
2014-03-01,Goldman Sachs,CitiBank New York,65134,23275,41859
2014-04-01,Goldman Sachs,CitiBank New York,67769,99516,-31747
2014-05-01,Goldman Sachs,CitiBank New York,66424,21291,45133
2014-06-01,Goldman Sachs,CitiBank New York,64876,58293,6583
2014-07-01,Goldman Sachs,CitiBank New York,67818,22865,44953
2014-08-01,Goldman Sachs,CitiBank New York,62132,32857,29275
2014-09-01,Goldman Sachs,CitiBank New York,67888,25169,42719
2014-10-01,Goldman Sachs,CitiBank New York,66465,21358,45107
2014-11-01,Goldman Sachs,CitiBank New York,65215,24261,40954
2014-12-01,Goldman Sachs,CitiBank New York,68976,58559,10417
2015-01-01,Goldman Sachs,CitiBank New York,76855,78262,-1407
2015-02-01,Goldman Sachs,CitiBank New York,75567,68974,6593
2015-03-01,Goldman Sachs,CitiBank New York,79124,52673,26451
2015-04-01,Goldman Sachs,CitiBank New York,77994,99346,-21352
2015-05-01,Goldman Sachs,CitiBank New York,73362,27315,46047
2015-06-01,Goldman Sachs,CitiBank New York,75996,84855,-8859
2015-07-01,Goldman Sachs,CitiBank New York,72173,99629,-27456
2015-08-01,Goldman Sachs,CitiBank New York,78481,17938,60543
2015-09-01,Goldman Sachs,CitiBank New York,77446,94126,-16680
2015-10-01,Goldman Sachs,CitiBank New York,75171,42586,32585
2015-11-01,Goldman Sachs,CitiBank New York,87999,64573,23426
2015-12-01,Goldman Sachs,CitiBank New York,85268,15198,70070
2016-01-01,Goldman Sachs,CitiBank New York,84987,25161,59826
2016-02-01,Goldman Sachs,CitiBank New York,89422,64939,24483
2016-03-01,Goldman Sachs,CitiBank New York,88821,88236,585
2016-04-01,Goldman Sachs,CitiBank New York,85961,75512,10449
2016-05-01,Goldman Sachs,CitiBank New York,84921,54528,30393
2016-06-01,Goldman Sachs,CitiBank New York,82828,87956,-5128
2016-07-01,Goldman Sachs,CitiBank New York,82756,24263,58493
2016-08-01,Goldman Sachs,CitiBank New York,89257,63714,25543
2016-09-01,Goldman Sachs,CitiBank New York,93152,14239,78913
2016-10-01,Goldman Sachs,CitiBank New York,92465,86164,6301
2016-11-01,Goldman Sachs,CitiBank New York,99844,41813,58031
2016-12-01,Goldman Sachs,CitiBank New York,95172,48995,46177
2017-01-01,Goldman Sachs,CitiBank New York,99356,26886,72470
2017-02-01,Goldman Sachs,CitiBank New York,92352,19825,72527
2017-03-01,Goldman Sachs,CitiBank New York,97723,62866,34857
2017-04-01,Goldman Sachs,CitiBank New York,99668,38536,61132
2017-05-01,Goldman Sachs,CitiBank New York,96796,41668,55128
2017-06-01,Goldman Sachs,CitiBank New York,93165,89641,3524
2017-07-01,Goldman Sachs,CitiBank New York,106266,87791,18475
2017-08-01,Goldman Sachs,CitiBank New York,107873,93675,14198
2017-09-01,Goldman Sachs,CitiBank New York,108114,83451,24663
2017-10-01,Goldman Sachs,CitiBank New York,108142,33383,74759
2017-11-01,Goldman Sachs,CitiBank New York,101887,34926,66961
2017-12-01,Goldman Sachs,CitiBank New York,107196,94523,12673
2018-01-01,Goldman Sachs,CitiBank New York,101268,13771,87497
2018-02-01,Goldman Sachs,CitiBank New York,109765,85582,24183
2018-03-01,Goldman Sachs,CitiBank New York,107224,22181,85043
2018-04-01,Goldman Sachs,CitiBank New York,103472,97978,5494
2010-01-01,Goldman Sachs,CitiBank London,11958,99128,-87170
2010-02-01,Goldman Sachs,CitiBank London,17681,77659,-59978
2010-03-01,Goldman Sachs,CitiBank London,18224,61165,-42941
2010-04-01,Goldman Sachs,CitiBank London,19812,92411,-72599
2010-05-01,Goldman Sachs,CitiBank London,15116,67385,-52269
2010-06-01,Goldman Sachs,CitiBank London,15384,15821,-437
2010-07-01,Goldman Sachs,CitiBank London,14981,15468,-487
2010-08-01,Goldman Sachs,CitiBank London,16743,62746,-46003
2010-09-01,Goldman Sachs,CitiBank London,11219,55982,-44763
2010-10-01,Goldman Sachs,CitiBank London,19539,68783,-49244
2010-11-01,Goldman Sachs,CitiBank London,26314,76132,-49818
2010-12-01,Goldman Sachs,CitiBank London,22361,27859,-5498
2011-01-01,Goldman Sachs,CitiBank London,27783,31394,-3611
2011-02-01,Goldman Sachs,CitiBank London,29956,53737,-23781
2011-03-01,Goldman Sachs,CitiBank London,25593,29643,-4050
2011-04-01,Goldman Sachs,CitiBank London,23353,41571,-18218
2011-05-01,Goldman Sachs,CitiBank London,25987,88197,-62210
2011-06-01,Goldman Sachs,CitiBank London,27132,35211,-8079
2011-07-01,Goldman Sachs,CitiBank London,23875,26145,-2270
2011-08-01,Goldman Sachs,CitiBank London,26417,16691,9726
2011-09-01,Goldman Sachs,CitiBank London,39375,14369,25006
2011-10-01,Goldman Sachs,CitiBank London,34677,54165,-19488
2011-11-01,Goldman Sachs,CitiBank London,32574,32279,295
2011-12-01,Goldman Sachs,CitiBank London,33595,41246,-7651
2012-01-01,Goldman Sachs,CitiBank London,33748,19146,14602
2012-02-01,Goldman Sachs,CitiBank London,31866,12584,19282
2012-03-01,Goldman Sachs,CitiBank London,39376,63572,-24196
2012-04-01,Goldman Sachs,CitiBank London,31312,61332,-30020
2012-05-01,Goldman Sachs,CitiBank London,37783,24299,13484
2012-06-01,Goldman Sachs,CitiBank London,37749,62121,-24372
2012-07-01,Goldman Sachs,CitiBank London,41169,23423,17746
2012-08-01,Goldman Sachs,CitiBank London,48415,96599,-48184
2012-09-01,Goldman Sachs,CitiBank London,49337,32651,16686
2012-10-01,Goldman Sachs,CitiBank London,45286,92957,-47671
2012-11-01,Goldman Sachs,CitiBank London,48488,84828,-36340
2012-12-01,Goldman Sachs,CitiBank London,45887,56388,-10501
2013-01-01,Goldman Sachs,CitiBank London,42564,69675,-27111
2013-02-01,Goldman Sachs,CitiBank London,44783,61142,-16359
2013-03-01,Goldman Sachs,CitiBank London,43514,13946,29568
2013-04-01,Goldman Sachs,CitiBank London,45747,98885,-53138
2013-05-01,Goldman Sachs,CitiBank London,51479,19547,31932
2013-06-01,Goldman Sachs,CitiBank London,58629,24897,33732
2013-07-01,Goldman Sachs,CitiBank London,56563,66298,-9735
2013-08-01,Goldman Sachs,CitiBank London,52568,33846,18722
2013-09-01,Goldman Sachs,CitiBank London,51694,98862,-47168
2013-10-01,Goldman Sachs,CitiBank London,59274,79764,-20490
2013-11-01,Goldman Sachs,CitiBank London,56534,53819,2715
2013-12-01,Goldman Sachs,CitiBank London,54482,73135,-18653
2014-01-01,Goldman Sachs,CitiBank London,54956,28917,26039
2014-02-01,Goldman Sachs,CitiBank London,54634,17589,37045
2014-03-01,Goldman Sachs,CitiBank London,67569,88968,-21399
2014-04-01,Goldman Sachs,CitiBank London,64729,32738,31991
2014-05-01,Goldman Sachs,CitiBank London,65828,58995,6833
2014-06-01,Goldman Sachs,CitiBank London,66395,57546,8849
2014-07-01,Goldman Sachs,CitiBank London,62456,51484,10972
2014-08-01,Goldman Sachs,CitiBank London,64411,77749,-13338
2014-09-01,Goldman Sachs,CitiBank London,68198,17182,51016
2014-10-01,Goldman Sachs,CitiBank London,68119,85794,-17675
2014-11-01,Goldman Sachs,CitiBank London,61542,15342,46200
2014-12-01,Goldman Sachs,CitiBank London,64464,87394,-22930
2015-01-01,Goldman Sachs,CitiBank London,73315,25887,47428
2015-02-01,Goldman Sachs,CitiBank London,77988,86638,-8650
2015-03-01,Goldman Sachs,CitiBank London,76627,18835,57792
2015-04-01,Goldman Sachs,CitiBank London,77749,13648,64101
2015-05-01,Goldman Sachs,CitiBank London,71183,83986,-12803
2015-06-01,Goldman Sachs,CitiBank London,74864,15572,59292
2015-07-01,Goldman Sachs,CitiBank London,75639,99944,-24305
2015-08-01,Goldman Sachs,CitiBank London,76761,89851,-13090
2015-09-01,Goldman Sachs,CitiBank London,78952,34769,44183
2015-10-01,Goldman Sachs,CitiBank London,72724,94714,-21990
2015-11-01,Goldman Sachs,CitiBank London,86871,76829,10042
2015-12-01,Goldman Sachs,CitiBank London,83483,71987,11496
2016-01-01,Goldman Sachs,CitiBank London,81388,45346,36042
2016-02-01,Goldman Sachs,CitiBank London,87955,98933,-10978
2016-03-01,Goldman Sachs,CitiBank London,85298,64813,20485
2016-04-01,Goldman Sachs,CitiBank London,88783,96429,-7646
2016-05-01,Goldman Sachs,CitiBank London,86821,78432,8389
2016-06-01,Goldman Sachs,CitiBank London,88355,26914,61441
2016-07-01,Goldman Sachs,CitiBank London,88713,17632,71081
2016-08-01,Goldman Sachs,CitiBank London,81252,48215,33037
2016-09-01,Goldman Sachs,CitiBank London,91327,11846,79481
2016-10-01,Goldman Sachs,CitiBank London,97654,77756,19898
2016-11-01,Goldman Sachs,CitiBank London,94129,85516,8613
2016-12-01,Goldman Sachs,CitiBank London,99382,71185,28197
2017-01-01,Goldman Sachs,CitiBank London,94746,39225,55521
2017-02-01,Goldman Sachs,CitiBank London,96182,47329,48853
2017-03-01,Goldman Sachs,CitiBank London,98967,92946,6021
2017-04-01,Goldman Sachs,CitiBank London,97312,86983,10329
2017-05-01,Goldman Sachs,CitiBank London,97775,61591,36184
2017-06-01,Goldman Sachs,CitiBank London,96457,26349,70108
2017-07-01,Goldman Sachs,CitiBank London,105854,55815,50039
2017-08-01,Goldman Sachs,CitiBank London,102191,71385,30806
2017-09-01,Goldman Sachs,CitiBank London,103558,22915,80643
2017-10-01,Goldman Sachs,CitiBank London,105128,93979,11149
2017-11-01,Goldman Sachs,CitiBank London,108436,83652,24784
2017-12-01,Goldman Sachs,CitiBank London,104955,69112,35843
2018-01-01,Goldman Sachs,CitiBank London,101479,59259,42220
2018-02-01,Goldman Sachs,CitiBank London,103996,53262,50734
2018-03-01,Goldman Sachs,CitiBank London,105224,59434,45790
2018-04-01,Goldman Sachs,CitiBank London,102586,33276,69310
2010-01-01,Goldman Sachs,CitiBank Pune,17837,62255,-44418
2010-02-01,Goldman Sachs,CitiBank Pune,14519,69386,-54867
2010-03-01,Goldman Sachs,CitiBank Pune,15967,97192,-81225
2010-04-01,Goldman Sachs,CitiBank Pune,15449,85883,-70434
2010-05-01,Goldman Sachs,CitiBank Pune,17311,61753,-44442
2010-06-01,Goldman Sachs,CitiBank Pune,13491,56495,-43004
2010-07-01,Goldman Sachs,CitiBank Pune,15296,23663,-8367
2010-08-01,Goldman Sachs,CitiBank Pune,12782,62138,-49356
2010-09-01,Goldman Sachs,CitiBank Pune,13828,95514,-81686
2010-10-01,Goldman Sachs,CitiBank Pune,15219,11684,3535
2010-11-01,Goldman Sachs,CitiBank Pune,27485,79542,-52057
2010-12-01,Goldman Sachs,CitiBank Pune,24117,24424,-307
2011-01-01,Goldman Sachs,CitiBank Pune,21925,52783,-30858
2011-02-01,Goldman Sachs,CitiBank Pune,26962,69326,-42364
2011-03-01,Goldman Sachs,CitiBank Pune,27844,33362,-5518
2011-04-01,Goldman Sachs,CitiBank Pune,22224,51518,-29294
2011-05-01,Goldman Sachs,CitiBank Pune,21632,77877,-56245
2011-06-01,Goldman Sachs,CitiBank Pune,23994,64185,-40191
2011-07-01,Goldman Sachs,CitiBank Pune,24295,43877,-19582
2011-08-01,Goldman Sachs,CitiBank Pune,24379,57798,-33419
2011-09-01,Goldman Sachs,CitiBank Pune,33797,85176,-51379
2011-10-01,Goldman Sachs,CitiBank Pune,34157,72338,-38181
2011-11-01,Goldman Sachs,CitiBank Pune,33124,72558,-39434
2011-12-01,Goldman Sachs,CitiBank Pune,34956,54511,-19555
2012-01-01,Goldman Sachs,CitiBank Pune,39284,43652,-4368
2012-02-01,Goldman Sachs,CitiBank Pune,36525,82246,-45721
2012-03-01,Goldman Sachs,CitiBank Pune,33677,26249,7428
2012-04-01,Goldman Sachs,CitiBank Pune,39845,29787,10058
2012-05-01,Goldman Sachs,CitiBank Pune,39987,35854,4133
2012-06-01,Goldman Sachs,CitiBank Pune,37496,65356,-27860
2012-07-01,Goldman Sachs,CitiBank Pune,48436,75656,-27220
2012-08-01,Goldman Sachs,CitiBank Pune,48896,32826,16070
2012-09-01,Goldman Sachs,CitiBank Pune,49681,71792,-22111
2012-10-01,Goldman Sachs,CitiBank Pune,47852,75926,-28074
2012-11-01,Goldman Sachs,CitiBank Pune,48842,29381,19461
2012-12-01,Goldman Sachs,CitiBank Pune,47531,38584,8947
2013-01-01,Goldman Sachs,CitiBank Pune,43525,84289,-40764
2013-02-01,Goldman Sachs,CitiBank Pune,47587,32564,15023
2013-03-01,Goldman Sachs,CitiBank Pune,43984,72578,-28594
2013-04-01,Goldman Sachs,CitiBank Pune,45758,51158,-5400
2013-05-01,Goldman Sachs,CitiBank Pune,53126,93429,-40303
2013-06-01,Goldman Sachs,CitiBank Pune,57221,16955,40266
2013-07-01,Goldman Sachs,CitiBank Pune,59451,66151,-6700
2013-08-01,Goldman Sachs,CitiBank Pune,55546,69473,-13927
2013-09-01,Goldman Sachs,CitiBank Pune,55433,63483,-8050
2013-10-01,Goldman Sachs,CitiBank Pune,55164,23885,31279
2013-11-01,Goldman Sachs,CitiBank Pune,59639,27741,31898
2013-12-01,Goldman Sachs,CitiBank Pune,57548,81252,-23704
2014-01-01,Goldman Sachs,CitiBank Pune,57661,58266,-605
2014-02-01,Goldman Sachs,CitiBank Pune,56872,12719,44153
2014-03-01,Goldman Sachs,CitiBank Pune,61952,36131,25821
2014-04-01,Goldman Sachs,CitiBank Pune,69339,91374,-22035
2014-05-01,Goldman Sachs,CitiBank Pune,61477,67185,-5708
2014-06-01,Goldman Sachs,CitiBank Pune,64137,55976,8161
2014-07-01,Goldman Sachs,CitiBank Pune,63534,25189,38345
2014-08-01,Goldman Sachs,CitiBank Pune,67938,71227,-3289
2014-09-01,Goldman Sachs,CitiBank Pune,66247,76563,-10316
2014-10-01,Goldman Sachs,CitiBank Pune,63575,83132,-19557
2014-11-01,Goldman Sachs,CitiBank Pune,67169,55324,11845
2014-12-01,Goldman Sachs,CitiBank Pune,65515,23154,42361
2015-01-01,Goldman Sachs,CitiBank Pune,74631,65767,8864
2015-02-01,Goldman Sachs,CitiBank Pune,77923,51471,26452
2015-03-01,Goldman Sachs,CitiBank Pune,71631,36818,34813
2015-04-01,Goldman Sachs,CitiBank Pune,79923,57733,22190
2015-05-01,Goldman Sachs,CitiBank Pune,78936,25542,53394
2015-06-01,Goldman Sachs,CitiBank Pune,74645,23727,50918
2015-07-01,Goldman Sachs,CitiBank Pune,71538,87899,-16361
2015-08-01,Goldman Sachs,CitiBank Pune,74497,17595,56902
2015-09-01,Goldman Sachs,CitiBank Pune,73647,37729,35918
2015-10-01,Goldman Sachs,CitiBank Pune,73169,44782,28387
2015-11-01,Goldman Sachs,CitiBank Pune,82196,88925,-6729
2015-12-01,Goldman Sachs,CitiBank Pune,88326,25953,62373
2016-01-01,Goldman Sachs,CitiBank Pune,88876,67463,21413
2016-02-01,Goldman Sachs,CitiBank Pune,88441,83323,5118
2016-03-01,Goldman Sachs,CitiBank Pune,84119,24447,59672
2016-04-01,Goldman Sachs,CitiBank Pune,85993,49978,36015
2016-05-01,Goldman Sachs,CitiBank Pune,82424,81794,630
2016-06-01,Goldman Sachs,CitiBank Pune,82868,27259,55609
2016-07-01,Goldman Sachs,CitiBank Pune,82845,22282,60563
2016-08-01,Goldman Sachs,CitiBank Pune,87988,83786,4202
2016-09-01,Goldman Sachs,CitiBank Pune,92133,83547,8586
2016-10-01,Goldman Sachs,CitiBank Pune,95347,83857,11490
2016-11-01,Goldman Sachs,CitiBank Pune,96584,46119,50465
2016-12-01,Goldman Sachs,CitiBank Pune,94396,55228,39168
2017-01-01,Goldman Sachs,CitiBank Pune,91197,28897,62300
2017-02-01,Goldman Sachs,CitiBank Pune,99773,44815,54958
2017-03-01,Goldman Sachs,CitiBank Pune,93425,71971,21454
2017-04-01,Goldman Sachs,CitiBank Pune,91488,67533,23955
2017-05-01,Goldman Sachs,CitiBank Pune,96312,93611,2701
2017-06-01,Goldman Sachs,CitiBank Pune,95859,83394,12465
2017-07-01,Goldman Sachs,CitiBank Pune,106541,43284,63257
2017-08-01,Goldman Sachs,CitiBank Pune,101466,82864,18602
2017-09-01,Goldman Sachs,CitiBank Pune,104769,93437,11332
2017-10-01,Goldman Sachs,CitiBank Pune,108959,19391,89568
2017-11-01,Goldman Sachs,CitiBank Pune,104832,29145,75687
2017-12-01,Goldman Sachs,CitiBank Pune,109616,18929,90687
2018-01-01,Goldman Sachs,CitiBank Pune,104132,93999,10133
2018-02-01,Goldman Sachs,CitiBank Pune,107631,42318,65313
2018-03-01,Goldman Sachs,CitiBank Pune,104761,73785,30976
2018-04-01,Goldman Sachs,CitiBank Pune,103314,62765,40549
2010-01-01,Goldman Sachs,CitiBank Singapore,15763,93232,-77469
2010-02-01,Goldman Sachs,CitiBank Singapore,12147,44277,-32130
2010-03-01,Goldman Sachs,CitiBank Singapore,17352,59775,-42423
2010-04-01,Goldman Sachs,CitiBank Singapore,18234,98421,-80187
2010-05-01,Goldman Sachs,CitiBank Singapore,16521,81395,-64874
2010-06-01,Goldman Sachs,CitiBank Singapore,12484,74438,-61954
2010-07-01,Goldman Sachs,CitiBank Singapore,18729,24781,-6052
2010-08-01,Goldman Sachs,CitiBank Singapore,19815,93286,-73471
2010-09-01,Goldman Sachs,CitiBank Singapore,14591,61772,-47181
2010-10-01,Goldman Sachs,CitiBank Singapore,18771,44526,-25755
2010-11-01,Goldman Sachs,CitiBank Singapore,22385,22487,-102
2010-12-01,Goldman Sachs,CitiBank Singapore,27966,41873,-13907
2011-01-01,Goldman Sachs,CitiBank Singapore,21735,12875,8860
2011-02-01,Goldman Sachs,CitiBank Singapore,23232,25942,-2710
2011-03-01,Goldman Sachs,CitiBank Singapore,21764,89998,-68234
2011-04-01,Goldman Sachs,CitiBank Singapore,24656,51512,-26856
2011-05-01,Goldman Sachs,CitiBank Singapore,26472,82663,-56191
2011-06-01,Goldman Sachs,CitiBank Singapore,23459,35972,-12513
2011-07-01,Goldman Sachs,CitiBank Singapore,24263,26287,-2024
2011-08-01,Goldman Sachs,CitiBank Singapore,28532,94888,-66356
2011-09-01,Goldman Sachs,CitiBank Singapore,35614,42757,-7143
2011-10-01,Goldman Sachs,CitiBank Singapore,36728,46351,-9623
2011-11-01,Goldman Sachs,CitiBank Singapore,32929,27997,4932
2011-12-01,Goldman Sachs,CitiBank Singapore,35415,59755,-24340
2012-01-01,Goldman Sachs,CitiBank Singapore,38512,47815,-9303
2012-02-01,Goldman Sachs,CitiBank Singapore,32878,56379,-23501
2012-03-01,Goldman Sachs,CitiBank Singapore,38117,65272,-27155
2012-04-01,Goldman Sachs,CitiBank Singapore,34761,64293,-29532
2012-05-01,Goldman Sachs,CitiBank Singapore,33532,24164,9368
2012-06-01,Goldman Sachs,CitiBank Singapore,31796,79135,-47339
2012-07-01,Goldman Sachs,CitiBank Singapore,43835,77942,-34107
2012-08-01,Goldman Sachs,CitiBank Singapore,42331,55925,-13594
2012-09-01,Goldman Sachs,CitiBank Singapore,41858,55596,-13738
2012-10-01,Goldman Sachs,CitiBank Singapore,45979,74884,-28905
2012-11-01,Goldman Sachs,CitiBank Singapore,43184,23394,19790
2012-12-01,Goldman Sachs,CitiBank Singapore,47776,55423,-7647
2013-01-01,Goldman Sachs,CitiBank Singapore,43597,63985,-20388
2013-02-01,Goldman Sachs,CitiBank Singapore,44638,34441,10197
2013-03-01,Goldman Sachs,CitiBank Singapore,49271,83251,-33980
2013-04-01,Goldman Sachs,CitiBank Singapore,48884,93949,-45065
2013-05-01,Goldman Sachs,CitiBank Singapore,54727,73129,-18402
2013-06-01,Goldman Sachs,CitiBank Singapore,56658,25836,30822
2013-07-01,Goldman Sachs,CitiBank Singapore,57838,84712,-26874
2013-08-01,Goldman Sachs,CitiBank Singapore,56613,89584,-32971
2013-09-01,Goldman Sachs,CitiBank Singapore,57268,91436,-34168
2013-10-01,Goldman Sachs,CitiBank Singapore,55128,44751,10377
2013-11-01,Goldman Sachs,CitiBank Singapore,58454,38429,20025
2013-12-01,Goldman Sachs,CitiBank Singapore,51167,65114,-13947
2014-01-01,Goldman Sachs,CitiBank Singapore,52183,73458,-21275
2014-02-01,Goldman Sachs,CitiBank Singapore,56254,31374,24880
2014-03-01,Goldman Sachs,CitiBank Singapore,69872,41255,28617
2014-04-01,Goldman Sachs,CitiBank Singapore,68921,91848,-22927
2014-05-01,Goldman Sachs,CitiBank Singapore,64714,36364,28350
2014-06-01,Goldman Sachs,CitiBank Singapore,61319,28696,32623
2014-07-01,Goldman Sachs,CitiBank Singapore,63398,52616,10782
2014-08-01,Goldman Sachs,CitiBank Singapore,66275,76571,-10296
2014-09-01,Goldman Sachs,CitiBank Singapore,69598,28412,41186
2014-10-01,Goldman Sachs,CitiBank Singapore,68794,73672,-4878
2014-11-01,Goldman Sachs,CitiBank Singapore,68752,53349,15403
2014-12-01,Goldman Sachs,CitiBank Singapore,63921,25157,38764
2015-01-01,Goldman Sachs,CitiBank Singapore,75393,94368,-18975
2015-02-01,Goldman Sachs,CitiBank Singapore,77281,21657,55624
2015-03-01,Goldman Sachs,CitiBank Singapore,77655,77754,-99
2015-04-01,Goldman Sachs,CitiBank Singapore,72975,51857,21118
2015-05-01,Goldman Sachs,CitiBank Singapore,74191,37888,36303
2015-06-01,Goldman Sachs,CitiBank Singapore,72798,47546,25252
2015-07-01,Goldman Sachs,CitiBank Singapore,73382,78184,-4802
2015-08-01,Goldman Sachs,CitiBank Singapore,77173,24344,52829
2015-09-01,Goldman Sachs,CitiBank Singapore,72356,49587,22769
2015-10-01,Goldman Sachs,CitiBank Singapore,79888,82934,-3046
2015-11-01,Goldman Sachs,CitiBank Singapore,89458,53526,35932
2015-12-01,Goldman Sachs,CitiBank Singapore,85834,79652,6182
2016-01-01,Goldman Sachs,CitiBank Singapore,89562,49497,40065
2016-02-01,Goldman Sachs,CitiBank Singapore,86122,35814,50308
2016-03-01,Goldman Sachs,CitiBank Singapore,89487,41114,48373
2016-04-01,Goldman Sachs,CitiBank Singapore,88848,84349,4499
2016-05-01,Goldman Sachs,CitiBank Singapore,86314,74341,11973
2016-06-01,Goldman Sachs,CitiBank Singapore,82221,42673,39548
2016-07-01,Goldman Sachs,CitiBank Singapore,81386,22331,59055
2016-08-01,Goldman Sachs,CitiBank Singapore,89767,19959,69808
2016-09-01,Goldman Sachs,CitiBank Singapore,96615,91944,4671
2016-10-01,Goldman Sachs,CitiBank Singapore,98868,29962,68906
2016-11-01,Goldman Sachs,CitiBank Singapore,94483,11328,83155
2016-12-01,Goldman Sachs,CitiBank Singapore,91893,58965,32928
2017-01-01,Goldman Sachs,CitiBank Singapore,97128,94334,2794
2017-02-01,Goldman Sachs,CitiBank Singapore,99114,85527,13587
2017-03-01,Goldman Sachs,CitiBank Singapore,96139,11429,84710
2017-04-01,Goldman Sachs,CitiBank Singapore,94934,24926,70008
2017-05-01,Goldman Sachs,CitiBank Singapore,98723,83797,14926
2017-06-01,Goldman Sachs,CitiBank Singapore,96579,64162,32417
2017-07-01,Goldman Sachs,CitiBank Singapore,104958,82762,22196
2017-08-01,Goldman Sachs,CitiBank Singapore,104435,64863,39572
2017-09-01,Goldman Sachs,CitiBank Singapore,103728,17752,85976
2017-10-01,Goldman Sachs,CitiBank Singapore,109284,76838,32446
2017-11-01,Goldman Sachs,CitiBank Singapore,109264,33662,75602
2017-12-01,Goldman Sachs,CitiBank Singapore,109766,97455,12311
2018-01-01,Goldman Sachs,CitiBank Singapore,109564,86936,22628
2018-02-01,Goldman Sachs,CitiBank Singapore,109325,49868,59457
2018-03-01,Goldman Sachs,CitiBank Singapore,103499,12362,91137
2018-04-01,Goldman Sachs,CitiBank Singapore,104114,18853,85261
2010-01-01,Goldman Sachs,CitiBank HongKong,17355,31179,-13824
2010-02-01,Goldman Sachs,CitiBank HongKong,18397,51417,-33020
2010-03-01,Goldman Sachs,CitiBank HongKong,14386,96976,-82590
2010-04-01,Goldman Sachs,CitiBank HongKong,15549,41123,-25574
2010-05-01,Goldman Sachs,CitiBank HongKong,11958,34842,-22884
2010-06-01,Goldman Sachs,CitiBank HongKong,15674,75187,-59513
2010-07-01,Goldman Sachs,CitiBank HongKong,15586,71553,-55967
2010-08-01,Goldman Sachs,CitiBank HongKong,14153,58779,-44626
2010-09-01,Goldman Sachs,CitiBank HongKong,12181,83671,-71490
2010-10-01,Goldman Sachs,CitiBank HongKong,18593,97952,-79359
2010-11-01,Goldman Sachs,CitiBank HongKong,23716,44388,-20672
2010-12-01,Goldman Sachs,CitiBank HongKong,23951,22551,1400
2011-01-01,Goldman Sachs,CitiBank HongKong,23492,73716,-50224
2011-02-01,Goldman Sachs,CitiBank HongKong,27241,14558,12683
2011-03-01,Goldman Sachs,CitiBank HongKong,23741,76598,-52857
2011-04-01,Goldman Sachs,CitiBank HongKong,26828,27918,-1090
2011-05-01,Goldman Sachs,CitiBank HongKong,24178,54126,-29948
2011-06-01,Goldman Sachs,CitiBank HongKong,22316,28299,-5983
2011-07-01,Goldman Sachs,CitiBank HongKong,26739,33717,-6978
2011-08-01,Goldman Sachs,CitiBank HongKong,24699,65245,-40546
2011-09-01,Goldman Sachs,CitiBank HongKong,38977,23598,15379
2011-10-01,Goldman Sachs,CitiBank HongKong,39757,87347,-47590
2011-11-01,Goldman Sachs,CitiBank HongKong,37115,75534,-38419
2011-12-01,Goldman Sachs,CitiBank HongKong,37468,19975,17493
2012-01-01,Goldman Sachs,CitiBank HongKong,31359,44854,-13495
2012-02-01,Goldman Sachs,CitiBank HongKong,35473,62887,-27414
2012-03-01,Goldman Sachs,CitiBank HongKong,34735,71891,-37156
2012-04-01,Goldman Sachs,CitiBank HongKong,34554,34946,-392
2012-05-01,Goldman Sachs,CitiBank HongKong,36911,38812,-1901
2012-06-01,Goldman Sachs,CitiBank HongKong,36377,59285,-22908
2012-07-01,Goldman Sachs,CitiBank HongKong,44295,85269,-40974
2012-08-01,Goldman Sachs,CitiBank HongKong,43858,58811,-14953
2012-09-01,Goldman Sachs,CitiBank HongKong,43639,46725,-3086
2012-10-01,Goldman Sachs,CitiBank HongKong,46862,94473,-47611
2012-11-01,Goldman Sachs,CitiBank HongKong,43567,79668,-36101
2012-12-01,Goldman Sachs,CitiBank HongKong,43322,17865,25457
2013-01-01,Goldman Sachs,CitiBank HongKong,49199,69579,-20380
2013-02-01,Goldman Sachs,CitiBank HongKong,48725,63446,-14721
2013-03-01,Goldman Sachs,CitiBank HongKong,41459,11199,30260
2013-04-01,Goldman Sachs,CitiBank HongKong,41675,71865,-30190
2013-05-01,Goldman Sachs,CitiBank HongKong,55543,16239,39304
2013-06-01,Goldman Sachs,CitiBank HongKong,59432,88844,-29412
2013-07-01,Goldman Sachs,CitiBank HongKong,51799,73581,-21782
2013-08-01,Goldman Sachs,CitiBank HongKong,54849,28862,25987
2013-09-01,Goldman Sachs,CitiBank HongKong,59359,94887,-35528
2013-10-01,Goldman Sachs,CitiBank HongKong,59518,72864,-13346
2013-11-01,Goldman Sachs,CitiBank HongKong,52289,15597,36692
2013-12-01,Goldman Sachs,CitiBank HongKong,59251,12759,46492
2014-01-01,Goldman Sachs,CitiBank HongKong,52879,39193,13686
2014-02-01,Goldman Sachs,CitiBank HongKong,52877,66276,-13399
2014-03-01,Goldman Sachs,CitiBank HongKong,69844,86759,-16915
2014-04-01,Goldman Sachs,CitiBank HongKong,68126,74775,-6649
2014-05-01,Goldman Sachs,CitiBank HongKong,69966,16222,53744
2014-06-01,Goldman Sachs,CitiBank HongKong,68343,36815,31528
2014-07-01,Goldman Sachs,CitiBank HongKong,61911,13535,48376
2014-08-01,Goldman Sachs,CitiBank HongKong,64387,74953,-10566
2014-09-01,Goldman Sachs,CitiBank HongKong,68535,96162,-27627
2014-10-01,Goldman Sachs,CitiBank HongKong,61843,52436,9407
2014-11-01,Goldman Sachs,CitiBank HongKong,65461,58883,6578
2014-12-01,Goldman Sachs,CitiBank HongKong,63328,76947,-13619
2015-01-01,Goldman Sachs,CitiBank HongKong,78415,29454,48961
2015-02-01,Goldman Sachs,CitiBank HongKong,71459,32347,39112
2015-03-01,Goldman Sachs,CitiBank HongKong,77351,82812,-5461
2015-04-01,Goldman Sachs,CitiBank HongKong,71197,43581,27616
2015-05-01,Goldman Sachs,CitiBank HongKong,71189,22866,48323
2015-06-01,Goldman Sachs,CitiBank HongKong,76117,79533,-3416
2015-07-01,Goldman Sachs,CitiBank HongKong,72466,26689,45777
2015-08-01,Goldman Sachs,CitiBank HongKong,75958,84288,-8330
2015-09-01,Goldman Sachs,CitiBank HongKong,77541,41453,36088
2015-10-01,Goldman Sachs,CitiBank HongKong,71424,19713,51711
2015-11-01,Goldman Sachs,CitiBank HongKong,87758,73275,14483
2015-12-01,Goldman Sachs,CitiBank HongKong,84824,51911,32913
2016-01-01,Goldman Sachs,CitiBank HongKong,86114,73282,12832
2016-02-01,Goldman Sachs,CitiBank HongKong,84478,19761,64717
2016-03-01,Goldman Sachs,CitiBank HongKong,82521,41747,40774
2016-04-01,Goldman Sachs,CitiBank HongKong,82589,46932,35657
2016-05-01,Goldman Sachs,CitiBank HongKong,81172,95914,-14742
2016-06-01,Goldman Sachs,CitiBank HongKong,81721,71615,10106
2016-07-01,Goldman Sachs,CitiBank HongKong,83437,88846,-5409
2016-08-01,Goldman Sachs,CitiBank HongKong,89225,56687,32538
2016-09-01,Goldman Sachs,CitiBank HongKong,98255,13588,84667
2016-10-01,Goldman Sachs,CitiBank HongKong,98337,97664,673
2016-11-01,Goldman Sachs,CitiBank HongKong,91633,68165,23468
2016-12-01,Goldman Sachs,CitiBank HongKong,96111,98429,-2318
2017-01-01,Goldman Sachs,CitiBank HongKong,93763,55875,37888
2017-02-01,Goldman Sachs,CitiBank HongKong,92158,68415,23743
2017-03-01,Goldman Sachs,CitiBank HongKong,97453,69175,28278
2017-04-01,Goldman Sachs,CitiBank HongKong,92636,31553,61083
2017-05-01,Goldman Sachs,CitiBank HongKong,97512,22478,75034
2017-06-01,Goldman Sachs,CitiBank HongKong,96192,45293,50899
2017-07-01,Goldman Sachs,CitiBank HongKong,102475,68357,34118
2017-08-01,Goldman Sachs,CitiBank HongKong,103965,92571,11394
2017-09-01,Goldman Sachs,CitiBank HongKong,109779,39194,70585
2017-10-01,Goldman Sachs,CitiBank HongKong,103665,19964,83701
2017-11-01,Goldman Sachs,CitiBank HongKong,107198,97512,9686
2017-12-01,Goldman Sachs,CitiBank HongKong,103549,57968,45581
2018-01-01,Goldman Sachs,CitiBank HongKong,109334,39743,69591
2018-02-01,Goldman Sachs,CitiBank HongKong,109371,66753,42618
2018-03-01,Goldman Sachs,CitiBank HongKong,108144,81596,26548
2018-04-01,Goldman Sachs,CitiBank HongKong,109839,42692,67147
2010-01-01,Deutsche Bank,CitiBank New York,18722,46472,-27750
2010-02-01,Deutsche Bank,CitiBank New York,14873,95373,-80500
2010-03-01,Deutsche Bank,CitiBank New York,14466,46115,-31649
2010-04-01,Deutsche Bank,CitiBank New York,17622,98928,-81306
2010-05-01,Deutsche Bank,CitiBank New York,17958,98599,-80641
2010-06-01,Deutsche Bank,CitiBank New York,13657,57617,-43960
2010-07-01,Deutsche Bank,CitiBank New York,13792,31259,-17467
2010-08-01,Deutsche Bank,CitiBank New York,15652,51521,-35869
2010-09-01,Deutsche Bank,CitiBank New York,13968,59691,-45723
2010-10-01,Deutsche Bank,CitiBank New York,13524,95928,-82404
2010-11-01,Deutsche Bank,CitiBank New York,24774,48426,-23652
2010-12-01,Deutsche Bank,CitiBank New York,24164,19382,4782
2011-01-01,Deutsche Bank,CitiBank New York,24256,37751,-13495
2011-02-01,Deutsche Bank,CitiBank New York,25731,26296,-565
2011-03-01,Deutsche Bank,CitiBank New York,26211,81122,-54911
2011-04-01,Deutsche Bank,CitiBank New York,25313,91275,-65962
2011-05-01,Deutsche Bank,CitiBank New York,21612,59266,-37654
2011-06-01,Deutsche Bank,CitiBank New York,25947,82422,-56475
2011-07-01,Deutsche Bank,CitiBank New York,23521,21266,2255
2011-08-01,Deutsche Bank,CitiBank New York,25247,54889,-29642
2011-09-01,Deutsche Bank,CitiBank New York,34546,73412,-38866
2011-10-01,Deutsche Bank,CitiBank New York,37681,58874,-21193
2011-11-01,Deutsche Bank,CitiBank New York,31647,22798,8849
2011-12-01,Deutsche Bank,CitiBank New York,37249,93593,-56344
2012-01-01,Deutsche Bank,CitiBank New York,35665,63234,-27569
2012-02-01,Deutsche Bank,CitiBank New York,34555,45966,-11411
2012-03-01,Deutsche Bank,CitiBank New York,33923,17178,16745
2012-04-01,Deutsche Bank,CitiBank New York,37837,75165,-37328
2012-05-01,Deutsche Bank,CitiBank New York,38978,92821,-53843
2012-06-01,Deutsche Bank,CitiBank New York,38512,19781,18731
2012-07-01,Deutsche Bank,CitiBank New York,46322,29674,16648
2012-08-01,Deutsche Bank,CitiBank New York,42984,62466,-19482
2012-09-01,Deutsche Bank,CitiBank New York,43536,21681,21855
2012-10-01,Deutsche Bank,CitiBank New York,46972,24873,22099
2012-11-01,Deutsche Bank,CitiBank New York,45627,83832,-38205
2012-12-01,Deutsche Bank,CitiBank New York,45942,94413,-48471
2013-01-01,Deutsche Bank,CitiBank New York,49258,48531,727
2013-02-01,Deutsche Bank,CitiBank New York,46812,27646,19166
2013-03-01,Deutsche Bank,CitiBank New York,48258,88219,-39961
2013-04-01,Deutsche Bank,CitiBank New York,44223,33919,10304
2013-05-01,Deutsche Bank,CitiBank New York,56611,89439,-32828
2013-06-01,Deutsche Bank,CitiBank New York,55262,56126,-864
2013-07-01,Deutsche Bank,CitiBank New York,54765,72337,-17572
2013-08-01,Deutsche Bank,CitiBank New York,54755,16869,37886
2013-09-01,Deutsche Bank,CitiBank New York,53913,36274,17639
2013-10-01,Deutsche Bank,CitiBank New York,58946,71614,-12668
2013-11-01,Deutsche Bank,CitiBank New York,55637,79243,-23606
2013-12-01,Deutsche Bank,CitiBank New York,58483,84634,-26151
2014-01-01,Deutsche Bank,CitiBank New York,53319,25947,27372
2014-02-01,Deutsche Bank,CitiBank New York,51517,66987,-15470
2014-03-01,Deutsche Bank,CitiBank New York,67973,24424,43549
2014-04-01,Deutsche Bank,CitiBank New York,67822,97184,-29362
2014-05-01,Deutsche Bank,CitiBank New York,63782,42416,21366
2014-06-01,Deutsche Bank,CitiBank New York,61312,45642,15670
2014-07-01,Deutsche Bank,CitiBank New York,65637,88998,-23361
2014-08-01,Deutsche Bank,CitiBank New York,61175,25775,35400
2014-09-01,Deutsche Bank,CitiBank New York,62629,18233,44396
2014-10-01,Deutsche Bank,CitiBank New York,65691,87435,-21744
2014-11-01,Deutsche Bank,CitiBank New York,65927,82328,-16401
2014-12-01,Deutsche Bank,CitiBank New York,66178,92564,-26386
2015-01-01,Deutsche Bank,CitiBank New York,71749,69179,2570
2015-02-01,Deutsche Bank,CitiBank New York,78914,38317,40597
2015-03-01,Deutsche Bank,CitiBank New York,79789,83148,-3359
2015-04-01,Deutsche Bank,CitiBank New York,79351,61275,18076
2015-05-01,Deutsche Bank,CitiBank New York,74118,55833,18285
2015-06-01,Deutsche Bank,CitiBank New York,77754,46928,30826
2015-07-01,Deutsche Bank,CitiBank New York,78722,42629,36093
2015-08-01,Deutsche Bank,CitiBank New York,78319,89572,-11253
2015-09-01,Deutsche Bank,CitiBank New York,72173,64893,7280
2015-10-01,Deutsche Bank,CitiBank New York,74413,24672,49741
2015-11-01,Deutsche Bank,CitiBank New York,86215,61256,24959
2015-12-01,Deutsche Bank,CitiBank New York,86192,29643,56549
2016-01-01,Deutsche Bank,CitiBank New York,85246,32577,52669
2016-02-01,Deutsche Bank,CitiBank New York,82473,97399,-14926
2016-03-01,Deutsche Bank,CitiBank New York,88145,61713,26432
2016-04-01,Deutsche Bank,CitiBank New York,81358,18512,62846
2016-05-01,Deutsche Bank,CitiBank New York,82112,87131,-5019
2016-06-01,Deutsche Bank,CitiBank New York,89278,25552,63726
2016-07-01,Deutsche Bank,CitiBank New York,85444,34127,51317
2016-08-01,Deutsche Bank,CitiBank New York,82374,71391,10983
2016-09-01,Deutsche Bank,CitiBank New York,98966,63844,35122
2016-10-01,Deutsche Bank,CitiBank New York,94187,52989,41198
2016-11-01,Deutsche Bank,CitiBank New York,95619,28258,67361
2016-12-01,Deutsche Bank,CitiBank New York,95598,91277,4321
2017-01-01,Deutsche Bank,CitiBank New York,97781,33931,63850
2017-02-01,Deutsche Bank,CitiBank New York,98816,79578,19238
2017-03-01,Deutsche Bank,CitiBank New York,98722,95646,3076
2017-04-01,Deutsche Bank,CitiBank New York,94276,89286,4990
2017-05-01,Deutsche Bank,CitiBank New York,99518,96749,2769
2017-06-01,Deutsche Bank,CitiBank New York,99354,55974,43380
2017-07-01,Deutsche Bank,CitiBank New York,102615,46545,56070
2017-08-01,Deutsche Bank,CitiBank New York,106948,37814,69134
2017-09-01,Deutsche Bank,CitiBank New York,109573,29595,79978
2017-10-01,Deutsche Bank,CitiBank New York,104892,15433,89459
2017-11-01,Deutsche Bank,CitiBank New York,104922,96537,8385
2017-12-01,Deutsche Bank,CitiBank New York,109154,25333,83821
2018-01-01,Deutsche Bank,CitiBank New York,104374,32711,71663
2018-02-01,Deutsche Bank,CitiBank New York,105413,73154,32259
2018-03-01,Deutsche Bank,CitiBank New York,104157,85149,19008
2018-04-01,Deutsche Bank,CitiBank New York,107149,65235,41914
2010-01-01,Deutsche Bank,CitiBank London,17842,61663,-43821
2010-02-01,Deutsche Bank,CitiBank London,16647,87166,-70519
2010-03-01,Deutsche Bank,CitiBank London,13975,79722,-65747
2010-04-01,Deutsche Bank,CitiBank London,13883,67232,-53349
2010-05-01,Deutsche Bank,CitiBank London,16581,14717,1864
2010-06-01,Deutsche Bank,CitiBank London,15763,35156,-19393
2010-07-01,Deutsche Bank,CitiBank London,18185,32651,-14466
2010-08-01,Deutsche Bank,CitiBank London,12972,72234,-59262
2010-09-01,Deutsche Bank,CitiBank London,18779,69557,-50778
2010-10-01,Deutsche Bank,CitiBank London,16159,48921,-32762
2010-11-01,Deutsche Bank,CitiBank London,23519,58679,-35160
2010-12-01,Deutsche Bank,CitiBank London,28946,72495,-43549
2011-01-01,Deutsche Bank,CitiBank London,21645,48392,-26747
2011-02-01,Deutsche Bank,CitiBank London,23216,79252,-56036
2011-03-01,Deutsche Bank,CitiBank London,21513,82642,-61129
2011-04-01,Deutsche Bank,CitiBank London,27599,43897,-16298
2011-05-01,Deutsche Bank,CitiBank London,24538,21665,2873
2011-06-01,Deutsche Bank,CitiBank London,21749,19312,2437
2011-07-01,Deutsche Bank,CitiBank London,22899,61253,-38354
2011-08-01,Deutsche Bank,CitiBank London,25659,89897,-64238
2011-09-01,Deutsche Bank,CitiBank London,34732,63716,-28984
2011-10-01,Deutsche Bank,CitiBank London,35588,51511,-15923
2011-11-01,Deutsche Bank,CitiBank London,31894,91568,-59674
2011-12-01,Deutsche Bank,CitiBank London,37593,27571,10022
2012-01-01,Deutsche Bank,CitiBank London,37572,76219,-38647
2012-02-01,Deutsche Bank,CitiBank London,38582,57564,-18982
2012-03-01,Deutsche Bank,CitiBank London,37432,99649,-62217
2012-04-01,Deutsche Bank,CitiBank London,37545,77285,-39740
2012-05-01,Deutsche Bank,CitiBank London,31442,75876,-44434
2012-06-01,Deutsche Bank,CitiBank London,38496,51784,-13288
2012-07-01,Deutsche Bank,CitiBank London,48945,51617,-2672
2012-08-01,Deutsche Bank,CitiBank London,47988,66761,-18773
2012-09-01,Deutsche Bank,CitiBank London,48926,36834,12092
2012-10-01,Deutsche Bank,CitiBank London,45227,56915,-11688
2012-11-01,Deutsche Bank,CitiBank London,48697,21735,26962
2012-12-01,Deutsche Bank,CitiBank London,48489,48662,-173
2013-01-01,Deutsche Bank,CitiBank London,45197,56263,-11066
2013-02-01,Deutsche Bank,CitiBank London,45325,33134,12191
2013-03-01,Deutsche Bank,CitiBank London,44543,58797,-14254
2013-04-01,Deutsche Bank,CitiBank London,48255,45996,2259
2013-05-01,Deutsche Bank,CitiBank London,52923,45844,7079
2013-06-01,Deutsche Bank,CitiBank London,52365,79813,-27448
2013-07-01,Deutsche Bank,CitiBank London,57543,19778,37765
2013-08-01,Deutsche Bank,CitiBank London,51741,21591,30150
2013-09-01,Deutsche Bank,CitiBank London,57971,68562,-10591
2013-10-01,Deutsche Bank,CitiBank London,57633,86936,-29303
2013-11-01,Deutsche Bank,CitiBank London,58134,28312,29822
2013-12-01,Deutsche Bank,CitiBank London,58238,27172,31066
2014-01-01,Deutsche Bank,CitiBank London,53366,51364,2002
2014-02-01,Deutsche Bank,CitiBank London,53787,91922,-38135
2014-03-01,Deutsche Bank,CitiBank London,69356,13272,56084
2014-04-01,Deutsche Bank,CitiBank London,66147,43549,22598
2014-05-01,Deutsche Bank,CitiBank London,62577,38556,24021
2014-06-01,Deutsche Bank,CitiBank London,69112,75163,-6051
2014-07-01,Deutsche Bank,CitiBank London,65149,31687,33462
2014-08-01,Deutsche Bank,CitiBank London,66311,68698,-2387
2014-09-01,Deutsche Bank,CitiBank London,66717,61327,5390
2014-10-01,Deutsche Bank,CitiBank London,64639,29846,34793
2014-11-01,Deutsche Bank,CitiBank London,62548,81993,-19445
2014-12-01,Deutsche Bank,CitiBank London,67812,76866,-9054
2015-01-01,Deutsche Bank,CitiBank London,71896,13825,58071
2015-02-01,Deutsche Bank,CitiBank London,77873,49249,28624
2015-03-01,Deutsche Bank,CitiBank London,76888,74261,2627
2015-04-01,Deutsche Bank,CitiBank London,71395,32424,38971
2015-05-01,Deutsche Bank,CitiBank London,77919,67533,10386
2015-06-01,Deutsche Bank,CitiBank London,78182,62264,15918
2015-07-01,Deutsche Bank,CitiBank London,72137,86267,-14130
2015-08-01,Deutsche Bank,CitiBank London,74634,43499,31135
2015-09-01,Deutsche Bank,CitiBank London,75997,69847,6150
2015-10-01,Deutsche Bank,CitiBank London,71415,93872,-22457
2015-11-01,Deutsche Bank,CitiBank London,81369,98331,-16962
2015-12-01,Deutsche Bank,CitiBank London,88164,74111,14053
2016-01-01,Deutsche Bank,CitiBank London,83935,71979,11956
2016-02-01,Deutsche Bank,CitiBank London,84281,92428,-8147
2016-03-01,Deutsche Bank,CitiBank London,83642,51484,32158
2016-04-01,Deutsche Bank,CitiBank London,87927,91943,-4016
2016-05-01,Deutsche Bank,CitiBank London,86777,54382,32395
2016-06-01,Deutsche Bank,CitiBank London,84131,27948,56183
2016-07-01,Deutsche Bank,CitiBank London,81482,75478,6004
2016-08-01,Deutsche Bank,CitiBank London,85933,37961,47972
2016-09-01,Deutsche Bank,CitiBank London,93565,12434,81131
2016-10-01,Deutsche Bank,CitiBank London,95716,74517,21199
2016-11-01,Deutsche Bank,CitiBank London,94538,56197,38341
2016-12-01,Deutsche Bank,CitiBank London,96966,88528,8438
2017-01-01,Deutsche Bank,CitiBank London,96396,93632,2764
2017-02-01,Deutsche Bank,CitiBank London,91447,12816,78631
2017-03-01,Deutsche Bank,CitiBank London,92836,83923,8913
2017-04-01,Deutsche Bank,CitiBank London,91694,84334,7360
2017-05-01,Deutsche Bank,CitiBank London,96922,86586,10336
2017-06-01,Deutsche Bank,CitiBank London,98268,36643,61625
2017-07-01,Deutsche Bank,CitiBank London,108583,59889,48694
2017-08-01,Deutsche Bank,CitiBank London,108323,71767,36556
2017-09-01,Deutsche Bank,CitiBank London,108196,26372,81824
2017-10-01,Deutsche Bank,CitiBank London,104575,83943,20632
2017-11-01,Deutsche Bank,CitiBank London,104517,65136,39381
2017-12-01,Deutsche Bank,CitiBank London,109588,23571,86017
2018-01-01,Deutsche Bank,CitiBank London,109333,67811,41522
2018-02-01,Deutsche Bank,CitiBank London,105762,15264,90498
2018-03-01,Deutsche Bank,CitiBank London,109433,32519,76914
2018-04-01,Deutsche Bank,CitiBank London,109853,86984,22869
2010-01-01,Deutsche Bank,CitiBank Pune,12348,72593,-60245
2010-02-01,Deutsche Bank,CitiBank Pune,12254,11593,661
2010-03-01,Deutsche Bank,CitiBank Pune,11178,77813,-66635
2010-04-01,Deutsche Bank,CitiBank Pune,19255,52883,-33628
2010-05-01,Deutsche Bank,CitiBank Pune,18545,44327,-25782
2010-06-01,Deutsche Bank,CitiBank Pune,12461,64886,-52425
2010-07-01,Deutsche Bank,CitiBank Pune,14838,91313,-76475
2010-08-01,Deutsche Bank,CitiBank Pune,11227,37619,-26392
2010-09-01,Deutsche Bank,CitiBank Pune,17277,46749,-29472
2010-10-01,Deutsche Bank,CitiBank Pune,16388,33667,-17279
2010-11-01,Deutsche Bank,CitiBank Pune,26286,74225,-47939
2010-12-01,Deutsche Bank,CitiBank Pune,25962,45646,-19684
2011-01-01,Deutsche Bank,CitiBank Pune,26349,13238,13111
2011-02-01,Deutsche Bank,CitiBank Pune,28288,84182,-55894
2011-03-01,Deutsche Bank,CitiBank Pune,24248,17448,6800
2011-04-01,Deutsche Bank,CitiBank Pune,26864,76196,-49332
2011-05-01,Deutsche Bank,CitiBank Pune,26841,61568,-34727
2011-06-01,Deutsche Bank,CitiBank Pune,22149,87549,-65400
2011-07-01,Deutsche Bank,CitiBank Pune,29986,34486,-4500
2011-08-01,Deutsche Bank,CitiBank Pune,27748,42191,-14443
2011-09-01,Deutsche Bank,CitiBank Pune,34683,64725,-30042
2011-10-01,Deutsche Bank,CitiBank Pune,37224,31331,5893
2011-11-01,Deutsche Bank,CitiBank Pune,39817,69469,-29652
2011-12-01,Deutsche Bank,CitiBank Pune,34233,21349,12884
2012-01-01,Deutsche Bank,CitiBank Pune,32823,93935,-61112
2012-02-01,Deutsche Bank,CitiBank Pune,33964,76695,-42731
2012-03-01,Deutsche Bank,CitiBank Pune,39594,75693,-36099
2012-04-01,Deutsche Bank,CitiBank Pune,35741,53388,-17647
2012-05-01,Deutsche Bank,CitiBank Pune,36327,67523,-31196
2012-06-01,Deutsche Bank,CitiBank Pune,35746,47336,-11590
2012-07-01,Deutsche Bank,CitiBank Pune,41274,84961,-43687
2012-08-01,Deutsche Bank,CitiBank Pune,48334,21224,27110
2012-09-01,Deutsche Bank,CitiBank Pune,42835,31611,11224
2012-10-01,Deutsche Bank,CitiBank Pune,42112,46669,-4557
2012-11-01,Deutsche Bank,CitiBank Pune,48236,93856,-45620
2012-12-01,Deutsche Bank,CitiBank Pune,45975,92525,-46550
2013-01-01,Deutsche Bank,CitiBank Pune,48814,13885,34929
2013-02-01,Deutsche Bank,CitiBank Pune,46252,36611,9641
2013-03-01,Deutsche Bank,CitiBank Pune,48743,45425,3318
2013-04-01,Deutsche Bank,CitiBank Pune,48246,59718,-11472
2013-05-01,Deutsche Bank,CitiBank Pune,52911,98926,-46015
2013-06-01,Deutsche Bank,CitiBank Pune,54648,27675,26973
2013-07-01,Deutsche Bank,CitiBank Pune,56835,54594,2241
2013-08-01,Deutsche Bank,CitiBank Pune,52125,89218,-37093
2013-09-01,Deutsche Bank,CitiBank Pune,52896,99583,-46687
2013-10-01,Deutsche Bank,CitiBank Pune,51285,42689,8596
2013-11-01,Deutsche Bank,CitiBank Pune,59236,31668,27568
2013-12-01,Deutsche Bank,CitiBank Pune,57565,47725,9840
2014-01-01,Deutsche Bank,CitiBank Pune,56769,46986,9783
2014-02-01,Deutsche Bank,CitiBank Pune,51258,91264,-40006
2014-03-01,Deutsche Bank,CitiBank Pune,67998,54741,13257
2014-04-01,Deutsche Bank,CitiBank Pune,66888,18729,48159
2014-05-01,Deutsche Bank,CitiBank Pune,63337,42551,20786
2014-06-01,Deutsche Bank,CitiBank Pune,65439,95249,-29810
2014-07-01,Deutsche Bank,CitiBank Pune,65898,85453,-19555
2014-08-01,Deutsche Bank,CitiBank Pune,63375,55342,8033
2014-09-01,Deutsche Bank,CitiBank Pune,62619,78578,-15959
2014-10-01,Deutsche Bank,CitiBank Pune,61922,38635,23287
2014-11-01,Deutsche Bank,CitiBank Pune,65868,59312,6556
2014-12-01,Deutsche Bank,CitiBank Pune,67768,63654,4114
2015-01-01,Deutsche Bank,CitiBank Pune,78238,28841,49397
2015-02-01,Deutsche Bank,CitiBank Pune,75142,46977,28165
2015-03-01,Deutsche Bank,CitiBank Pune,79591,15865,63726
2015-04-01,Deutsche Bank,CitiBank Pune,76562,54723,21839
2015-05-01,Deutsche Bank,CitiBank Pune,72966,53345,19621
2015-06-01,Deutsche Bank,CitiBank Pune,73663,52373,21290
2015-07-01,Deutsche Bank,CitiBank Pune,77432,39228,38204
2015-08-01,Deutsche Bank,CitiBank Pune,71964,17838,54126
2015-09-01,Deutsche Bank,CitiBank Pune,73186,28552,44634
2015-10-01,Deutsche Bank,CitiBank Pune,71546,14918,56628
2015-11-01,Deutsche Bank,CitiBank Pune,83734,61116,22618
2015-12-01,Deutsche Bank,CitiBank Pune,87187,35471,51716
2016-01-01,Deutsche Bank,CitiBank Pune,81878,45643,36235
2016-02-01,Deutsche Bank,CitiBank Pune,87441,81228,6213
2016-03-01,Deutsche Bank,CitiBank Pune,88316,75115,13201
2016-04-01,Deutsche Bank,CitiBank Pune,84771,32517,52254
2016-05-01,Deutsche Bank,CitiBank Pune,81242,62421,18821
2016-06-01,Deutsche Bank,CitiBank Pune,85336,63166,22170
2016-07-01,Deutsche Bank,CitiBank Pune,89743,85963,3780
2016-08-01,Deutsche Bank,CitiBank Pune,84169,12312,71857
2016-09-01,Deutsche Bank,CitiBank Pune,95769,97435,-1666
2016-10-01,Deutsche Bank,CitiBank Pune,94483,94996,-513
2016-11-01,Deutsche Bank,CitiBank Pune,97316,71149,26167
2016-12-01,Deutsche Bank,CitiBank Pune,92755,15967,76788
2017-01-01,Deutsche Bank,CitiBank Pune,97363,15166,82197
2017-02-01,Deutsche Bank,CitiBank Pune,96594,52642,43952
2017-03-01,Deutsche Bank,CitiBank Pune,93982,32182,61800
2017-04-01,Deutsche Bank,CitiBank Pune,95281,59696,35585
2017-05-01,Deutsche Bank,CitiBank Pune,99123,78513,20610
2017-06-01,Deutsche Bank,CitiBank Pune,96427,21424,75003
2017-07-01,Deutsche Bank,CitiBank Pune,103655,81649,22006
2017-08-01,Deutsche Bank,CitiBank Pune,105317,47837,57480
2017-09-01,Deutsche Bank,CitiBank Pune,101938,15925,86013
2017-10-01,Deutsche Bank,CitiBank Pune,109893,33864,76029
2017-11-01,Deutsche Bank,CitiBank Pune,102788,56553,46235
2017-12-01,Deutsche Bank,CitiBank Pune,101949,13795,88154
2018-01-01,Deutsche Bank,CitiBank Pune,107847,78389,29458
2018-02-01,Deutsche Bank,CitiBank Pune,105866,11774,94092
2018-03-01,Deutsche Bank,CitiBank Pune,107616,24972,82644
2018-04-01,Deutsche Bank,CitiBank Pune,104296,53995,50301
2010-01-01,Deutsche Bank,CitiBank Singapore,16229,17583,-1354
2010-02-01,Deutsche Bank,CitiBank Singapore,11728,72541,-60813
2010-03-01,Deutsche Bank,CitiBank Singapore,11488,54454,-42966
2010-04-01,Deutsche Bank,CitiBank Singapore,12611,76534,-63923
2010-05-01,Deutsche Bank,CitiBank Singapore,13479,47215,-33736
2010-06-01,Deutsche Bank,CitiBank Singapore,18189,75547,-57358
2010-07-01,Deutsche Bank,CitiBank Singapore,14354,21358,-7004
2010-08-01,Deutsche Bank,CitiBank Singapore,17963,76368,-58405
2010-09-01,Deutsche Bank,CitiBank Singapore,11667,82879,-71212
2010-10-01,Deutsche Bank,CitiBank Singapore,19423,98786,-79363
2010-11-01,Deutsche Bank,CitiBank Singapore,25581,91536,-65955
2010-12-01,Deutsche Bank,CitiBank Singapore,26843,76789,-49946
2011-01-01,Deutsche Bank,CitiBank Singapore,28776,14156,14620
2011-02-01,Deutsche Bank,CitiBank Singapore,25124,91683,-66559
2011-03-01,Deutsche Bank,CitiBank Singapore,26736,13326,13410
2011-04-01,Deutsche Bank,CitiBank Singapore,29226,15955,13271
2011-05-01,Deutsche Bank,CitiBank Singapore,28366,23341,5025
2011-06-01,Deutsche Bank,CitiBank Singapore,25978,63224,-37246
2011-07-01,Deutsche Bank,CitiBank Singapore,29444,77196,-47752
2011-08-01,Deutsche Bank,CitiBank Singapore,22412,52514,-30102
2011-09-01,Deutsche Bank,CitiBank Singapore,34661,63848,-29187
2011-10-01,Deutsche Bank,CitiBank Singapore,31557,36678,-5121
2011-11-01,Deutsche Bank,CitiBank Singapore,32715,91599,-58884
2011-12-01,Deutsche Bank,CitiBank Singapore,34186,55469,-21283
2012-01-01,Deutsche Bank,CitiBank Singapore,37962,66697,-28735
2012-02-01,Deutsche Bank,CitiBank Singapore,31318,53291,-21973
2012-03-01,Deutsche Bank,CitiBank Singapore,31628,24142,7486
2012-04-01,Deutsche Bank,CitiBank Singapore,38576,88555,-49979
2012-05-01,Deutsche Bank,CitiBank Singapore,34558,24237,10321
2012-06-01,Deutsche Bank,CitiBank Singapore,39356,79741,-40385
2012-07-01,Deutsche Bank,CitiBank Singapore,42375,79163,-36788
2012-08-01,Deutsche Bank,CitiBank Singapore,41785,37799,3986
2012-09-01,Deutsche Bank,CitiBank Singapore,49566,16391,33175
2012-10-01,Deutsche Bank,CitiBank Singapore,43134,94511,-51377
2012-11-01,Deutsche Bank,CitiBank Singapore,45613,19421,26192
2012-12-01,Deutsche Bank,CitiBank Singapore,48176,93856,-45680
2013-01-01,Deutsche Bank,CitiBank Singapore,43273,65549,-22276
2013-02-01,Deutsche Bank,CitiBank Singapore,45995,49564,-3569
2013-03-01,Deutsche Bank,CitiBank Singapore,46272,83798,-37526
2013-04-01,Deutsche Bank,CitiBank Singapore,48271,15363,32908
2013-05-01,Deutsche Bank,CitiBank Singapore,55376,88256,-32880
2013-06-01,Deutsche Bank,CitiBank Singapore,53652,73298,-19646
2013-07-01,Deutsche Bank,CitiBank Singapore,59911,33479,26432
2013-08-01,Deutsche Bank,CitiBank Singapore,53738,57434,-3696
2013-09-01,Deutsche Bank,CitiBank Singapore,55325,15383,39942
2013-10-01,Deutsche Bank,CitiBank Singapore,54848,41994,12854
2013-11-01,Deutsche Bank,CitiBank Singapore,56998,54449,2549
2013-12-01,Deutsche Bank,CitiBank Singapore,59376,43823,15553
2014-01-01,Deutsche Bank,CitiBank Singapore,58444,62573,-4129
2014-02-01,Deutsche Bank,CitiBank Singapore,53169,47382,5787
2014-03-01,Deutsche Bank,CitiBank Singapore,68765,74997,-6232
2014-04-01,Deutsche Bank,CitiBank Singapore,65222,85246,-20024
2014-05-01,Deutsche Bank,CitiBank Singapore,64175,56291,7884
2014-06-01,Deutsche Bank,CitiBank Singapore,66573,81337,-14764
2014-07-01,Deutsche Bank,CitiBank Singapore,63628,56985,6643
2014-08-01,Deutsche Bank,CitiBank Singapore,63798,31284,32514
2014-09-01,Deutsche Bank,CitiBank Singapore,63559,78663,-15104
2014-10-01,Deutsche Bank,CitiBank Singapore,66148,82662,-16514
2014-11-01,Deutsche Bank,CitiBank Singapore,64432,19337,45095
2014-12-01,Deutsche Bank,CitiBank Singapore,68442,32592,35850
2015-01-01,Deutsche Bank,CitiBank Singapore,72841,63348,9493
2015-02-01,Deutsche Bank,CitiBank Singapore,79178,35548,43630
2015-03-01,Deutsche Bank,CitiBank Singapore,76112,56423,19689
2015-04-01,Deutsche Bank,CitiBank Singapore,72139,79617,-7478
2015-05-01,Deutsche Bank,CitiBank Singapore,76944,31188,45756
2015-06-01,Deutsche Bank,CitiBank Singapore,72595,36785,35810
2015-07-01,Deutsche Bank,CitiBank Singapore,77428,25885,51543
2015-08-01,Deutsche Bank,CitiBank Singapore,75932,22248,53684
2015-09-01,Deutsche Bank,CitiBank Singapore,77679,38347,39332
2015-10-01,Deutsche Bank,CitiBank Singapore,75814,97384,-21570
2015-11-01,Deutsche Bank,CitiBank Singapore,87974,68549,19425
2015-12-01,Deutsche Bank,CitiBank Singapore,86148,65189,20959
2016-01-01,Deutsche Bank,CitiBank Singapore,88914,94372,-5458
2016-02-01,Deutsche Bank,CitiBank Singapore,83577,22782,60795
2016-03-01,Deutsche Bank,CitiBank Singapore,87676,43972,43704
2016-04-01,Deutsche Bank,CitiBank Singapore,81852,56889,24963
2016-05-01,Deutsche Bank,CitiBank Singapore,82172,49131,33041
2016-06-01,Deutsche Bank,CitiBank Singapore,83316,43784,39532
2016-07-01,Deutsche Bank,CitiBank Singapore,85655,88264,-2609
2016-08-01,Deutsche Bank,CitiBank Singapore,82335,88161,-5826
2016-09-01,Deutsche Bank,CitiBank Singapore,95334,97198,-1864
2016-10-01,Deutsche Bank,CitiBank Singapore,97788,33999,63789
2016-11-01,Deutsche Bank,CitiBank Singapore,99227,82335,16892
2016-12-01,Deutsche Bank,CitiBank Singapore,91276,13812,77464
2017-01-01,Deutsche Bank,CitiBank Singapore,92974,62154,30820
2017-02-01,Deutsche Bank,CitiBank Singapore,96621,75334,21287
2017-03-01,Deutsche Bank,CitiBank Singapore,93366,51421,41945
2017-04-01,Deutsche Bank,CitiBank Singapore,99228,77553,21675
2017-05-01,Deutsche Bank,CitiBank Singapore,93362,44154,49208
2017-06-01,Deutsche Bank,CitiBank Singapore,96337,65627,30710
2017-07-01,Deutsche Bank,CitiBank Singapore,108845,77784,31061
2017-08-01,Deutsche Bank,CitiBank Singapore,109759,17691,92068
2017-09-01,Deutsche Bank,CitiBank Singapore,101165,55175,45990
2017-10-01,Deutsche Bank,CitiBank Singapore,106232,87584,18648
2017-11-01,Deutsche Bank,CitiBank Singapore,102382,47467,54915
2017-12-01,Deutsche Bank,CitiBank Singapore,105313,61379,43934
2018-01-01,Deutsche Bank,CitiBank Singapore,108996,24528,84468
2018-02-01,Deutsche Bank,CitiBank Singapore,103819,96246,7573
2018-03-01,Deutsche Bank,CitiBank Singapore,104515,23742,80773
2018-04-01,Deutsche Bank,CitiBank Singapore,101428,64361,37067
2010-01-01,Deutsche Bank,CitiBank HongKong,13875,68226,-54351
2010-02-01,Deutsche Bank,CitiBank HongKong,17893,53825,-35932
2010-03-01,Deutsche Bank,CitiBank HongKong,16544,86854,-70310
2010-04-01,Deutsche Bank,CitiBank HongKong,18439,59829,-41390
2010-05-01,Deutsche Bank,CitiBank HongKong,13881,14911,-1030
2010-06-01,Deutsche Bank,CitiBank HongKong,19927,23724,-3797
2010-07-01,Deutsche Bank,CitiBank HongKong,14466,53835,-39369
2010-08-01,Deutsche Bank,CitiBank HongKong,15882,33615,-17733
2010-09-01,Deutsche Bank,CitiBank HongKong,14871,57314,-42443
2010-10-01,Deutsche Bank,CitiBank HongKong,19885,72955,-53070
2010-11-01,Deutsche Bank,CitiBank HongKong,28175,67718,-39543
2010-12-01,Deutsche Bank,CitiBank HongKong,21644,88635,-66991
2011-01-01,Deutsche Bank,CitiBank HongKong,29152,39572,-10420
2011-02-01,Deutsche Bank,CitiBank HongKong,23547,29214,-5667
2011-03-01,Deutsche Bank,CitiBank HongKong,28332,94148,-65816
2011-04-01,Deutsche Bank,CitiBank HongKong,28461,42257,-13796
2011-05-01,Deutsche Bank,CitiBank HongKong,25834,28118,-2284
2011-06-01,Deutsche Bank,CitiBank HongKong,21236,44539,-23303
2011-07-01,Deutsche Bank,CitiBank HongKong,24944,52768,-27824
2011-08-01,Deutsche Bank,CitiBank HongKong,21745,35839,-14094
2011-09-01,Deutsche Bank,CitiBank HongKong,38648,28542,10106
2011-10-01,Deutsche Bank,CitiBank HongKong,33671,15897,17774
2011-11-01,Deutsche Bank,CitiBank HongKong,34169,11973,22196
2011-12-01,Deutsche Bank,CitiBank HongKong,38757,87219,-48462
2012-01-01,Deutsche Bank,CitiBank HongKong,35422,24757,10665
2012-02-01,Deutsche Bank,CitiBank HongKong,32589,75135,-42546
2012-03-01,Deutsche Bank,CitiBank HongKong,33346,13858,19488
2012-04-01,Deutsche Bank,CitiBank HongKong,39716,41268,-1552
2012-05-01,Deutsche Bank,CitiBank HongKong,33646,98815,-65169
2012-06-01,Deutsche Bank,CitiBank HongKong,35897,35567,330
2012-07-01,Deutsche Bank,CitiBank HongKong,49827,48854,973
2012-08-01,Deutsche Bank,CitiBank HongKong,42695,58146,-15451
2012-09-01,Deutsche Bank,CitiBank HongKong,48464,59442,-10978
2012-10-01,Deutsche Bank,CitiBank HongKong,46732,84823,-38091
2012-11-01,Deutsche Bank,CitiBank HongKong,44586,53459,-8873
2012-12-01,Deutsche Bank,CitiBank HongKong,46159,31139,15020
2013-01-01,Deutsche Bank,CitiBank HongKong,41158,15493,25665
2013-02-01,Deutsche Bank,CitiBank HongKong,46338,42644,3694
2013-03-01,Deutsche Bank,CitiBank HongKong,41782,62219,-20437
2013-04-01,Deutsche Bank,CitiBank HongKong,47327,45223,2104
2013-05-01,Deutsche Bank,CitiBank HongKong,54477,37858,16619
2013-06-01,Deutsche Bank,CitiBank HongKong,51858,46648,5210
2013-07-01,Deutsche Bank,CitiBank HongKong,55385,18229,37156
2013-08-01,Deutsche Bank,CitiBank HongKong,51496,34175,17321
2013-09-01,Deutsche Bank,CitiBank HongKong,56712,78351,-21639
2013-10-01,Deutsche Bank,CitiBank HongKong,53885,82524,-28639
2013-11-01,Deutsche Bank,CitiBank HongKong,55476,29578,25898
2013-12-01,Deutsche Bank,CitiBank HongKong,59265,28536,30729
2014-01-01,Deutsche Bank,CitiBank HongKong,51984,59515,-7531
2014-02-01,Deutsche Bank,CitiBank HongKong,53338,64756,-11418
2014-03-01,Deutsche Bank,CitiBank HongKong,69399,83581,-14182
2014-04-01,Deutsche Bank,CitiBank HongKong,61671,15712,45959
2014-05-01,Deutsche Bank,CitiBank HongKong,63557,32314,31243
2014-06-01,Deutsche Bank,CitiBank HongKong,65983,68851,-2868
2014-07-01,Deutsche Bank,CitiBank HongKong,62842,89167,-26325
2014-08-01,Deutsche Bank,CitiBank HongKong,66198,21153,45045
2014-09-01,Deutsche Bank,CitiBank HongKong,65295,12743,52552
2014-10-01,Deutsche Bank,CitiBank HongKong,62918,67946,-5028
2014-11-01,Deutsche Bank,CitiBank HongKong,67323,84164,-16841
2014-12-01,Deutsche Bank,CitiBank HongKong,64199,98297,-34098
2015-01-01,Deutsche Bank,CitiBank HongKong,74561,97945,-23384
2015-02-01,Deutsche Bank,CitiBank HongKong,72532,62876,9656
2015-03-01,Deutsche Bank,CitiBank HongKong,76496,99312,-22816
2015-04-01,Deutsche Bank,CitiBank HongKong,75598,64976,10622
2015-05-01,Deutsche Bank,CitiBank HongKong,72986,11835,61151
2015-06-01,Deutsche Bank,CitiBank HongKong,78491,69754,8737
2015-07-01,Deutsche Bank,CitiBank HongKong,76355,53149,23206
2015-08-01,Deutsche Bank,CitiBank HongKong,72879,23653,49226
2015-09-01,Deutsche Bank,CitiBank HongKong,76448,62196,14252
2015-10-01,Deutsche Bank,CitiBank HongKong,78863,31674,47189
2015-11-01,Deutsche Bank,CitiBank HongKong,82591,61645,20946
2015-12-01,Deutsche Bank,CitiBank HongKong,85613,66946,18667
2016-01-01,Deutsche Bank,CitiBank HongKong,81385,91668,-10283
2016-02-01,Deutsche Bank,CitiBank HongKong,83752,35155,48597
2016-03-01,Deutsche Bank,CitiBank HongKong,81448,43168,38280
2016-04-01,Deutsche Bank,CitiBank HongKong,88495,13117,75378
2016-05-01,Deutsche Bank,CitiBank HongKong,85875,68668,17207
2016-06-01,Deutsche Bank,CitiBank HongKong,88867,23877,64990
2016-07-01,Deutsche Bank,CitiBank HongKong,87413,83624,3789
2016-08-01,Deutsche Bank,CitiBank HongKong,85242,79649,5593
2016-09-01,Deutsche Bank,CitiBank HongKong,91645,35161,56484
2016-10-01,Deutsche Bank,CitiBank HongKong,95961,92662,3299
2016-11-01,Deutsche Bank,CitiBank HongKong,96757,21568,75189
2016-12-01,Deutsche Bank,CitiBank HongKong,95298,71292,24006
2017-01-01,Deutsche Bank,CitiBank HongKong,93171,18561,74610
2017-02-01,Deutsche Bank,CitiBank HongKong,99197,66119,33078
2017-03-01,Deutsche Bank,CitiBank HongKong,92616,96563,-3947
2017-04-01,Deutsche Bank,CitiBank HongKong,96324,36115,60209
2017-05-01,Deutsche Bank,CitiBank HongKong,93716,83155,10561
2017-06-01,Deutsche Bank,CitiBank HongKong,96147,99328,-3181
2017-07-01,Deutsche Bank,CitiBank HongKong,101143,87773,13370
2017-08-01,Deutsche Bank,CitiBank HongKong,108414,91592,16822
2017-09-01,Deutsche Bank,CitiBank HongKong,109943,27816,82127
2017-10-01,Deutsche Bank,CitiBank HongKong,109746,61747,47999
2017-11-01,Deutsche Bank,CitiBank HongKong,109882,47911,61971
2017-12-01,Deutsche Bank,CitiBank HongKong,109816,91345,18471
2018-01-01,Deutsche Bank,CitiBank HongKong,104621,34336,70285
2018-02-01,Deutsche Bank,CitiBank HongKong,102998,76976,26022
2018-03-01,Deutsche Bank,CitiBank HongKong,107337,43427,63910
2018-04-01,Deutsche Bank,CitiBank HongKong,103684,31966,71718
2010-01-01,JP Morgan,CitiBank New York,11424,79766,-68342
2010-02-01,JP Morgan,CitiBank New York,18413,16179,2234
2010-03-01,JP Morgan,CitiBank New York,17826,73387,-55561
2010-04-01,JP Morgan,CitiBank New York,19163,47666,-28503
2010-05-01,JP Morgan,CitiBank New York,17525,51599,-34074
2010-06-01,JP Morgan,CitiBank New York,12989,29136,-16147
2010-07-01,JP Morgan,CitiBank New York,18158,15492,2666
2010-08-01,JP Morgan,CitiBank New York,18469,59855,-41386
2010-09-01,JP Morgan,CitiBank New York,14155,68333,-54178
2010-10-01,JP Morgan,CitiBank New York,13313,44584,-31271
2010-11-01,JP Morgan,CitiBank New York,26528,47449,-20921
2010-12-01,JP Morgan,CitiBank New York,26638,25589,1049
2011-01-01,JP Morgan,CitiBank New York,21691,95197,-73506
2011-02-01,JP Morgan,CitiBank New York,25683,96175,-70492
2011-03-01,JP Morgan,CitiBank New York,24292,89462,-65170
2011-04-01,JP Morgan,CitiBank New York,21124,47128,-26004
2011-05-01,JP Morgan,CitiBank New York,28475,55436,-26961
2011-06-01,JP Morgan,CitiBank New York,26447,49735,-23288
2011-07-01,JP Morgan,CitiBank New York,25821,31985,-6164
2011-08-01,JP Morgan,CitiBank New York,29382,32198,-2816
2011-09-01,JP Morgan,CitiBank New York,35529,54485,-18956
2011-10-01,JP Morgan,CitiBank New York,39211,15199,24012
2011-11-01,JP Morgan,CitiBank New York,33762,56492,-22730
2011-12-01,JP Morgan,CitiBank New York,36297,11836,24461
2012-01-01,JP Morgan,CitiBank New York,32135,45882,-13747
2012-02-01,JP Morgan,CitiBank New York,31573,43644,-12071
2012-03-01,JP Morgan,CitiBank New York,32269,43922,-11653
2012-04-01,JP Morgan,CitiBank New York,34991,56181,-21190
2012-05-01,JP Morgan,CitiBank New York,35374,29264,6110
2012-06-01,JP Morgan,CitiBank New York,34317,91897,-57580
2012-07-01,JP Morgan,CitiBank New York,44312,41511,2801
2012-08-01,JP Morgan,CitiBank New York,45151,59842,-14691
2012-09-01,JP Morgan,CitiBank New York,49949,35471,14478
2012-10-01,JP Morgan,CitiBank New York,46735,27815,18920
2012-11-01,JP Morgan,CitiBank New York,44154,55846,-11692
2012-12-01,JP Morgan,CitiBank New York,43821,86784,-42963
2013-01-01,JP Morgan,CitiBank New York,47192,28623,18569
2013-02-01,JP Morgan,CitiBank New York,48295,25933,22362
2013-03-01,JP Morgan,CitiBank New York,46851,33294,13557
2013-04-01,JP Morgan,CitiBank New York,43928,14428,29500
2013-05-01,JP Morgan,CitiBank New York,52398,79162,-26764
2013-06-01,JP Morgan,CitiBank New York,59374,74954,-15580
2013-07-01,JP Morgan,CitiBank New York,57974,46295,11679
2013-08-01,JP Morgan,CitiBank New York,53439,67643,-14204
2013-09-01,JP Morgan,CitiBank New York,56657,37245,19412
2013-10-01,JP Morgan,CitiBank New York,56219,22493,33726
2013-11-01,JP Morgan,CitiBank New York,59527,73655,-14128
2013-12-01,JP Morgan,CitiBank New York,53358,35415,17943
2014-01-01,JP Morgan,CitiBank New York,59958,48846,11112
2014-02-01,JP Morgan,CitiBank New York,57657,49127,8530
2014-03-01,JP Morgan,CitiBank New York,61194,61573,-379
2014-04-01,JP Morgan,CitiBank New York,66513,23519,42994
2014-05-01,JP Morgan,CitiBank New York,62727,26341,36386
2014-06-01,JP Morgan,CitiBank New York,69314,74381,-5067
2014-07-01,JP Morgan,CitiBank New York,61964,45731,16233
2014-08-01,JP Morgan,CitiBank New York,66918,31971,34947
2014-09-01,JP Morgan,CitiBank New York,64225,13756,50469
2014-10-01,JP Morgan,CitiBank New York,62293,17272,45021
2014-11-01,JP Morgan,CitiBank New York,64486,21525,42961
2014-12-01,JP Morgan,CitiBank New York,68132,66743,1389
2015-01-01,JP Morgan,CitiBank New York,79784,53889,25895
2015-02-01,JP Morgan,CitiBank New York,74779,44824,29955
2015-03-01,JP Morgan,CitiBank New York,71875,59393,12482
2015-04-01,JP Morgan,CitiBank New York,78784,63126,15658
2015-05-01,JP Morgan,CitiBank New York,73426,98811,-25385
2015-06-01,JP Morgan,CitiBank New York,79182,91421,-12239
2015-07-01,JP Morgan,CitiBank New York,76915,73518,3397
2015-08-01,JP Morgan,CitiBank New York,71539,65153,6386
2015-09-01,JP Morgan,CitiBank New York,75458,36927,38531
2015-10-01,JP Morgan,CitiBank New York,73843,96836,-22993
2015-11-01,JP Morgan,CitiBank New York,82352,99567,-17215
2015-12-01,JP Morgan,CitiBank New York,83253,85836,-2583
2016-01-01,JP Morgan,CitiBank New York,85523,27733,57790
2016-02-01,JP Morgan,CitiBank New York,81829,28494,53335
2016-03-01,JP Morgan,CitiBank New York,81142,75275,5867
2016-04-01,JP Morgan,CitiBank New York,86792,51872,34920
2016-05-01,JP Morgan,CitiBank New York,85263,89928,-4665
2016-06-01,JP Morgan,CitiBank New York,89265,79236,10029
2016-07-01,JP Morgan,CitiBank New York,85583,59476,26107
2016-08-01,JP Morgan,CitiBank New York,88222,81478,6744
2016-09-01,JP Morgan,CitiBank New York,98762,88251,10511
2016-10-01,JP Morgan,CitiBank New York,92131,68291,23840
2016-11-01,JP Morgan,CitiBank New York,98794,98413,381
2016-12-01,JP Morgan,CitiBank New York,96718,39382,57336
2017-01-01,JP Morgan,CitiBank New York,93911,19365,74546
2017-02-01,JP Morgan,CitiBank New York,95534,54688,40846
2017-03-01,JP Morgan,CitiBank New York,92619,12992,79627
2017-04-01,JP Morgan,CitiBank New York,94823,45135,49688
2017-05-01,JP Morgan,CitiBank New York,99477,84771,14706
2017-06-01,JP Morgan,CitiBank New York,95835,94892,943
2017-07-01,JP Morgan,CitiBank New York,105747,77517,28230
2017-08-01,JP Morgan,CitiBank New York,101555,48117,53438
2017-09-01,JP Morgan,CitiBank New York,104963,92424,12539
2017-10-01,JP Morgan,CitiBank New York,107187,47853,59334
2017-11-01,JP Morgan,CitiBank New York,107646,75535,32111
2017-12-01,JP Morgan,CitiBank New York,102145,31653,70492
2018-01-01,JP Morgan,CitiBank New York,104218,24534,79684
2018-02-01,JP Morgan,CitiBank New York,104383,59584,44799
2018-03-01,JP Morgan,CitiBank New York,104529,74927,29602
2018-04-01,JP Morgan,CitiBank New York,105456,34432,71024
2010-01-01,JP Morgan,CitiBank London,15996,46735,-30739
2010-02-01,JP Morgan,CitiBank London,18858,69727,-50869
2010-03-01,JP Morgan,CitiBank London,16861,46986,-30125
2010-04-01,JP Morgan,CitiBank London,19972,24778,-4806
2010-05-01,JP Morgan,CitiBank London,15695,16627,-932
2010-06-01,JP Morgan,CitiBank London,19178,12674,6504
2010-07-01,JP Morgan,CitiBank London,19377,76796,-57419
2010-08-01,JP Morgan,CitiBank London,15154,83338,-68184
2010-09-01,JP Morgan,CitiBank London,14839,82519,-67680
2010-10-01,JP Morgan,CitiBank London,11581,84826,-73245
2010-11-01,JP Morgan,CitiBank London,27422,47923,-20501
2010-12-01,JP Morgan,CitiBank London,25856,95381,-69525
2011-01-01,JP Morgan,CitiBank London,26783,15793,10990
2011-02-01,JP Morgan,CitiBank London,23457,67754,-44297
2011-03-01,JP Morgan,CitiBank London,25459,26385,-926
2011-04-01,JP Morgan,CitiBank London,27558,98731,-71173
2011-05-01,JP Morgan,CitiBank London,24542,59775,-35233
2011-06-01,JP Morgan,CitiBank London,29549,49685,-20136
2011-07-01,JP Morgan,CitiBank London,23518,13365,10153
2011-08-01,JP Morgan,CitiBank London,25479,56675,-31196
2011-09-01,JP Morgan,CitiBank London,37263,93532,-56269
2011-10-01,JP Morgan,CitiBank London,31528,41567,-10039
2011-11-01,JP Morgan,CitiBank London,36212,41961,-5749
2011-12-01,JP Morgan,CitiBank London,39597,98175,-58578
2012-01-01,JP Morgan,CitiBank London,38583,12281,26302
2012-02-01,JP Morgan,CitiBank London,38321,42818,-4497
2012-03-01,JP Morgan,CitiBank London,32167,24761,7406
2012-04-01,JP Morgan,CitiBank London,38285,78382,-40097
2012-05-01,JP Morgan,CitiBank London,39516,61922,-22406
2012-06-01,JP Morgan,CitiBank London,34417,89542,-55125
2012-07-01,JP Morgan,CitiBank London,44961,32651,12310
2012-08-01,JP Morgan,CitiBank London,45619,87935,-42316
2012-09-01,JP Morgan,CitiBank London,47522,28799,18723
2012-10-01,JP Morgan,CitiBank London,42555,76493,-33938
2012-11-01,JP Morgan,CitiBank London,44335,68479,-24144
2012-12-01,JP Morgan,CitiBank London,45722,77718,-31996
2013-01-01,JP Morgan,CitiBank London,48697,97916,-49219
2013-02-01,JP Morgan,CitiBank London,49486,89447,-39961
2013-03-01,JP Morgan,CitiBank London,48978,35562,13416
2013-04-01,JP Morgan,CitiBank London,49326,71593,-22267
2013-05-01,JP Morgan,CitiBank London,57917,16355,41562
2013-06-01,JP Morgan,CitiBank London,54488,71459,-16971
2013-07-01,JP Morgan,CitiBank London,54427,25813,28614
2013-08-01,JP Morgan,CitiBank London,57718,69594,-11876
2013-09-01,JP Morgan,CitiBank London,52433,53548,-1115
2013-10-01,JP Morgan,CitiBank London,57314,53745,3569
2013-11-01,JP Morgan,CitiBank London,55193,74374,-19181
2013-12-01,JP Morgan,CitiBank London,58737,56132,2605
2014-01-01,JP Morgan,CitiBank London,53142,56177,-3035
2014-02-01,JP Morgan,CitiBank London,56688,48273,8415
2014-03-01,JP Morgan,CitiBank London,68224,48936,19288
2014-04-01,JP Morgan,CitiBank London,65967,95276,-29309
2014-05-01,JP Morgan,CitiBank London,62478,64818,-2340
2014-06-01,JP Morgan,CitiBank London,63163,31553,31610
2014-07-01,JP Morgan,CitiBank London,63175,22837,40338
2014-08-01,JP Morgan,CitiBank London,69639,76377,-6738
2014-09-01,JP Morgan,CitiBank London,65688,78437,-12749
2014-10-01,JP Morgan,CitiBank London,64599,68364,-3765
2014-11-01,JP Morgan,CitiBank London,64146,19235,44911
2014-12-01,JP Morgan,CitiBank London,63888,76692,-12804
2015-01-01,JP Morgan,CitiBank London,71949,63344,8605
2015-02-01,JP Morgan,CitiBank London,75682,55427,20255
2015-03-01,JP Morgan,CitiBank London,76377,85252,-8875
2015-04-01,JP Morgan,CitiBank London,73911,22788,51123
2015-05-01,JP Morgan,CitiBank London,77687,59278,18409
2015-06-01,JP Morgan,CitiBank London,78446,81992,-3546
2015-07-01,JP Morgan,CitiBank London,79969,93264,-13295
2015-08-01,JP Morgan,CitiBank London,78962,76883,2079
2015-09-01,JP Morgan,CitiBank London,71699,14647,57052
2015-10-01,JP Morgan,CitiBank London,75797,26497,49300
2015-11-01,JP Morgan,CitiBank London,82228,28595,53633
2015-12-01,JP Morgan,CitiBank London,88844,11121,77723
2016-01-01,JP Morgan,CitiBank London,89531,24364,65167
2016-02-01,JP Morgan,CitiBank London,82758,79991,2767
2016-03-01,JP Morgan,CitiBank London,86842,34594,52248
2016-04-01,JP Morgan,CitiBank London,83943,18967,64976
2016-05-01,JP Morgan,CitiBank London,81348,69489,11859
2016-06-01,JP Morgan,CitiBank London,83783,83843,-60
2016-07-01,JP Morgan,CitiBank London,88694,96183,-7489
2016-08-01,JP Morgan,CitiBank London,85645,57248,28397
2016-09-01,JP Morgan,CitiBank London,99725,92888,6837
2016-10-01,JP Morgan,CitiBank London,97831,37367,60464
2016-11-01,JP Morgan,CitiBank London,93815,32315,61500
2016-12-01,JP Morgan,CitiBank London,97695,51939,45756
2017-01-01,JP Morgan,CitiBank London,96585,66477,30108
2017-02-01,JP Morgan,CitiBank London,95225,51371,43854
2017-03-01,JP Morgan,CitiBank London,93792,89452,4340
2017-04-01,JP Morgan,CitiBank London,96814,48751,48063
2017-05-01,JP Morgan,CitiBank London,97535,57152,40383
2017-06-01,JP Morgan,CitiBank London,91759,83583,8176
2017-07-01,JP Morgan,CitiBank London,103462,17787,85675
2017-08-01,JP Morgan,CitiBank London,109969,44383,65586
2017-09-01,JP Morgan,CitiBank London,101859,79983,21876
2017-10-01,JP Morgan,CitiBank London,103689,72559,31130
2017-11-01,JP Morgan,CitiBank London,108588,63887,44701
2017-12-01,JP Morgan,CitiBank London,104742,94217,10525
2018-01-01,JP Morgan,CitiBank London,106348,64779,41569
2018-02-01,JP Morgan,CitiBank London,108522,51799,56723
2018-03-01,JP Morgan,CitiBank London,104532,69627,34905
2018-04-01,JP Morgan,CitiBank London,106893,92547,14346
2010-01-01,JP Morgan,CitiBank Pune,15987,24828,-8841
2010-02-01,JP Morgan,CitiBank Pune,13157,86149,-72992
2010-03-01,JP Morgan,CitiBank Pune,15877,72489,-56612
2010-04-01,JP Morgan,CitiBank Pune,12452,57715,-45263
2010-05-01,JP Morgan,CitiBank Pune,19543,12946,6597
2010-06-01,JP Morgan,CitiBank Pune,17893,67314,-49421
2010-07-01,JP Morgan,CitiBank Pune,11969,53869,-41900
2010-08-01,JP Morgan,CitiBank Pune,16926,68111,-51185
2010-09-01,JP Morgan,CitiBank Pune,12787,76844,-64057
2010-10-01,JP Morgan,CitiBank Pune,11625,72343,-60718
2010-11-01,JP Morgan,CitiBank Pune,23337,93899,-70562
2010-12-01,JP Morgan,CitiBank Pune,26366,41584,-15218
2011-01-01,JP Morgan,CitiBank Pune,28159,33699,-5540
2011-02-01,JP Morgan,CitiBank Pune,24113,84678,-60565
2011-03-01,JP Morgan,CitiBank Pune,23197,52524,-29327
2011-04-01,JP Morgan,CitiBank Pune,21556,94689,-73133
2011-05-01,JP Morgan,CitiBank Pune,29868,87319,-57451
2011-06-01,JP Morgan,CitiBank Pune,25441,24264,1177
2011-07-01,JP Morgan,CitiBank Pune,27133,53292,-26159
2011-08-01,JP Morgan,CitiBank Pune,25233,83753,-58520
2011-09-01,JP Morgan,CitiBank Pune,35796,86445,-50649
2011-10-01,JP Morgan,CitiBank Pune,37777,53484,-15707
2011-11-01,JP Morgan,CitiBank Pune,37658,62635,-24977
2011-12-01,JP Morgan,CitiBank Pune,32987,26216,6771
2012-01-01,JP Morgan,CitiBank Pune,39194,15259,23935
2012-02-01,JP Morgan,CitiBank Pune,39159,57747,-18588
2012-03-01,JP Morgan,CitiBank Pune,38865,61362,-22497
2012-04-01,JP Morgan,CitiBank Pune,39726,36549,3177
2012-05-01,JP Morgan,CitiBank Pune,39719,88519,-48800
2012-06-01,JP Morgan,CitiBank Pune,39322,46843,-7521
2012-07-01,JP Morgan,CitiBank Pune,42987,98498,-55511
2012-08-01,JP Morgan,CitiBank Pune,42875,54616,-11741
2012-09-01,JP Morgan,CitiBank Pune,43632,37424,6208
2012-10-01,JP Morgan,CitiBank Pune,42932,39958,2974
2012-11-01,JP Morgan,CitiBank Pune,42848,82587,-39739
2012-12-01,JP Morgan,CitiBank Pune,49296,43648,5648
2013-01-01,JP Morgan,CitiBank Pune,43986,25326,18660
2013-02-01,JP Morgan,CitiBank Pune,46995,35387,11608
2013-03-01,JP Morgan,CitiBank Pune,41956,85394,-43438
2013-04-01,JP Morgan,CitiBank Pune,46291,79146,-32855
2013-05-01,JP Morgan,CitiBank Pune,55696,32574,23122
2013-06-01,JP Morgan,CitiBank Pune,54375,65835,-11460
2013-07-01,JP Morgan,CitiBank Pune,59938,57622,2316
2013-08-01,JP Morgan,CitiBank Pune,54235,79915,-25680
2013-09-01,JP Morgan,CitiBank Pune,52552,83819,-31267
2013-10-01,JP Morgan,CitiBank Pune,58882,97591,-38709
2013-11-01,JP Morgan,CitiBank Pune,56477,18795,37682
2013-12-01,JP Morgan,CitiBank Pune,55114,23473,31641
2014-01-01,JP Morgan,CitiBank Pune,55799,37637,18162
2014-02-01,JP Morgan,CitiBank Pune,54579,72151,-17572
2014-03-01,JP Morgan,CitiBank Pune,69719,83367,-13648
2014-04-01,JP Morgan,CitiBank Pune,61441,31578,29863
2014-05-01,JP Morgan,CitiBank Pune,64739,76451,-11712
2014-06-01,JP Morgan,CitiBank Pune,62321,34752,27569
2014-07-01,JP Morgan,CitiBank Pune,62861,88255,-25394
2014-08-01,JP Morgan,CitiBank Pune,65129,23296,41833
2014-09-01,JP Morgan,CitiBank Pune,67987,13817,54170
2014-10-01,JP Morgan,CitiBank Pune,65122,69541,-4419
2014-11-01,JP Morgan,CitiBank Pune,61275,92251,-30976
2014-12-01,JP Morgan,CitiBank Pune,62326,76417,-14091
2015-01-01,JP Morgan,CitiBank Pune,75368,39226,36142
2015-02-01,JP Morgan,CitiBank Pune,74948,17772,57176
2015-03-01,JP Morgan,CitiBank Pune,76155,48917,27238
2015-04-01,JP Morgan,CitiBank Pune,76239,45626,30613
2015-05-01,JP Morgan,CitiBank Pune,78844,81224,-2380
2015-06-01,JP Morgan,CitiBank Pune,77119,21985,55134
2015-07-01,JP Morgan,CitiBank Pune,79742,99651,-19909
2015-08-01,JP Morgan,CitiBank Pune,78959,51739,27220
2015-09-01,JP Morgan,CitiBank Pune,77751,64275,13476
2015-10-01,JP Morgan,CitiBank Pune,74968,29278,45690
2015-11-01,JP Morgan,CitiBank Pune,84517,84333,184
2015-12-01,JP Morgan,CitiBank Pune,87654,43154,44500
2016-01-01,JP Morgan,CitiBank Pune,86757,32272,54485
2016-02-01,JP Morgan,CitiBank Pune,86123,69283,16840
2016-03-01,JP Morgan,CitiBank Pune,88611,75211,13400
2016-04-01,JP Morgan,CitiBank Pune,86163,79137,7026
2016-05-01,JP Morgan,CitiBank Pune,89438,35733,53705
2016-06-01,JP Morgan,CitiBank Pune,89598,89939,-341
2016-07-01,JP Morgan,CitiBank Pune,88589,15937,72652
2016-08-01,JP Morgan,CitiBank Pune,81811,91263,-9452
2016-09-01,JP Morgan,CitiBank Pune,96632,78722,17910
2016-10-01,JP Morgan,CitiBank Pune,93451,63849,29602
2016-11-01,JP Morgan,CitiBank Pune,91949,99389,-7440
2016-12-01,JP Morgan,CitiBank Pune,91216,33181,58035
2017-01-01,JP Morgan,CitiBank Pune,99583,66944,32639
2017-02-01,JP Morgan,CitiBank Pune,91444,88188,3256
2017-03-01,JP Morgan,CitiBank Pune,94241,19958,74283
2017-04-01,JP Morgan,CitiBank Pune,93943,63448,30495
2017-05-01,JP Morgan,CitiBank Pune,96538,33165,63373
2017-06-01,JP Morgan,CitiBank Pune,99975,41317,58658
2017-07-01,JP Morgan,CitiBank Pune,109261,33426,75835
2017-08-01,JP Morgan,CitiBank Pune,102387,44843,57544
2017-09-01,JP Morgan,CitiBank Pune,104947,96384,8563
2017-10-01,JP Morgan,CitiBank Pune,105912,42824,63088
2017-11-01,JP Morgan,CitiBank Pune,104534,16619,87915
2017-12-01,JP Morgan,CitiBank Pune,106118,67522,38596
2018-01-01,JP Morgan,CitiBank Pune,105261,17525,87736
2018-02-01,JP Morgan,CitiBank Pune,106236,75783,30453
2018-03-01,JP Morgan,CitiBank Pune,104615,33657,70958
2018-04-01,JP Morgan,CitiBank Pune,106478,55696,50782
2010-01-01,JP Morgan,CitiBank Singapore,12443,44547,-32104
2010-02-01,JP Morgan,CitiBank Singapore,19522,26776,-7254
2010-03-01,JP Morgan,CitiBank Singapore,12687,12471,216
2010-04-01,JP Morgan,CitiBank Singapore,17649,17627,22
2010-05-01,JP Morgan,CitiBank Singapore,16698,23626,-6928
2010-06-01,JP Morgan,CitiBank Singapore,12166,89439,-77273
2010-07-01,JP Morgan,CitiBank Singapore,14222,27988,-13766
2010-08-01,JP Morgan,CitiBank Singapore,12259,15537,-3278
2010-09-01,JP Morgan,CitiBank Singapore,11155,53687,-42532
2010-10-01,JP Morgan,CitiBank Singapore,15125,37193,-22068
2010-11-01,JP Morgan,CitiBank Singapore,26219,65436,-39217
2010-12-01,JP Morgan,CitiBank Singapore,27932,25195,2737
2011-01-01,JP Morgan,CitiBank Singapore,26379,88515,-62136
2011-02-01,JP Morgan,CitiBank Singapore,23716,83176,-59460
2011-03-01,JP Morgan,CitiBank Singapore,28113,67559,-39446
2011-04-01,JP Morgan,CitiBank Singapore,24366,66564,-42198
2011-05-01,JP Morgan,CitiBank Singapore,29258,77321,-48063
2011-06-01,JP Morgan,CitiBank Singapore,25426,97858,-72432
2011-07-01,JP Morgan,CitiBank Singapore,29372,49286,-19914
2011-08-01,JP Morgan,CitiBank Singapore,24899,39742,-14843
2011-09-01,JP Morgan,CitiBank Singapore,39156,56656,-17500
2011-10-01,JP Morgan,CitiBank Singapore,31649,16819,14830
2011-11-01,JP Morgan,CitiBank Singapore,34546,83188,-48642
2011-12-01,JP Morgan,CitiBank Singapore,37144,88412,-51268
2012-01-01,JP Morgan,CitiBank Singapore,33312,23877,9435
2012-02-01,JP Morgan,CitiBank Singapore,32232,91164,-58932
2012-03-01,JP Morgan,CitiBank Singapore,38139,26595,11544
2012-04-01,JP Morgan,CitiBank Singapore,38979,46813,-7834
2012-05-01,JP Morgan,CitiBank Singapore,38595,59846,-21251
2012-06-01,JP Morgan,CitiBank Singapore,32226,94124,-61898
2012-07-01,JP Morgan,CitiBank Singapore,44462,46821,-2359
2012-08-01,JP Morgan,CitiBank Singapore,46616,87344,-40728
2012-09-01,JP Morgan,CitiBank Singapore,45733,16688,29045
2012-10-01,JP Morgan,CitiBank Singapore,42379,41448,931
2012-11-01,JP Morgan,CitiBank Singapore,46928,28871,18057
2012-12-01,JP Morgan,CitiBank Singapore,43997,94567,-50570
2013-01-01,JP Morgan,CitiBank Singapore,43337,67938,-24601
2013-02-01,JP Morgan,CitiBank Singapore,46225,65888,-19663
2013-03-01,JP Morgan,CitiBank Singapore,44641,34895,9746
2013-04-01,JP Morgan,CitiBank Singapore,43798,55143,-11345
2013-05-01,JP Morgan,CitiBank Singapore,53245,56772,-3527
2013-06-01,JP Morgan,CitiBank Singapore,51854,77932,-26078
2013-07-01,JP Morgan,CitiBank Singapore,58326,43625,14701
2013-08-01,JP Morgan,CitiBank Singapore,54584,89184,-34600
2013-09-01,JP Morgan,CitiBank Singapore,56673,24269,32404
2013-10-01,JP Morgan,CitiBank Singapore,52449,66322,-13873
2013-11-01,JP Morgan,CitiBank Singapore,51418,59556,-8138
2013-12-01,JP Morgan,CitiBank Singapore,54323,99385,-45062
2014-01-01,JP Morgan,CitiBank Singapore,59357,82551,-23194
2014-02-01,JP Morgan,CitiBank Singapore,58614,54842,3772
2014-03-01,JP Morgan,CitiBank Singapore,61931,37159,24772
2014-04-01,JP Morgan,CitiBank Singapore,63978,64617,-639
2014-05-01,JP Morgan,CitiBank Singapore,69875,72394,-2519
2014-06-01,JP Morgan,CitiBank Singapore,63114,66435,-3321
2014-07-01,JP Morgan,CitiBank Singapore,62994,66239,-3245
2014-08-01,JP Morgan,CitiBank Singapore,69674,48861,20813
2014-09-01,JP Morgan,CitiBank Singapore,68418,42858,25560
2014-10-01,JP Morgan,CitiBank Singapore,61659,46212,15447
2014-11-01,JP Morgan,CitiBank Singapore,64926,21511,43415
2014-12-01,JP Morgan,CitiBank Singapore,61472,91571,-30099
2015-01-01,JP Morgan,CitiBank Singapore,72619,74944,-2325
2015-02-01,JP Morgan,CitiBank Singapore,72742,22572,50170
2015-03-01,JP Morgan,CitiBank Singapore,75688,61873,13815
2015-04-01,JP Morgan,CitiBank Singapore,72997,91774,-18777
2015-05-01,JP Morgan,CitiBank Singapore,77442,29557,47885
2015-06-01,JP Morgan,CitiBank Singapore,75986,48531,27455
2015-07-01,JP Morgan,CitiBank Singapore,76573,59452,17121
2015-08-01,JP Morgan,CitiBank Singapore,75259,55197,20062
2015-09-01,JP Morgan,CitiBank Singapore,75138,63969,11169
2015-10-01,JP Morgan,CitiBank Singapore,76283,69212,7071
2015-11-01,JP Morgan,CitiBank Singapore,81894,76896,4998
2015-12-01,JP Morgan,CitiBank Singapore,84757,31275,53482
2016-01-01,JP Morgan,CitiBank Singapore,83238,45373,37865
2016-02-01,JP Morgan,CitiBank Singapore,83778,39354,44424
2016-03-01,JP Morgan,CitiBank Singapore,86477,67814,18663
2016-04-01,JP Morgan,CitiBank Singapore,87241,88535,-1294
2016-05-01,JP Morgan,CitiBank Singapore,84336,43231,41105
2016-06-01,JP Morgan,CitiBank Singapore,81772,28467,53305
2016-07-01,JP Morgan,CitiBank Singapore,85649,82964,2685
2016-08-01,JP Morgan,CitiBank Singapore,86694,42921,43773
2016-09-01,JP Morgan,CitiBank Singapore,93897,49916,43981
2016-10-01,JP Morgan,CitiBank Singapore,97345,72914,24431
2016-11-01,JP Morgan,CitiBank Singapore,94663,82995,11668
2016-12-01,JP Morgan,CitiBank Singapore,92673,41736,50937
2017-01-01,JP Morgan,CitiBank Singapore,93986,38696,55290
2017-02-01,JP Morgan,CitiBank Singapore,98167,93722,4445
2017-03-01,JP Morgan,CitiBank Singapore,93572,38585,54987
2017-04-01,JP Morgan,CitiBank Singapore,98615,88314,10301
2017-05-01,JP Morgan,CitiBank Singapore,99892,52252,47640
2017-06-01,JP Morgan,CitiBank Singapore,98387,17233,81154
2017-07-01,JP Morgan,CitiBank Singapore,104851,96155,8696
2017-08-01,JP Morgan,CitiBank Singapore,109388,93458,15930
2017-09-01,JP Morgan,CitiBank Singapore,104634,76654,27980
2017-10-01,JP Morgan,CitiBank Singapore,106163,59265,46898
2017-11-01,JP Morgan,CitiBank Singapore,102888,15171,87717
2017-12-01,JP Morgan,CitiBank Singapore,107331,92344,14987
2018-01-01,JP Morgan,CitiBank Singapore,109366,42526,66840
2018-02-01,JP Morgan,CitiBank Singapore,101982,72533,29449
2018-03-01,JP Morgan,CitiBank Singapore,105485,74128,31357
2018-04-01,JP Morgan,CitiBank Singapore,104893,17173,87720
2010-01-01,JP Morgan,CitiBank HongKong,12295,39152,-26857
2010-02-01,JP Morgan,CitiBank HongKong,15562,19658,-4096
2010-03-01,JP Morgan,CitiBank HongKong,16799,79693,-62894
2010-04-01,JP Morgan,CitiBank HongKong,15849,48794,-32945
2010-05-01,JP Morgan,CitiBank HongKong,14995,49263,-34268
2010-06-01,JP Morgan,CitiBank HongKong,15823,73767,-57944
2010-07-01,JP Morgan,CitiBank HongKong,15471,84967,-69496
2010-08-01,JP Morgan,CitiBank HongKong,19398,51226,-31828
2010-09-01,JP Morgan,CitiBank HongKong,17993,92196,-74203
2010-10-01,JP Morgan,CitiBank HongKong,19767,77192,-57425
2010-11-01,JP Morgan,CitiBank HongKong,26447,52653,-26206
2010-12-01,JP Morgan,CitiBank HongKong,25818,83411,-57593
2011-01-01,JP Morgan,CitiBank HongKong,23379,46694,-23315
2011-02-01,JP Morgan,CitiBank HongKong,21469,94131,-72662
2011-03-01,JP Morgan,CitiBank HongKong,28581,12756,15825
2011-04-01,JP Morgan,CitiBank HongKong,22692,31293,-8601
2011-05-01,JP Morgan,CitiBank HongKong,23747,47354,-23607
2011-06-01,JP Morgan,CitiBank HongKong,25586,96333,-70747
2011-07-01,JP Morgan,CitiBank HongKong,26252,75768,-49516
2011-08-01,JP Morgan,CitiBank HongKong,25664,42638,-16974
2011-09-01,JP Morgan,CitiBank HongKong,38577,83321,-44744
2011-10-01,JP Morgan,CitiBank HongKong,33238,47877,-14639
2011-11-01,JP Morgan,CitiBank HongKong,33583,16946,16637
2011-12-01,JP Morgan,CitiBank HongKong,33925,73944,-40019
2012-01-01,JP Morgan,CitiBank HongKong,39857,95611,-55754
2012-02-01,JP Morgan,CitiBank HongKong,38852,37374,1478
2012-03-01,JP Morgan,CitiBank HongKong,31945,85345,-53400
2012-04-01,JP Morgan,CitiBank HongKong,38125,75742,-37617
2012-05-01,JP Morgan,CitiBank HongKong,36776,64884,-28108
2012-06-01,JP Morgan,CitiBank HongKong,31391,78643,-47252
2012-07-01,JP Morgan,CitiBank HongKong,46771,44152,2619
2012-08-01,JP Morgan,CitiBank HongKong,43694,65599,-21905
2012-09-01,JP Morgan,CitiBank HongKong,48857,41747,7110
2012-10-01,JP Morgan,CitiBank HongKong,49249,19629,29620
2012-11-01,JP Morgan,CitiBank HongKong,49251,45769,3482
2012-12-01,JP Morgan,CitiBank HongKong,42815,65519,-22704
2013-01-01,JP Morgan,CitiBank HongKong,46752,81845,-35093
2013-02-01,JP Morgan,CitiBank HongKong,45346,92297,-46951
2013-03-01,JP Morgan,CitiBank HongKong,48135,87161,-39026
2013-04-01,JP Morgan,CitiBank HongKong,42916,82479,-39563
2013-05-01,JP Morgan,CitiBank HongKong,52999,59898,-6899
2013-06-01,JP Morgan,CitiBank HongKong,53743,97671,-43928
2013-07-01,JP Morgan,CitiBank HongKong,58379,66397,-8018
2013-08-01,JP Morgan,CitiBank HongKong,54687,17382,37305
2013-09-01,JP Morgan,CitiBank HongKong,54667,33447,21220
2013-10-01,JP Morgan,CitiBank HongKong,59131,78154,-19023
2013-11-01,JP Morgan,CitiBank HongKong,54545,57842,-3297
2013-12-01,JP Morgan,CitiBank HongKong,51181,41344,9837
2014-01-01,JP Morgan,CitiBank HongKong,56599,48384,8215
2014-02-01,JP Morgan,CitiBank HongKong,51197,59453,-8256
2014-03-01,JP Morgan,CitiBank HongKong,66615,77231,-10616
2014-04-01,JP Morgan,CitiBank HongKong,64638,86624,-21986
2014-05-01,JP Morgan,CitiBank HongKong,65415,55232,10183
2014-06-01,JP Morgan,CitiBank HongKong,66372,52552,13820
2014-07-01,JP Morgan,CitiBank HongKong,67136,51133,16003
2014-08-01,JP Morgan,CitiBank HongKong,67728,53875,13853
2014-09-01,JP Morgan,CitiBank HongKong,61932,23995,37937
2014-10-01,JP Morgan,CitiBank HongKong,62834,32546,30288
2014-11-01,JP Morgan,CitiBank HongKong,67847,91843,-23996
2014-12-01,JP Morgan,CitiBank HongKong,63884,11154,52730
2015-01-01,JP Morgan,CitiBank HongKong,75357,12399,62958
2015-02-01,JP Morgan,CitiBank HongKong,74838,92795,-17957
2015-03-01,JP Morgan,CitiBank HongKong,74928,46569,28359
2015-04-01,JP Morgan,CitiBank HongKong,76385,79212,-2827
2015-05-01,JP Morgan,CitiBank HongKong,73365,26765,46600
2015-06-01,JP Morgan,CitiBank HongKong,77424,43695,33729
2015-07-01,JP Morgan,CitiBank HongKong,72326,66882,5444
2015-08-01,JP Morgan,CitiBank HongKong,74167,83353,-9186
2015-09-01,JP Morgan,CitiBank HongKong,74559,86691,-12132
2015-10-01,JP Morgan,CitiBank HongKong,73348,18283,55065
2015-11-01,JP Morgan,CitiBank HongKong,89129,57298,31831
2015-12-01,JP Morgan,CitiBank HongKong,82911,33694,49217
2016-01-01,JP Morgan,CitiBank HongKong,83873,46247,37626
2016-02-01,JP Morgan,CitiBank HongKong,88247,31415,56832
2016-03-01,JP Morgan,CitiBank HongKong,81542,39234,42308
2016-04-01,JP Morgan,CitiBank HongKong,83484,73844,9640
2016-05-01,JP Morgan,CitiBank HongKong,88328,57188,31140
2016-06-01,JP Morgan,CitiBank HongKong,87274,21258,66016
2016-07-01,JP Morgan,CitiBank HongKong,82317,97533,-15216
2016-08-01,JP Morgan,CitiBank HongKong,84996,17824,67172
2016-09-01,JP Morgan,CitiBank HongKong,96311,78899,17412
2016-10-01,JP Morgan,CitiBank HongKong,92452,77748,14704
2016-11-01,JP Morgan,CitiBank HongKong,98737,59863,38874
2016-12-01,JP Morgan,CitiBank HongKong,91759,77144,14615
2017-01-01,JP Morgan,CitiBank HongKong,99398,45925,53473
2017-02-01,JP Morgan,CitiBank HongKong,91735,22612,69123
2017-03-01,JP Morgan,CitiBank HongKong,99678,75422,24256
2017-04-01,JP Morgan,CitiBank HongKong,99891,77943,21948
2017-05-01,JP Morgan,CitiBank HongKong,96799,23737,73062
2017-06-01,JP Morgan,CitiBank HongKong,99562,91436,8126
2017-07-01,JP Morgan,CitiBank HongKong,104657,52549,52108
2017-08-01,JP Morgan,CitiBank HongKong,101794,66762,35032
2017-09-01,JP Morgan,CitiBank HongKong,102275,23311,78964
2017-10-01,JP Morgan,CitiBank HongKong,104179,69339,34840
2017-11-01,JP Morgan,CitiBank HongKong,109721,54142,55579
2017-12-01,JP Morgan,CitiBank HongKong,104825,52241,52584
2018-01-01,JP Morgan,CitiBank HongKong,106198,65447,40751
2018-02-01,JP Morgan,CitiBank HongKong,107939,97496,10443
2018-03-01,JP Morgan,CitiBank HongKong,102664,76282,26382
2018-04-01,JP Morgan,CitiBank HongKong,107411,88718,18693
2010-01-01,Bank of America,CitiBank New York,19363,32741,-13378
2010-02-01,Bank of America,CitiBank New York,19332,98445,-79113
2010-03-01,Bank of America,CitiBank New York,19565,11788,7777
2010-04-01,Bank of America,CitiBank New York,15124,76591,-61467
2010-05-01,Bank of America,CitiBank New York,15347,46746,-31399
2010-06-01,Bank of America,CitiBank New York,11928,49166,-37238
2010-07-01,Bank of America,CitiBank New York,14576,88855,-74279
2010-08-01,Bank of America,CitiBank New York,18255,92497,-74242
2010-09-01,Bank of America,CitiBank New York,16179,69778,-53599
2010-10-01,Bank of America,CitiBank New York,12881,38942,-26061
2010-11-01,Bank of America,CitiBank New York,23912,94945,-71033
2010-12-01,Bank of America,CitiBank New York,29632,62481,-32849
2011-01-01,Bank of America,CitiBank New York,27771,34274,-6503
2011-02-01,Bank of America,CitiBank New York,29975,73546,-43571
2011-03-01,Bank of America,CitiBank New York,27437,98319,-70882
2011-04-01,Bank of America,CitiBank New York,29158,68485,-39327
2011-05-01,Bank of America,CitiBank New York,22642,82563,-59921
2011-06-01,Bank of America,CitiBank New York,28617,61349,-32732
2011-07-01,Bank of America,CitiBank New York,26952,87119,-60167
2011-08-01,Bank of America,CitiBank New York,26899,49891,-22992
2011-09-01,Bank of America,CitiBank New York,38777,58891,-20114
2011-10-01,Bank of America,CitiBank New York,35639,27558,8081
2011-11-01,Bank of America,CitiBank New York,31876,64116,-32240
2011-12-01,Bank of America,CitiBank New York,38273,64965,-26692
2012-01-01,Bank of America,CitiBank New York,37593,56789,-19196
2012-02-01,Bank of America,CitiBank New York,33474,48266,-14792
2012-03-01,Bank of America,CitiBank New York,36681,97124,-60443
2012-04-01,Bank of America,CitiBank New York,34216,36647,-2431
2012-05-01,Bank of America,CitiBank New York,35697,42212,-6515
2012-06-01,Bank of America,CitiBank New York,31288,38264,-6976
2012-07-01,Bank of America,CitiBank New York,41511,76461,-34950
2012-08-01,Bank of America,CitiBank New York,43388,74116,-30728
2012-09-01,Bank of America,CitiBank New York,46495,73913,-27418
2012-10-01,Bank of America,CitiBank New York,48313,48441,-128
2012-11-01,Bank of America,CitiBank New York,42698,48326,-5628
2012-12-01,Bank of America,CitiBank New York,47492,85673,-38181
2013-01-01,Bank of America,CitiBank New York,46899,88979,-42080
2013-02-01,Bank of America,CitiBank New York,43425,66845,-23420
2013-03-01,Bank of America,CitiBank New York,48871,12243,36628
2013-04-01,Bank of America,CitiBank New York,49277,59573,-10296
2013-05-01,Bank of America,CitiBank New York,51457,95146,-43689
2013-06-01,Bank of America,CitiBank New York,57793,65184,-7391
2013-07-01,Bank of America,CitiBank New York,51789,73974,-22185
2013-08-01,Bank of America,CitiBank New York,51778,57697,-5919
2013-09-01,Bank of America,CitiBank New York,54446,85171,-30725
2013-10-01,Bank of America,CitiBank New York,56844,12824,44020
2013-11-01,Bank of America,CitiBank New York,54766,22431,32335
2013-12-01,Bank of America,CitiBank New York,54897,62136,-7239
2014-01-01,Bank of America,CitiBank New York,53522,46258,7264
2014-02-01,Bank of America,CitiBank New York,51947,39841,12106
2014-03-01,Bank of America,CitiBank New York,65311,35985,29326
2014-04-01,Bank of America,CitiBank New York,65371,24373,40998
2014-05-01,Bank of America,CitiBank New York,66474,89483,-23009
2014-06-01,Bank of America,CitiBank New York,66553,58681,7872
2014-07-01,Bank of America,CitiBank New York,66649,15186,51463
2014-08-01,Bank of America,CitiBank New York,61931,65672,-3741
2014-09-01,Bank of America,CitiBank New York,66734,67811,-1077
2014-10-01,Bank of America,CitiBank New York,62413,22652,39761
2014-11-01,Bank of America,CitiBank New York,65783,27472,38311
2014-12-01,Bank of America,CitiBank New York,68527,44194,24333
2015-01-01,Bank of America,CitiBank New York,77652,92931,-15279
2015-02-01,Bank of America,CitiBank New York,71418,29883,41535
2015-03-01,Bank of America,CitiBank New York,76457,62134,14323
2015-04-01,Bank of America,CitiBank New York,78593,94715,-16122
2015-05-01,Bank of America,CitiBank New York,75596,67562,8034
2015-06-01,Bank of America,CitiBank New York,76878,39551,37327
2015-07-01,Bank of America,CitiBank New York,77528,77559,-31
2015-08-01,Bank of America,CitiBank New York,74914,41813,33101
2015-09-01,Bank of America,CitiBank New York,76713,62362,14351
2015-10-01,Bank of America,CitiBank New York,78964,16436,62528
2015-11-01,Bank of America,CitiBank New York,86672,68618,18054
2015-12-01,Bank of America,CitiBank New York,81595,42618,38977
2016-01-01,Bank of America,CitiBank New York,83645,94953,-11308
2016-02-01,Bank of America,CitiBank New York,88636,84664,3972
2016-03-01,Bank of America,CitiBank New York,81228,86535,-5307
2016-04-01,Bank of America,CitiBank New York,83636,37981,45655
2016-05-01,Bank of America,CitiBank New York,86433,47843,38590
2016-06-01,Bank of America,CitiBank New York,89926,72466,17460
2016-07-01,Bank of America,CitiBank New York,82497,58537,23960
2016-08-01,Bank of America,CitiBank New York,84343,75556,8787
2016-09-01,Bank of America,CitiBank New York,92463,56949,35514
2016-10-01,Bank of America,CitiBank New York,95564,37966,57598
2016-11-01,Bank of America,CitiBank New York,92478,13933,78545
2016-12-01,Bank of America,CitiBank New York,98922,69542,29380
2017-01-01,Bank of America,CitiBank New York,97945,48185,49760
2017-02-01,Bank of America,CitiBank New York,98184,54462,43722
2017-03-01,Bank of America,CitiBank New York,91978,36616,55362
2017-04-01,Bank of America,CitiBank New York,97257,28591,68666
2017-05-01,Bank of America,CitiBank New York,94726,49724,45002
2017-06-01,Bank of America,CitiBank New York,91628,39292,52336
2017-07-01,Bank of America,CitiBank New York,109664,96444,13220
2017-08-01,Bank of America,CitiBank New York,104357,48947,55410
2017-09-01,Bank of America,CitiBank New York,107758,58288,49470
2017-10-01,Bank of America,CitiBank New York,105389,16688,88701
2017-11-01,Bank of America,CitiBank New York,104113,71612,32501
2017-12-01,Bank of America,CitiBank New York,109968,21135,88833
2018-01-01,Bank of America,CitiBank New York,104655,92596,12059
2018-02-01,Bank of America,CitiBank New York,106325,88477,17848
2018-03-01,Bank of America,CitiBank New York,107491,23317,84174
2018-04-01,Bank of America,CitiBank New York,104646,65374,39272
2010-01-01,Bank of America,CitiBank London,13647,89536,-75889
2010-02-01,Bank of America,CitiBank London,11553,55393,-43840
2010-03-01,Bank of America,CitiBank London,13326,38621,-25295
2010-04-01,Bank of America,CitiBank London,17917,85286,-67369
2010-05-01,Bank of America,CitiBank London,11898,76337,-64439
2010-06-01,Bank of America,CitiBank London,17537,45182,-27645
2010-07-01,Bank of America,CitiBank London,17642,63874,-46232
2010-08-01,Bank of America,CitiBank London,18758,13274,5484
2010-09-01,Bank of America,CitiBank London,15763,83745,-67982
2010-10-01,Bank of America,CitiBank London,16853,37238,-20385
2010-11-01,Bank of America,CitiBank London,24682,32333,-7651
2010-12-01,Bank of America,CitiBank London,29392,81941,-52549
2011-01-01,Bank of America,CitiBank London,27373,91522,-64149
2011-02-01,Bank of America,CitiBank London,26367,72384,-46017
2011-03-01,Bank of America,CitiBank London,29289,27276,2013
2011-04-01,Bank of America,CitiBank London,25851,67517,-41666
2011-05-01,Bank of America,CitiBank London,27876,41613,-13737
2011-06-01,Bank of America,CitiBank London,23719,55291,-31572
2011-07-01,Bank of America,CitiBank London,24318,38624,-14306
2011-08-01,Bank of America,CitiBank London,27452,15235,12217
2011-09-01,Bank of America,CitiBank London,37911,73644,-35733
2011-10-01,Bank of America,CitiBank London,38465,66371,-27906
2011-11-01,Bank of America,CitiBank London,32611,39346,-6735
2011-12-01,Bank of America,CitiBank London,37317,55433,-18116
2012-01-01,Bank of America,CitiBank London,38681,94978,-56297
2012-02-01,Bank of America,CitiBank London,34539,45845,-11306
2012-03-01,Bank of America,CitiBank London,32568,55831,-23263
2012-04-01,Bank of America,CitiBank London,35148,88818,-53670
2012-05-01,Bank of America,CitiBank London,35474,38527,-3053
2012-06-01,Bank of America,CitiBank London,32911,56417,-23506
2012-07-01,Bank of America,CitiBank London,49379,53672,-4293
2012-08-01,Bank of America,CitiBank London,45863,12472,33391
2012-09-01,Bank of America,CitiBank London,43922,28482,15440
2012-10-01,Bank of America,CitiBank London,45589,35778,9811
2012-11-01,Bank of America,CitiBank London,48544,76198,-27654
2012-12-01,Bank of America,CitiBank London,42721,12126,30595
2013-01-01,Bank of America,CitiBank London,47216,94119,-46903
2013-02-01,Bank of America,CitiBank London,47591,18996,28595
2013-03-01,Bank of America,CitiBank London,45175,55938,-10763
2013-04-01,Bank of America,CitiBank London,48128,48846,-718
2013-05-01,Bank of America,CitiBank London,53982,34467,19515
2013-06-01,Bank of America,CitiBank London,54954,79113,-24159
2013-07-01,Bank of America,CitiBank London,52983,71413,-18430
2013-08-01,Bank of America,CitiBank London,55437,33134,22303
2013-09-01,Bank of America,CitiBank London,55761,77136,-21375
2013-10-01,Bank of America,CitiBank London,54754,11259,43495
2013-11-01,Bank of America,CitiBank London,54146,12297,41849
2013-12-01,Bank of America,CitiBank London,54996,39892,15104
2014-01-01,Bank of America,CitiBank London,59912,23634,36278
2014-02-01,Bank of America,CitiBank London,52621,84677,-32056
2014-03-01,Bank of America,CitiBank London,64839,97412,-32573
2014-04-01,Bank of America,CitiBank London,67634,64662,2972
2014-05-01,Bank of America,CitiBank London,64515,47734,16781
2014-06-01,Bank of America,CitiBank London,67143,18923,48220
2014-07-01,Bank of America,CitiBank London,69675,64473,5202
2014-08-01,Bank of America,CitiBank London,69891,46151,23740
2014-09-01,Bank of America,CitiBank London,63838,76799,-12961
2014-10-01,Bank of America,CitiBank London,67699,89168,-21469
2014-11-01,Bank of America,CitiBank London,65744,42722,23022
2014-12-01,Bank of America,CitiBank London,64981,64896,85
2015-01-01,Bank of America,CitiBank London,73231,96123,-22892
2015-02-01,Bank of America,CitiBank London,72315,89188,-16873
2015-03-01,Bank of America,CitiBank London,72843,99186,-26343
2015-04-01,Bank of America,CitiBank London,73414,11464,61950
2015-05-01,Bank of America,CitiBank London,71761,86952,-15191
2015-06-01,Bank of America,CitiBank London,73962,27112,46850
2015-07-01,Bank of America,CitiBank London,75654,35889,39765
2015-08-01,Bank of America,CitiBank London,76636,46365,30271
2015-09-01,Bank of America,CitiBank London,79829,21465,58364
2015-10-01,Bank of America,CitiBank London,71415,74362,-2947
2015-11-01,Bank of America,CitiBank London,84229,56777,27452
2015-12-01,Bank of America,CitiBank London,89394,58137,31257
2016-01-01,Bank of America,CitiBank London,87845,96628,-8783
2016-02-01,Bank of America,CitiBank London,89195,82719,6476
2016-03-01,Bank of America,CitiBank London,84896,43535,41361
2016-04-01,Bank of America,CitiBank London,86799,82774,4025
2016-05-01,Bank of America,CitiBank London,89385,57487,31898
2016-06-01,Bank of America,CitiBank London,83933,53844,30089
2016-07-01,Bank of America,CitiBank London,87894,49712,38182
2016-08-01,Bank of America,CitiBank London,83924,59397,24527
2016-09-01,Bank of America,CitiBank London,92498,61333,31165
2016-10-01,Bank of America,CitiBank London,92536,41432,51104
2016-11-01,Bank of America,CitiBank London,92188,75181,17007
2016-12-01,Bank of America,CitiBank London,94777,75489,19288
2017-01-01,Bank of America,CitiBank London,99843,18751,81092
2017-02-01,Bank of America,CitiBank London,91142,83559,7583
2017-03-01,Bank of America,CitiBank London,93943,97759,-3816
2017-04-01,Bank of America,CitiBank London,96671,82839,13832
2017-05-01,Bank of America,CitiBank London,94468,16163,78305
2017-06-01,Bank of America,CitiBank London,93989,72288,21701
2017-07-01,Bank of America,CitiBank London,102973,49162,53811
2017-08-01,Bank of America,CitiBank London,104664,78547,26117
2017-09-01,Bank of America,CitiBank London,103642,83551,20091
2017-10-01,Bank of America,CitiBank London,105418,79383,26035
2017-11-01,Bank of America,CitiBank London,109517,43474,66043
2017-12-01,Bank of America,CitiBank London,102388,83783,18605
2018-01-01,Bank of America,CitiBank London,108349,29834,78515
2018-02-01,Bank of America,CitiBank London,101982,37849,64133
2018-03-01,Bank of America,CitiBank London,108392,38249,70143
2018-04-01,Bank of America,CitiBank London,104583,62669,41914
2010-01-01,Bank of America,CitiBank Pune,19891,83119,-63228
2010-02-01,Bank of America,CitiBank Pune,15363,31491,-16128
2010-03-01,Bank of America,CitiBank Pune,14144,53331,-39187
2010-04-01,Bank of America,CitiBank Pune,11652,58316,-46664
2010-05-01,Bank of America,CitiBank Pune,14711,64147,-49436
2010-06-01,Bank of America,CitiBank Pune,14717,64374,-49657
2010-07-01,Bank of America,CitiBank Pune,13452,48219,-34767
2010-08-01,Bank of America,CitiBank Pune,14929,24726,-9797
2010-09-01,Bank of America,CitiBank Pune,11634,59578,-47944
2010-10-01,Bank of America,CitiBank Pune,12644,38279,-25635
2010-11-01,Bank of America,CitiBank Pune,23851,34186,-10335
2010-12-01,Bank of America,CitiBank Pune,22586,42111,-19525
2011-01-01,Bank of America,CitiBank Pune,22237,84956,-62719
2011-02-01,Bank of America,CitiBank Pune,28337,15688,12649
2011-03-01,Bank of America,CitiBank Pune,25361,71318,-45957
2011-04-01,Bank of America,CitiBank Pune,27189,19121,8068
2011-05-01,Bank of America,CitiBank Pune,23491,65916,-42425
2011-06-01,Bank of America,CitiBank Pune,27223,62723,-35500
2011-07-01,Bank of America,CitiBank Pune,28988,14831,14157
2011-08-01,Bank of America,CitiBank Pune,28513,94117,-65604
2011-09-01,Bank of America,CitiBank Pune,37122,84486,-47364
2011-10-01,Bank of America,CitiBank Pune,33632,23629,10003
2011-11-01,Bank of America,CitiBank Pune,34568,27612,6956
2011-12-01,Bank of America,CitiBank Pune,32583,55232,-22649
2012-01-01,Bank of America,CitiBank Pune,37484,14224,23260
2012-02-01,Bank of America,CitiBank Pune,38975,94764,-55789
2012-03-01,Bank of America,CitiBank Pune,33227,52366,-19139
2012-04-01,Bank of America,CitiBank Pune,38415,94642,-56227
2012-05-01,Bank of America,CitiBank Pune,34635,41366,-6731
2012-06-01,Bank of America,CitiBank Pune,37859,23663,14196
2012-07-01,Bank of America,CitiBank Pune,42138,99169,-57031
2012-08-01,Bank of America,CitiBank Pune,46916,19227,27689
2012-09-01,Bank of America,CitiBank Pune,42552,49957,-7405
2012-10-01,Bank of America,CitiBank Pune,47543,78677,-31134
2012-11-01,Bank of America,CitiBank Pune,45838,84952,-39114
2012-12-01,Bank of America,CitiBank Pune,41328,44148,-2820
2013-01-01,Bank of America,CitiBank Pune,47667,94515,-46848
2013-02-01,Bank of America,CitiBank Pune,48662,97331,-48669
2013-03-01,Bank of America,CitiBank Pune,48262,93199,-44937
2013-04-01,Bank of America,CitiBank Pune,48321,96787,-48466
2013-05-01,Bank of America,CitiBank Pune,59722,46792,12930
2013-06-01,Bank of America,CitiBank Pune,56719,79598,-22879
2013-07-01,Bank of America,CitiBank Pune,51717,34525,17192
2013-08-01,Bank of America,CitiBank Pune,54896,12985,41911
2013-09-01,Bank of America,CitiBank Pune,52262,16121,36141
2013-10-01,Bank of America,CitiBank Pune,56498,73483,-16985
2013-11-01,Bank of America,CitiBank Pune,55436,99651,-44215
2013-12-01,Bank of America,CitiBank Pune,51228,99384,-48156
2014-01-01,Bank of America,CitiBank Pune,55819,57631,-1812
2014-02-01,Bank of America,CitiBank Pune,51612,27454,24158
2014-03-01,Bank of America,CitiBank Pune,66256,82257,-16001
2014-04-01,Bank of America,CitiBank Pune,69244,65667,3577
2014-05-01,Bank of America,CitiBank Pune,65799,77487,-11688
2014-06-01,Bank of America,CitiBank Pune,63689,68958,-5269
2014-07-01,Bank of America,CitiBank Pune,62163,66919,-4756
2014-08-01,Bank of America,CitiBank Pune,69719,22773,46946
2014-09-01,Bank of America,CitiBank Pune,63885,41877,22008
2014-10-01,Bank of America,CitiBank Pune,61796,89268,-27472
2014-11-01,Bank of America,CitiBank Pune,67378,94297,-26919
2014-12-01,Bank of America,CitiBank Pune,65784,98364,-32580
2015-01-01,Bank of America,CitiBank Pune,71668,13253,58415
2015-02-01,Bank of America,CitiBank Pune,71825,78294,-6469
2015-03-01,Bank of America,CitiBank Pune,74523,73618,905
2015-04-01,Bank of America,CitiBank Pune,77957,83163,-5206
2015-05-01,Bank of America,CitiBank Pune,72914,25771,47143
2015-06-01,Bank of America,CitiBank Pune,79124,24981,54143
2015-07-01,Bank of America,CitiBank Pune,77873,69476,8397
2015-08-01,Bank of America,CitiBank Pune,79557,68816,10741
2015-09-01,Bank of America,CitiBank Pune,78726,68542,10184
2015-10-01,Bank of America,CitiBank Pune,71559,58566,12993
2015-11-01,Bank of America,CitiBank Pune,82748,83645,-897
2015-12-01,Bank of America,CitiBank Pune,84487,51674,32813
2016-01-01,Bank of America,CitiBank Pune,83156,57466,25690
2016-02-01,Bank of America,CitiBank Pune,88231,66767,21464
2016-03-01,Bank of America,CitiBank Pune,87826,12339,75487
2016-04-01,Bank of America,CitiBank Pune,89538,53625,35913
2016-05-01,Bank of America,CitiBank Pune,81942,18142,63800
2016-06-01,Bank of America,CitiBank Pune,81424,59695,21729
2016-07-01,Bank of America,CitiBank Pune,87657,69358,18299
2016-08-01,Bank of America,CitiBank Pune,88241,13813,74428
2016-09-01,Bank of America,CitiBank Pune,95767,99185,-3418
2016-10-01,Bank of America,CitiBank Pune,98424,14468,83956
2016-11-01,Bank of America,CitiBank Pune,94574,59191,35383
2016-12-01,Bank of America,CitiBank Pune,98998,78926,20072
2017-01-01,Bank of America,CitiBank Pune,97172,84986,12186
2017-02-01,Bank of America,CitiBank Pune,93269,16925,76344
2017-03-01,Bank of America,CitiBank Pune,96892,23484,73408
2017-04-01,Bank of America,CitiBank Pune,92591,26436,66155
2017-05-01,Bank of America,CitiBank Pune,98458,59413,39045
2017-06-01,Bank of America,CitiBank Pune,91961,59568,32393
2017-07-01,Bank of America,CitiBank Pune,107546,57154,50392
2017-08-01,Bank of America,CitiBank Pune,104333,17237,87096
2017-09-01,Bank of America,CitiBank Pune,105342,69113,36229
2017-10-01,Bank of America,CitiBank Pune,106339,27816,78523
2017-11-01,Bank of America,CitiBank Pune,105494,79555,25939
2017-12-01,Bank of America,CitiBank Pune,108815,28391,80424
2018-01-01,Bank of America,CitiBank Pune,105167,82422,22745
2018-02-01,Bank of America,CitiBank Pune,101939,87938,14001
2018-03-01,Bank of America,CitiBank Pune,109341,93842,15499
2018-04-01,Bank of America,CitiBank Pune,105327,95959,9368
2010-01-01,Bank of America,CitiBank Singapore,14823,34872,-20049
2010-02-01,Bank of America,CitiBank Singapore,19918,42856,-22938
2010-03-01,Bank of America,CitiBank Singapore,15718,89352,-73634
2010-04-01,Bank of America,CitiBank Singapore,16551,88319,-71768
2010-05-01,Bank of America,CitiBank Singapore,17115,47243,-30128
2010-06-01,Bank of America,CitiBank Singapore,13144,63671,-50527
2010-07-01,Bank of America,CitiBank Singapore,14814,77985,-63171
2010-08-01,Bank of America,CitiBank Singapore,11193,27451,-16258
2010-09-01,Bank of America,CitiBank Singapore,17142,52158,-35016
2010-10-01,Bank of America,CitiBank Singapore,15879,72235,-56356
2010-11-01,Bank of America,CitiBank Singapore,22978,66243,-43265
2010-12-01,Bank of America,CitiBank Singapore,28848,48647,-19799
2011-01-01,Bank of America,CitiBank Singapore,23157,27373,-4216
2011-02-01,Bank of America,CitiBank Singapore,22656,29385,-6729
2011-03-01,Bank of America,CitiBank Singapore,23386,82444,-59058
2011-04-01,Bank of America,CitiBank Singapore,25293,67224,-41931
2011-05-01,Bank of America,CitiBank Singapore,22134,63159,-41025
2011-06-01,Bank of America,CitiBank Singapore,22714,98177,-75463
2011-07-01,Bank of America,CitiBank Singapore,27329,28158,-829
2011-08-01,Bank of America,CitiBank Singapore,27299,88855,-61556
2011-09-01,Bank of America,CitiBank Singapore,35913,31822,4091
2011-10-01,Bank of America,CitiBank Singapore,33864,63717,-29853
2011-11-01,Bank of America,CitiBank Singapore,35676,59848,-24172
2011-12-01,Bank of America,CitiBank Singapore,37797,76797,-39000
2012-01-01,Bank of America,CitiBank Singapore,36634,58327,-21693
2012-02-01,Bank of America,CitiBank Singapore,31454,13225,18229
2012-03-01,Bank of America,CitiBank Singapore,38921,84579,-45658
2012-04-01,Bank of America,CitiBank Singapore,31738,61562,-29824
2012-05-01,Bank of America,CitiBank Singapore,39193,39569,-376
2012-06-01,Bank of America,CitiBank Singapore,37577,77315,-39738
2012-07-01,Bank of America,CitiBank Singapore,49348,15976,33372
2012-08-01,Bank of America,CitiBank Singapore,48269,84514,-36245
2012-09-01,Bank of America,CitiBank Singapore,48576,96734,-48158
2012-10-01,Bank of America,CitiBank Singapore,49477,72197,-22720
2012-11-01,Bank of America,CitiBank Singapore,42744,34623,8121
2012-12-01,Bank of America,CitiBank Singapore,43818,96526,-52708
2013-01-01,Bank of America,CitiBank Singapore,45396,25191,20205
2013-02-01,Bank of America,CitiBank Singapore,49288,53463,-4175
2013-03-01,Bank of America,CitiBank Singapore,47894,29195,18699
2013-04-01,Bank of America,CitiBank Singapore,43676,84428,-40752
2013-05-01,Bank of America,CitiBank Singapore,55592,52776,2816
2013-06-01,Bank of America,CitiBank Singapore,57386,79999,-22613
2013-07-01,Bank of America,CitiBank Singapore,57951,68446,-10495
2013-08-01,Bank of America,CitiBank Singapore,54657,14687,39970
2013-09-01,Bank of America,CitiBank Singapore,53638,68798,-15160
2013-10-01,Bank of America,CitiBank Singapore,56673,85393,-28720
2013-11-01,Bank of America,CitiBank Singapore,53162,68953,-15791
2013-12-01,Bank of America,CitiBank Singapore,56522,24259,32263
2014-01-01,Bank of America,CitiBank Singapore,53826,33784,20042
2014-02-01,Bank of America,CitiBank Singapore,56654,13526,43128
2014-03-01,Bank of America,CitiBank Singapore,62625,85131,-22506
2014-04-01,Bank of America,CitiBank Singapore,61979,29467,32512
2014-05-01,Bank of America,CitiBank Singapore,68555,82191,-13636
2014-06-01,Bank of America,CitiBank Singapore,68392,73219,-4827
2014-07-01,Bank of America,CitiBank Singapore,68551,29912,38639
2014-08-01,Bank of America,CitiBank Singapore,69589,93225,-23636
2014-09-01,Bank of America,CitiBank Singapore,62248,33595,28653
2014-10-01,Bank of America,CitiBank Singapore,68398,99618,-31220
2014-11-01,Bank of America,CitiBank Singapore,65586,22922,42664
2014-12-01,Bank of America,CitiBank Singapore,66165,68131,-1966
2015-01-01,Bank of America,CitiBank Singapore,75289,23779,51510
2015-02-01,Bank of America,CitiBank Singapore,75928,47763,28165
2015-03-01,Bank of America,CitiBank Singapore,72467,74451,-1984
2015-04-01,Bank of America,CitiBank Singapore,75177,55733,19444
2015-05-01,Bank of America,CitiBank Singapore,74749,45548,29201
2015-06-01,Bank of America,CitiBank Singapore,77878,58569,19309
2015-07-01,Bank of America,CitiBank Singapore,74729,61128,13601
2015-08-01,Bank of America,CitiBank Singapore,73178,75248,-2070
2015-09-01,Bank of America,CitiBank Singapore,76254,43675,32579
2015-10-01,Bank of America,CitiBank Singapore,78867,64339,14528
2015-11-01,Bank of America,CitiBank Singapore,85955,76464,9491
2015-12-01,Bank of America,CitiBank Singapore,82844,73795,9049
2016-01-01,Bank of America,CitiBank Singapore,85865,37439,48426
2016-02-01,Bank of America,CitiBank Singapore,88755,27757,60998
2016-03-01,Bank of America,CitiBank Singapore,85631,49263,36368
2016-04-01,Bank of America,CitiBank Singapore,83971,75241,8730
2016-05-01,Bank of America,CitiBank Singapore,84251,56578,27673
2016-06-01,Bank of America,CitiBank Singapore,82446,22379,60067
2016-07-01,Bank of America,CitiBank Singapore,86879,26991,59888
2016-08-01,Bank of America,CitiBank Singapore,81673,64996,16677
2016-09-01,Bank of America,CitiBank Singapore,94275,87279,6996
2016-10-01,Bank of America,CitiBank Singapore,93413,84193,9220
2016-11-01,Bank of America,CitiBank Singapore,94693,96732,-2039
2016-12-01,Bank of America,CitiBank Singapore,98249,98214,35
2017-01-01,Bank of America,CitiBank Singapore,96991,22317,74674
2017-02-01,Bank of America,CitiBank Singapore,97486,38941,58545
2017-03-01,Bank of America,CitiBank Singapore,95972,52351,43621
2017-04-01,Bank of America,CitiBank Singapore,93294,39453,53841
2017-05-01,Bank of America,CitiBank Singapore,97329,59215,38114
2017-06-01,Bank of America,CitiBank Singapore,96867,84995,11872
2017-07-01,Bank of America,CitiBank Singapore,106857,73112,33745
2017-08-01,Bank of America,CitiBank Singapore,104928,15284,89644
2017-09-01,Bank of America,CitiBank Singapore,106389,87918,18471
2017-10-01,Bank of America,CitiBank Singapore,108358,11681,96677
2017-11-01,Bank of America,CitiBank Singapore,101345,25633,75712
2017-12-01,Bank of America,CitiBank Singapore,108594,93824,14770
2018-01-01,Bank of America,CitiBank Singapore,106373,56916,49457
2018-02-01,Bank of America,CitiBank Singapore,107127,56121,51006
2018-03-01,Bank of America,CitiBank Singapore,109412,22594,86818
2018-04-01,Bank of America,CitiBank Singapore,109376,14169,95207
2010-01-01,Bank of America,CitiBank HongKong,17286,99128,-81842
2010-02-01,Bank of America,CitiBank HongKong,11177,64343,-53166
2010-03-01,Bank of America,CitiBank HongKong,16699,57562,-40863
2010-04-01,Bank of America,CitiBank HongKong,13518,35633,-22115
2010-05-01,Bank of America,CitiBank HongKong,11176,61134,-49958
2010-06-01,Bank of America,CitiBank HongKong,13459,72225,-58766
2010-07-01,Bank of America,CitiBank HongKong,12898,92355,-79457
2010-08-01,Bank of America,CitiBank HongKong,11996,29852,-17856
2010-09-01,Bank of America,CitiBank HongKong,18599,74493,-55894
2010-10-01,Bank of America,CitiBank HongKong,17894,33287,-15393
2010-11-01,Bank of America,CitiBank HongKong,22861,86537,-63676
2010-12-01,Bank of America,CitiBank HongKong,21764,43766,-22002
2011-01-01,Bank of America,CitiBank HongKong,21128,23594,-2466
2011-02-01,Bank of America,CitiBank HongKong,22967,45199,-22232
2011-03-01,Bank of America,CitiBank HongKong,23199,12388,10811
2011-04-01,Bank of America,CitiBank HongKong,26974,36646,-9672
2011-05-01,Bank of America,CitiBank HongKong,22576,65278,-42702
2011-06-01,Bank of America,CitiBank HongKong,21284,36659,-15375
2011-07-01,Bank of America,CitiBank HongKong,26792,64761,-37969
2011-08-01,Bank of America,CitiBank HongKong,26945,97737,-70792
2011-09-01,Bank of America,CitiBank HongKong,33153,75351,-42198
2011-10-01,Bank of America,CitiBank HongKong,33931,59875,-25944
2011-11-01,Bank of America,CitiBank HongKong,39732,19512,20220
2011-12-01,Bank of America,CitiBank HongKong,36176,99587,-63411
2012-01-01,Bank of America,CitiBank HongKong,38668,86167,-47499
2012-02-01,Bank of America,CitiBank HongKong,35135,85896,-50761
2012-03-01,Bank of America,CitiBank HongKong,35521,47957,-12436
2012-04-01,Bank of America,CitiBank HongKong,34382,58929,-24547
2012-05-01,Bank of America,CitiBank HongKong,37817,67936,-30119
2012-06-01,Bank of America,CitiBank HongKong,38694,49416,-10722
2012-07-01,Bank of America,CitiBank HongKong,47144,32241,14903
2012-08-01,Bank of America,CitiBank HongKong,45333,89798,-44465
2012-09-01,Bank of America,CitiBank HongKong,47223,39939,7284
2012-10-01,Bank of America,CitiBank HongKong,43439,93935,-50496
2012-11-01,Bank of America,CitiBank HongKong,49541,82549,-33008
2012-12-01,Bank of America,CitiBank HongKong,43746,83945,-40199
2013-01-01,Bank of America,CitiBank HongKong,46968,77566,-30598
2013-02-01,Bank of America,CitiBank HongKong,43473,97667,-54194
2013-03-01,Bank of America,CitiBank HongKong,45457,55483,-10026
2013-04-01,Bank of America,CitiBank HongKong,49298,99298,-50000
2013-05-01,Bank of America,CitiBank HongKong,57626,78329,-20703
2013-06-01,Bank of America,CitiBank HongKong,55164,75172,-20008
2013-07-01,Bank of America,CitiBank HongKong,59598,79418,-19820
2013-08-01,Bank of America,CitiBank HongKong,52554,57797,-5243
2013-09-01,Bank of America,CitiBank HongKong,58212,35738,22474
2013-10-01,Bank of America,CitiBank HongKong,53221,77642,-24421
2013-11-01,Bank of America,CitiBank HongKong,56687,62256,-5569
2013-12-01,Bank of America,CitiBank HongKong,56832,83677,-26845
2014-01-01,Bank of America,CitiBank HongKong,52532,65864,-13332
2014-02-01,Bank of America,CitiBank HongKong,57428,65556,-8128
2014-03-01,Bank of America,CitiBank HongKong,62411,62971,-560
2014-04-01,Bank of America,CitiBank HongKong,61788,45293,16495
2014-05-01,Bank of America,CitiBank HongKong,62249,45949,16300
2014-06-01,Bank of America,CitiBank HongKong,62769,24733,38036
2014-07-01,Bank of America,CitiBank HongKong,69787,95871,-26084
2014-08-01,Bank of America,CitiBank HongKong,65169,96649,-31480
2014-09-01,Bank of America,CitiBank HongKong,68181,54322,13859
2014-10-01,Bank of America,CitiBank HongKong,61111,57295,3816
2014-11-01,Bank of America,CitiBank HongKong,68921,45639,23282
2014-12-01,Bank of America,CitiBank HongKong,62112,67687,-5575
2015-01-01,Bank of America,CitiBank HongKong,77877,39478,38399
2015-02-01,Bank of America,CitiBank HongKong,75738,26685,49053
2015-03-01,Bank of America,CitiBank HongKong,79783,64954,14829
2015-04-01,Bank of America,CitiBank HongKong,71495,75693,-4198
2015-05-01,Bank of America,CitiBank HongKong,71857,28654,43203
2015-06-01,Bank of America,CitiBank HongKong,75555,86477,-10922
2015-07-01,Bank of America,CitiBank HongKong,72521,51711,20810
2015-08-01,Bank of America,CitiBank HongKong,71821,71941,-120
2015-09-01,Bank of America,CitiBank HongKong,78931,42573,36358
2015-10-01,Bank of America,CitiBank HongKong,71112,74734,-3622
2015-11-01,Bank of America,CitiBank HongKong,88917,27174,61743
2015-12-01,Bank of America,CitiBank HongKong,84916,41623,43293
2016-01-01,Bank of America,CitiBank HongKong,83793,75248,8545
2016-02-01,Bank of America,CitiBank HongKong,87476,47342,40134
2016-03-01,Bank of America,CitiBank HongKong,83897,45283,38614
2016-04-01,Bank of America,CitiBank HongKong,81292,42737,38555
2016-05-01,Bank of America,CitiBank HongKong,86723,92472,-5749
2016-06-01,Bank of America,CitiBank HongKong,83482,83232,250
2016-07-01,Bank of America,CitiBank HongKong,86197,36866,49331
2016-08-01,Bank of America,CitiBank HongKong,86794,11753,75041
2016-09-01,Bank of America,CitiBank HongKong,97927,74852,23075
2016-10-01,Bank of America,CitiBank HongKong,94366,17954,76412
2016-11-01,Bank of America,CitiBank HongKong,93937,42794,51143
2016-12-01,Bank of America,CitiBank HongKong,98965,99991,-1026
2017-01-01,Bank of America,CitiBank HongKong,94481,28162,66319
2017-02-01,Bank of America,CitiBank HongKong,91313,35669,55644
2017-03-01,Bank of America,CitiBank HongKong,92441,16995,75446
2017-04-01,Bank of America,CitiBank HongKong,98991,23996,74995
2017-05-01,Bank of America,CitiBank HongKong,98456,91931,6525
2017-06-01,Bank of America,CitiBank HongKong,98659,75441,23218
2017-07-01,Bank of America,CitiBank HongKong,107755,63535,44220
2017-08-01,Bank of America,CitiBank HongKong,102518,11269,91249
2017-09-01,Bank of America,CitiBank HongKong,103233,14886,88347
2017-10-01,Bank of America,CitiBank HongKong,103951,51576,52375
2017-11-01,Bank of America,CitiBank HongKong,106776,66144,40632
2017-12-01,Bank of America,CitiBank HongKong,102613,13937,88676
2018-01-01,Bank of America,CitiBank HongKong,106397,26385,80012
2018-02-01,Bank of America,CitiBank HongKong,106174,76157,30017
2018-03-01,Bank of America,CitiBank HongKong,107998,42936,65062
2018-04-01,Bank of America,CitiBank HongKong,101249,77588,23661
2010-01-01,Barclays,CitiBank New York,19437,91241,-71804
2010-02-01,Barclays,CitiBank New York,19168,27648,-8480
2010-03-01,Barclays,CitiBank New York,17758,94477,-76719
2010-04-01,Barclays,CitiBank New York,12379,47314,-34935
2010-05-01,Barclays,CitiBank New York,14377,21171,-6794
2010-06-01,Barclays,CitiBank New York,18346,85982,-67636
2010-07-01,Barclays,CitiBank New York,16879,23655,-6776
2010-08-01,Barclays,CitiBank New York,15942,91578,-75636
2010-09-01,Barclays,CitiBank New York,14171,54518,-40347
2010-10-01,Barclays,CitiBank New York,15358,85357,-69999
2010-11-01,Barclays,CitiBank New York,27462,69545,-42083
2010-12-01,Barclays,CitiBank New York,22386,63418,-41032
2011-01-01,Barclays,CitiBank New York,23688,52335,-28647
2011-02-01,Barclays,CitiBank New York,24618,43196,-18578
2011-03-01,Barclays,CitiBank New York,21875,26976,-5101
2011-04-01,Barclays,CitiBank New York,21468,41729,-20261
2011-05-01,Barclays,CitiBank New York,28248,49838,-21590
2011-06-01,Barclays,CitiBank New York,23873,73347,-49474
2011-07-01,Barclays,CitiBank New York,29356,87327,-57971
2011-08-01,Barclays,CitiBank New York,27523,32476,-4953
2011-09-01,Barclays,CitiBank New York,35838,48722,-12884
2011-10-01,Barclays,CitiBank New York,38365,88242,-49877
2011-11-01,Barclays,CitiBank New York,36177,26929,9248
2011-12-01,Barclays,CitiBank New York,35642,14146,21496
2012-01-01,Barclays,CitiBank New York,38749,11786,26963
2012-02-01,Barclays,CitiBank New York,33482,39942,-6460
2012-03-01,Barclays,CitiBank New York,32918,73166,-40248
2012-04-01,Barclays,CitiBank New York,32527,97121,-64594
2012-05-01,Barclays,CitiBank New York,37754,46546,-8792
2012-06-01,Barclays,CitiBank New York,33354,71999,-38645
2012-07-01,Barclays,CitiBank New York,43936,45595,-1659
2012-08-01,Barclays,CitiBank New York,41242,58946,-17704
2012-09-01,Barclays,CitiBank New York,42116,53665,-11549
2012-10-01,Barclays,CitiBank New York,42845,64738,-21893
2012-11-01,Barclays,CitiBank New York,49522,73543,-24021
2012-12-01,Barclays,CitiBank New York,44233,94464,-50231
2013-01-01,Barclays,CitiBank New York,42862,32253,10609
2013-02-01,Barclays,CitiBank New York,43826,94829,-51003
2013-03-01,Barclays,CitiBank New York,44438,66699,-22261
2013-04-01,Barclays,CitiBank New York,42364,77127,-34763
2013-05-01,Barclays,CitiBank New York,57623,78199,-20576
2013-06-01,Barclays,CitiBank New York,58283,38554,19729
2013-07-01,Barclays,CitiBank New York,53855,42584,11271
2013-08-01,Barclays,CitiBank New York,52511,63911,-11400
2013-09-01,Barclays,CitiBank New York,58483,78724,-20241
2013-10-01,Barclays,CitiBank New York,52982,84935,-31953
2013-11-01,Barclays,CitiBank New York,51921,54736,-2815
2013-12-01,Barclays,CitiBank New York,52529,53953,-1424
2014-01-01,Barclays,CitiBank New York,53386,78629,-25243
2014-02-01,Barclays,CitiBank New York,56188,14966,41222
2014-03-01,Barclays,CitiBank New York,64184,71495,-7311
2014-04-01,Barclays,CitiBank New York,68754,47294,21460
2014-05-01,Barclays,CitiBank New York,62916,55365,7551
2014-06-01,Barclays,CitiBank New York,63736,35625,28111
2014-07-01,Barclays,CitiBank New York,62874,82995,-20121
2014-08-01,Barclays,CitiBank New York,63574,44729,18845
2014-09-01,Barclays,CitiBank New York,66396,88899,-22503
2014-10-01,Barclays,CitiBank New York,66426,58482,7944
2014-11-01,Barclays,CitiBank New York,68149,89869,-21720
2014-12-01,Barclays,CitiBank New York,65517,51114,14403
2015-01-01,Barclays,CitiBank New York,79526,46244,33282
2015-02-01,Barclays,CitiBank New York,78377,81541,-3164
2015-03-01,Barclays,CitiBank New York,75994,41858,34136
2015-04-01,Barclays,CitiBank New York,72615,35462,37153
2015-05-01,Barclays,CitiBank New York,72341,71666,675
2015-06-01,Barclays,CitiBank New York,77933,97114,-19181
2015-07-01,Barclays,CitiBank New York,79254,33284,45970
2015-08-01,Barclays,CitiBank New York,73947,52574,21373
2015-09-01,Barclays,CitiBank New York,76951,44157,32794
2015-10-01,Barclays,CitiBank New York,71535,52542,18993
2015-11-01,Barclays,CitiBank New York,89543,71269,18274
2015-12-01,Barclays,CitiBank New York,89584,31435,58149
2016-01-01,Barclays,CitiBank New York,81238,87441,-6203
2016-02-01,Barclays,CitiBank New York,87245,87449,-204
2016-03-01,Barclays,CitiBank New York,81135,14819,66316
2016-04-01,Barclays,CitiBank New York,82157,62163,19994
2016-05-01,Barclays,CitiBank New York,88212,58192,30020
2016-06-01,Barclays,CitiBank New York,81286,24263,57023
2016-07-01,Barclays,CitiBank New York,82499,51341,31158
2016-08-01,Barclays,CitiBank New York,88639,52926,35713
2016-09-01,Barclays,CitiBank New York,95698,86894,8804
2016-10-01,Barclays,CitiBank New York,98851,68135,30716
2016-11-01,Barclays,CitiBank New York,99339,74544,24795
2016-12-01,Barclays,CitiBank New York,99824,55217,44607
2017-01-01,Barclays,CitiBank New York,92814,63565,29249
2017-02-01,Barclays,CitiBank New York,98161,68716,29445
2017-03-01,Barclays,CitiBank New York,93472,31233,62239
2017-04-01,Barclays,CitiBank New York,97971,87371,10600
2017-05-01,Barclays,CitiBank New York,95895,33223,62672
2017-06-01,Barclays,CitiBank New York,93189,16262,76927
2017-07-01,Barclays,CitiBank New York,108865,65481,43384
2017-08-01,Barclays,CitiBank New York,105382,28637,76745
2017-09-01,Barclays,CitiBank New York,103293,55293,48000
2017-10-01,Barclays,CitiBank New York,105361,28158,77203
2017-11-01,Barclays,CitiBank New York,107329,22817,84512
2017-12-01,Barclays,CitiBank New York,104677,79186,25491
2018-01-01,Barclays,CitiBank New York,109866,38663,71203
2018-02-01,Barclays,CitiBank New York,108772,72324,36448
2018-03-01,Barclays,CitiBank New York,107921,45513,62408
2018-04-01,Barclays,CitiBank New York,109157,27885,81272
2010-01-01,Barclays,CitiBank London,16435,14237,2198
2010-02-01,Barclays,CitiBank London,13627,76916,-63289
2010-03-01,Barclays,CitiBank London,15127,56756,-41629
2010-04-01,Barclays,CitiBank London,17222,41818,-24596
2010-05-01,Barclays,CitiBank London,16289,21133,-4844
2010-06-01,Barclays,CitiBank London,19143,51837,-32694
2010-07-01,Barclays,CitiBank London,14958,68353,-53395
2010-08-01,Barclays,CitiBank London,16431,95185,-78754
2010-09-01,Barclays,CitiBank London,14242,64249,-50007
2010-10-01,Barclays,CitiBank London,13187,44296,-31109
2010-11-01,Barclays,CitiBank London,29597,21774,7823
2010-12-01,Barclays,CitiBank London,24334,69798,-45464
2011-01-01,Barclays,CitiBank London,22588,53834,-31246
2011-02-01,Barclays,CitiBank London,24386,67757,-43371
2011-03-01,Barclays,CitiBank London,28467,43911,-15444
2011-04-01,Barclays,CitiBank London,26255,92797,-66542
2011-05-01,Barclays,CitiBank London,25849,56195,-30346
2011-06-01,Barclays,CitiBank London,26892,53547,-26655
2011-07-01,Barclays,CitiBank London,23839,83863,-60024
2011-08-01,Barclays,CitiBank London,23566,22531,1035
2011-09-01,Barclays,CitiBank London,38422,91889,-53467
2011-10-01,Barclays,CitiBank London,38383,94828,-56445
2011-11-01,Barclays,CitiBank London,39268,64591,-25323
2011-12-01,Barclays,CitiBank London,39329,91914,-52585
2012-01-01,Barclays,CitiBank London,36985,54478,-17493
2012-02-01,Barclays,CitiBank London,38465,33656,4809
2012-03-01,Barclays,CitiBank London,36136,16926,19210
2012-04-01,Barclays,CitiBank London,33788,21427,12361
2012-05-01,Barclays,CitiBank London,33242,79914,-46672
2012-06-01,Barclays,CitiBank London,34817,23564,11253
2012-07-01,Barclays,CitiBank London,48949,37439,11510
2012-08-01,Barclays,CitiBank London,48351,82187,-33836
2012-09-01,Barclays,CitiBank London,49136,44784,4352
2012-10-01,Barclays,CitiBank London,44279,88444,-44165
2012-11-01,Barclays,CitiBank London,44757,87248,-42491
2012-12-01,Barclays,CitiBank London,48673,87623,-38950
2013-01-01,Barclays,CitiBank London,42354,57889,-15535
2013-02-01,Barclays,CitiBank London,48329,89792,-41463
2013-03-01,Barclays,CitiBank London,47946,12489,35457
2013-04-01,Barclays,CitiBank London,48172,83691,-35519
2013-05-01,Barclays,CitiBank London,53991,98193,-44202
2013-06-01,Barclays,CitiBank London,55652,79871,-24219
2013-07-01,Barclays,CitiBank London,55645,55832,-187
2013-08-01,Barclays,CitiBank London,54241,44618,9623
2013-09-01,Barclays,CitiBank London,57844,96467,-38623
2013-10-01,Barclays,CitiBank London,54289,46298,7991
2013-11-01,Barclays,CitiBank London,58286,86113,-27827
2013-12-01,Barclays,CitiBank London,55478,16624,38854
2014-01-01,Barclays,CitiBank London,56333,69311,-12978
2014-02-01,Barclays,CitiBank London,56198,67193,-10995
2014-03-01,Barclays,CitiBank London,63826,24728,39098
2014-04-01,Barclays,CitiBank London,69989,59431,10558
2014-05-01,Barclays,CitiBank London,65476,77128,-11652
2014-06-01,Barclays,CitiBank London,63468,62399,1069
2014-07-01,Barclays,CitiBank London,62428,71853,-9425
2014-08-01,Barclays,CitiBank London,61237,92529,-31292
2014-09-01,Barclays,CitiBank London,61244,35347,25897
2014-10-01,Barclays,CitiBank London,61744,62339,-595
2014-11-01,Barclays,CitiBank London,65564,44888,20676
2014-12-01,Barclays,CitiBank London,62122,62129,-7
2015-01-01,Barclays,CitiBank London,73917,92767,-18850
2015-02-01,Barclays,CitiBank London,78584,31251,47333
2015-03-01,Barclays,CitiBank London,78929,27282,51647
2015-04-01,Barclays,CitiBank London,76563,77785,-1222
2015-05-01,Barclays,CitiBank London,79239,52586,26653
2015-06-01,Barclays,CitiBank London,72557,87125,-14568
2015-07-01,Barclays,CitiBank London,74158,55922,18236
2015-08-01,Barclays,CitiBank London,72729,33194,39535
2015-09-01,Barclays,CitiBank London,78453,11115,67338
2015-10-01,Barclays,CitiBank London,71231,21778,49453
2015-11-01,Barclays,CitiBank London,85399,89374,-3975
2015-12-01,Barclays,CitiBank London,84799,23245,61554
2016-01-01,Barclays,CitiBank London,82271,47856,34415
2016-02-01,Barclays,CitiBank London,86646,58341,28305
2016-03-01,Barclays,CitiBank London,83536,21475,62061
2016-04-01,Barclays,CitiBank London,82926,86348,-3422
2016-05-01,Barclays,CitiBank London,88776,92721,-3945
2016-06-01,Barclays,CitiBank London,87325,48573,38752
2016-07-01,Barclays,CitiBank London,87871,94394,-6523
2016-08-01,Barclays,CitiBank London,83152,75795,7357
2016-09-01,Barclays,CitiBank London,98745,78561,20184
2016-10-01,Barclays,CitiBank London,99843,29241,70602
2016-11-01,Barclays,CitiBank London,97422,13269,84153
2016-12-01,Barclays,CitiBank London,92884,48183,44701
2017-01-01,Barclays,CitiBank London,92121,58657,33464
2017-02-01,Barclays,CitiBank London,92811,18134,74677
2017-03-01,Barclays,CitiBank London,94461,77772,16689
2017-04-01,Barclays,CitiBank London,99917,15132,84785
2017-05-01,Barclays,CitiBank London,92149,53264,38885
2017-06-01,Barclays,CitiBank London,94193,65219,28974
2017-07-01,Barclays,CitiBank London,105114,34398,70716
2017-08-01,Barclays,CitiBank London,103224,37715,65509
2017-09-01,Barclays,CitiBank London,106563,14665,91898
2017-10-01,Barclays,CitiBank London,102683,33777,68906
2017-11-01,Barclays,CitiBank London,107643,94924,12719
2017-12-01,Barclays,CitiBank London,106225,62523,43702
2018-01-01,Barclays,CitiBank London,104747,25718,79029
2018-02-01,Barclays,CitiBank London,101832,75716,26116
2018-03-01,Barclays,CitiBank London,106535,79157,27378
2018-04-01,Barclays,CitiBank London,104685,39143,65542
2010-01-01,Barclays,CitiBank Pune,11855,73644,-61789
2010-02-01,Barclays,CitiBank Pune,12817,47968,-35151
2010-03-01,Barclays,CitiBank Pune,12231,57169,-44938
2010-04-01,Barclays,CitiBank Pune,15417,46451,-31034
2010-05-01,Barclays,CitiBank Pune,14374,94822,-80448
2010-06-01,Barclays,CitiBank Pune,19545,31482,-11937
2010-07-01,Barclays,CitiBank Pune,14853,35417,-20564
2010-08-01,Barclays,CitiBank Pune,15726,96118,-80392
2010-09-01,Barclays,CitiBank Pune,16821,66715,-49894
2010-10-01,Barclays,CitiBank Pune,17993,11225,6768
2010-11-01,Barclays,CitiBank Pune,24865,26382,-1517
2010-12-01,Barclays,CitiBank Pune,26744,99818,-73074
2011-01-01,Barclays,CitiBank Pune,26125,99788,-73663
2011-02-01,Barclays,CitiBank Pune,24429,77581,-53152
2011-03-01,Barclays,CitiBank Pune,26721,31163,-4442
2011-04-01,Barclays,CitiBank Pune,24252,52527,-28275
2011-05-01,Barclays,CitiBank Pune,23221,42282,-19061
2011-06-01,Barclays,CitiBank Pune,29733,41933,-12200
2011-07-01,Barclays,CitiBank Pune,28634,18789,9845
2011-08-01,Barclays,CitiBank Pune,23921,29266,-5345
2011-09-01,Barclays,CitiBank Pune,39175,81421,-42246
2011-10-01,Barclays,CitiBank Pune,38192,75812,-37620
2011-11-01,Barclays,CitiBank Pune,31416,83291,-51875
2011-12-01,Barclays,CitiBank Pune,35953,98325,-62372
2012-01-01,Barclays,CitiBank Pune,37753,21596,16157
2012-02-01,Barclays,CitiBank Pune,34111,72111,-38000
2012-03-01,Barclays,CitiBank Pune,38222,82894,-44672
2012-04-01,Barclays,CitiBank Pune,35817,88159,-52342
2012-05-01,Barclays,CitiBank Pune,39858,43997,-4139
2012-06-01,Barclays,CitiBank Pune,37567,53417,-15850
2012-07-01,Barclays,CitiBank Pune,44569,55585,-11016
2012-08-01,Barclays,CitiBank Pune,42184,81387,-39203
2012-09-01,Barclays,CitiBank Pune,43272,64856,-21584
2012-10-01,Barclays,CitiBank Pune,46225,52919,-6694
2012-11-01,Barclays,CitiBank Pune,43135,77576,-34441
2012-12-01,Barclays,CitiBank Pune,41917,52848,-10931
2013-01-01,Barclays,CitiBank Pune,45129,74884,-29755
2013-02-01,Barclays,CitiBank Pune,48248,29863,18385
2013-03-01,Barclays,CitiBank Pune,49532,62254,-12722
2013-04-01,Barclays,CitiBank Pune,43253,56619,-13366
2013-05-01,Barclays,CitiBank Pune,59433,56341,3092
2013-06-01,Barclays,CitiBank Pune,51823,74817,-22994
2013-07-01,Barclays,CitiBank Pune,58457,83288,-24831
2013-08-01,Barclays,CitiBank Pune,56945,31578,25367
2013-09-01,Barclays,CitiBank Pune,54553,48133,6420
2013-10-01,Barclays,CitiBank Pune,53757,21453,32304
2013-11-01,Barclays,CitiBank Pune,57595,42442,15153
2013-12-01,Barclays,CitiBank Pune,53536,85788,-32252
2014-01-01,Barclays,CitiBank Pune,53988,33712,20276
2014-02-01,Barclays,CitiBank Pune,54653,25431,29222
2014-03-01,Barclays,CitiBank Pune,62415,56961,5454
2014-04-01,Barclays,CitiBank Pune,69588,76381,-6793
2014-05-01,Barclays,CitiBank Pune,67273,37223,30050
2014-06-01,Barclays,CitiBank Pune,64192,96213,-32021
2014-07-01,Barclays,CitiBank Pune,64726,66731,-2005
2014-08-01,Barclays,CitiBank Pune,69926,94153,-24227
2014-09-01,Barclays,CitiBank Pune,62236,89167,-26931
2014-10-01,Barclays,CitiBank Pune,64223,82617,-18394
2014-11-01,Barclays,CitiBank Pune,64292,14988,49304
2014-12-01,Barclays,CitiBank Pune,67469,46971,20498
2015-01-01,Barclays,CitiBank Pune,73523,49671,23852
2015-02-01,Barclays,CitiBank Pune,77863,62582,15281
2015-03-01,Barclays,CitiBank Pune,79577,64612,14965
2015-04-01,Barclays,CitiBank Pune,75372,45323,30049
2015-05-01,Barclays,CitiBank Pune,71871,79464,-7593
2015-06-01,Barclays,CitiBank Pune,77767,77819,-52
2015-07-01,Barclays,CitiBank Pune,79699,69438,10261
2015-08-01,Barclays,CitiBank Pune,79868,26848,53020
2015-09-01,Barclays,CitiBank Pune,71176,39777,31399
2015-10-01,Barclays,CitiBank Pune,73925,51932,21993
2015-11-01,Barclays,CitiBank Pune,88152,38727,49425
2015-12-01,Barclays,CitiBank Pune,89957,26875,63082
2016-01-01,Barclays,CitiBank Pune,82797,74558,8239
2016-02-01,Barclays,CitiBank Pune,89514,39613,49901
2016-03-01,Barclays,CitiBank Pune,88516,33155,55361
2016-04-01,Barclays,CitiBank Pune,85869,13234,72635
2016-05-01,Barclays,CitiBank Pune,89724,68558,21166
2016-06-01,Barclays,CitiBank Pune,87939,35188,52751
2016-07-01,Barclays,CitiBank Pune,82273,63436,18837
2016-08-01,Barclays,CitiBank Pune,85281,34949,50332
2016-09-01,Barclays,CitiBank Pune,92994,18772,74222
2016-10-01,Barclays,CitiBank Pune,93387,93622,-235
2016-11-01,Barclays,CitiBank Pune,95634,88927,6707
2016-12-01,Barclays,CitiBank Pune,96158,24418,71740
2017-01-01,Barclays,CitiBank Pune,92289,25736,66553
2017-02-01,Barclays,CitiBank Pune,93238,34274,58964
2017-03-01,Barclays,CitiBank Pune,95296,12334,82962
2017-04-01,Barclays,CitiBank Pune,92489,61185,31304
2017-05-01,Barclays,CitiBank Pune,91336,68514,22822
2017-06-01,Barclays,CitiBank Pune,97495,12784,84711
2017-07-01,Barclays,CitiBank Pune,103875,27596,76279
2017-08-01,Barclays,CitiBank Pune,107824,88454,19370
2017-09-01,Barclays,CitiBank Pune,105246,47934,57312
2017-10-01,Barclays,CitiBank Pune,105148,82764,22384
2017-11-01,Barclays,CitiBank Pune,102357,58517,43840
2017-12-01,Barclays,CitiBank Pune,106578,81343,25235
2018-01-01,Barclays,CitiBank Pune,107682,95677,12005
2018-02-01,Barclays,CitiBank Pune,107175,59619,47556
2018-03-01,Barclays,CitiBank Pune,105879,32691,73188
2018-04-01,Barclays,CitiBank Pune,101136,22565,78571
2010-01-01,Barclays,CitiBank Singapore,11134,44227,-33093
2010-02-01,Barclays,CitiBank Singapore,18683,42866,-24183
2010-03-01,Barclays,CitiBank Singapore,17458,66798,-49340
2010-04-01,Barclays,CitiBank Singapore,15171,67865,-52694
2010-05-01,Barclays,CitiBank Singapore,19994,11975,8019
2010-06-01,Barclays,CitiBank Singapore,11527,17731,-6204
2010-07-01,Barclays,CitiBank Singapore,19345,44632,-25287
2010-08-01,Barclays,CitiBank Singapore,12322,51587,-39265
2010-09-01,Barclays,CitiBank Singapore,13223,32613,-19390
2010-10-01,Barclays,CitiBank Singapore,18322,23145,-4823
2010-11-01,Barclays,CitiBank Singapore,28769,81535,-52766
2010-12-01,Barclays,CitiBank Singapore,23943,35468,-11525
2011-01-01,Barclays,CitiBank Singapore,24496,72286,-47790
2011-02-01,Barclays,CitiBank Singapore,29711,52314,-22603
2011-03-01,Barclays,CitiBank Singapore,25839,26274,-435
2011-04-01,Barclays,CitiBank Singapore,27843,74514,-46671
2011-05-01,Barclays,CitiBank Singapore,24481,68355,-43874
2011-06-01,Barclays,CitiBank Singapore,22937,77717,-54780
2011-07-01,Barclays,CitiBank Singapore,24721,16453,8268
2011-08-01,Barclays,CitiBank Singapore,21935,75893,-53958
2011-09-01,Barclays,CitiBank Singapore,37383,33574,3809
2011-10-01,Barclays,CitiBank Singapore,38618,55817,-17199
2011-11-01,Barclays,CitiBank Singapore,39777,58737,-18960
2011-12-01,Barclays,CitiBank Singapore,34937,68871,-33934
2012-01-01,Barclays,CitiBank Singapore,32627,24769,7858
2012-02-01,Barclays,CitiBank Singapore,32967,54573,-21606
2012-03-01,Barclays,CitiBank Singapore,31518,45173,-13655
2012-04-01,Barclays,CitiBank Singapore,31396,35392,-3996
2012-05-01,Barclays,CitiBank Singapore,32132,21199,10933
2012-06-01,Barclays,CitiBank Singapore,35441,69858,-34417
2012-07-01,Barclays,CitiBank Singapore,43662,83645,-39983
2012-08-01,Barclays,CitiBank Singapore,42218,95784,-53566
2012-09-01,Barclays,CitiBank Singapore,49714,27361,22353
2012-10-01,Barclays,CitiBank Singapore,43826,25582,18244
2012-11-01,Barclays,CitiBank Singapore,44492,36654,7838
2012-12-01,Barclays,CitiBank Singapore,44828,38773,6055
2013-01-01,Barclays,CitiBank Singapore,43773,64655,-20882
2013-02-01,Barclays,CitiBank Singapore,41499,77497,-35998
2013-03-01,Barclays,CitiBank Singapore,47323,35521,11802
2013-04-01,Barclays,CitiBank Singapore,41598,55914,-14316
2013-05-01,Barclays,CitiBank Singapore,51969,83713,-31744
2013-06-01,Barclays,CitiBank Singapore,59674,69564,-9890
2013-07-01,Barclays,CitiBank Singapore,59462,44934,14528
2013-08-01,Barclays,CitiBank Singapore,55469,89447,-33978
2013-09-01,Barclays,CitiBank Singapore,53585,27643,25942
2013-10-01,Barclays,CitiBank Singapore,52862,93638,-40776
2013-11-01,Barclays,CitiBank Singapore,51474,27526,23948
2013-12-01,Barclays,CitiBank Singapore,56946,53343,3603
2014-01-01,Barclays,CitiBank Singapore,51116,44813,6303
2014-02-01,Barclays,CitiBank Singapore,53738,15326,38412
2014-03-01,Barclays,CitiBank Singapore,63198,26579,36619
2014-04-01,Barclays,CitiBank Singapore,69371,14382,54989
2014-05-01,Barclays,CitiBank Singapore,66429,54612,11817
2014-06-01,Barclays,CitiBank Singapore,61198,24327,36871
2014-07-01,Barclays,CitiBank Singapore,64597,88912,-24315
2014-08-01,Barclays,CitiBank Singapore,66115,72225,-6110
2014-09-01,Barclays,CitiBank Singapore,62289,21139,41150
2014-10-01,Barclays,CitiBank Singapore,69884,77545,-7661
2014-11-01,Barclays,CitiBank Singapore,69142,14413,54729
2014-12-01,Barclays,CitiBank Singapore,61835,22813,39022
2015-01-01,Barclays,CitiBank Singapore,78411,53815,24596
2015-02-01,Barclays,CitiBank Singapore,76863,79552,-2689
2015-03-01,Barclays,CitiBank Singapore,74464,36136,38328
2015-04-01,Barclays,CitiBank Singapore,78268,44123,34145
2015-05-01,Barclays,CitiBank Singapore,76364,45952,30412
2015-06-01,Barclays,CitiBank Singapore,74912,28138,46774
2015-07-01,Barclays,CitiBank Singapore,71134,35896,35238
2015-08-01,Barclays,CitiBank Singapore,73977,16721,57256
2015-09-01,Barclays,CitiBank Singapore,72449,26193,46256
2015-10-01,Barclays,CitiBank Singapore,74214,76163,-1949
2015-11-01,Barclays,CitiBank Singapore,88838,42278,46560
2015-12-01,Barclays,CitiBank Singapore,83395,18863,64532
2016-01-01,Barclays,CitiBank Singapore,81728,92749,-11021
2016-02-01,Barclays,CitiBank Singapore,83227,12823,70404
2016-03-01,Barclays,CitiBank Singapore,85788,54389,31399
2016-04-01,Barclays,CitiBank Singapore,87419,27132,60287
2016-05-01,Barclays,CitiBank Singapore,87916,85365,2551
2016-06-01,Barclays,CitiBank Singapore,86481,73155,13326
2016-07-01,Barclays,CitiBank Singapore,85422,64659,20763
2016-08-01,Barclays,CitiBank Singapore,84383,44274,40109
2016-09-01,Barclays,CitiBank Singapore,96489,27563,68926
2016-10-01,Barclays,CitiBank Singapore,94345,25672,68673
2016-11-01,Barclays,CitiBank Singapore,92391,98338,-5947
2016-12-01,Barclays,CitiBank Singapore,98351,99916,-1565
2017-01-01,Barclays,CitiBank Singapore,98649,41675,56974
2017-02-01,Barclays,CitiBank Singapore,94863,99349,-4486
2017-03-01,Barclays,CitiBank Singapore,94897,34133,60764
2017-04-01,Barclays,CitiBank Singapore,95968,89689,6279
2017-05-01,Barclays,CitiBank Singapore,91793,49983,41810
2017-06-01,Barclays,CitiBank Singapore,98226,73663,24563
2017-07-01,Barclays,CitiBank Singapore,103136,54857,48279
2017-08-01,Barclays,CitiBank Singapore,108499,29316,79183
2017-09-01,Barclays,CitiBank Singapore,108815,68262,40553
2017-10-01,Barclays,CitiBank Singapore,108114,75366,32748
2017-11-01,Barclays,CitiBank Singapore,106659,33659,73000
2017-12-01,Barclays,CitiBank Singapore,105656,35385,70271
2018-01-01,Barclays,CitiBank Singapore,103487,96551,6936
2018-02-01,Barclays,CitiBank Singapore,105843,51433,54410
2018-03-01,Barclays,CitiBank Singapore,107282,35194,72088
2018-04-01,Barclays,CitiBank Singapore,102397,89835,12562
2010-01-01,Barclays,CitiBank HongKong,15458,66421,-50963
2010-02-01,Barclays,CitiBank HongKong,17614,61945,-44331
2010-03-01,Barclays,CitiBank HongKong,12668,24888,-12220
2010-04-01,Barclays,CitiBank HongKong,13143,63873,-50730
2010-05-01,Barclays,CitiBank HongKong,13464,38198,-24734
2010-06-01,Barclays,CitiBank HongKong,17188,77149,-59961
2010-07-01,Barclays,CitiBank HongKong,11273,86791,-75518
2010-08-01,Barclays,CitiBank HongKong,13712,45731,-32019
2010-09-01,Barclays,CitiBank HongKong,18553,95478,-76925
2010-10-01,Barclays,CitiBank HongKong,11879,94251,-82372
2010-11-01,Barclays,CitiBank HongKong,22495,17165,5330
2010-12-01,Barclays,CitiBank HongKong,28819,43444,-14625
2011-01-01,Barclays,CitiBank HongKong,22597,54241,-31644
2011-02-01,Barclays,CitiBank HongKong,22743,15699,7044
2011-03-01,Barclays,CitiBank HongKong,21832,94713,-72881
2011-04-01,Barclays,CitiBank HongKong,25973,41452,-15479
2011-05-01,Barclays,CitiBank HongKong,29929,45175,-15246
2011-06-01,Barclays,CitiBank HongKong,28135,98924,-70789
2011-07-01,Barclays,CitiBank HongKong,23473,76792,-53319
2011-08-01,Barclays,CitiBank HongKong,25498,18352,7146
2011-09-01,Barclays,CitiBank HongKong,38863,97956,-59093
2011-10-01,Barclays,CitiBank HongKong,37458,91826,-54368
2011-11-01,Barclays,CitiBank HongKong,32631,57861,-25230
2011-12-01,Barclays,CitiBank HongKong,32545,21869,10676
2012-01-01,Barclays,CitiBank HongKong,32927,14838,18089
2012-02-01,Barclays,CitiBank HongKong,36485,14752,21733
2012-03-01,Barclays,CitiBank HongKong,36634,62536,-25902
2012-04-01,Barclays,CitiBank HongKong,33171,34666,-1495
2012-05-01,Barclays,CitiBank HongKong,32196,15973,16223
2012-06-01,Barclays,CitiBank HongKong,37724,89345,-51621
2012-07-01,Barclays,CitiBank HongKong,47152,44681,2471
2012-08-01,Barclays,CitiBank HongKong,41329,16691,24638
2012-09-01,Barclays,CitiBank HongKong,44176,44642,-466
2012-10-01,Barclays,CitiBank HongKong,43723,72484,-28761
2012-11-01,Barclays,CitiBank HongKong,42962,74441,-31479
2012-12-01,Barclays,CitiBank HongKong,41998,58179,-16181
2013-01-01,Barclays,CitiBank HongKong,44947,71412,-26465
2013-02-01,Barclays,CitiBank HongKong,49644,29777,19867
2013-03-01,Barclays,CitiBank HongKong,42658,81137,-38479
2013-04-01,Barclays,CitiBank HongKong,41986,58718,-16732
2013-05-01,Barclays,CitiBank HongKong,51858,96888,-45030
2013-06-01,Barclays,CitiBank HongKong,52294,91327,-39033
2013-07-01,Barclays,CitiBank HongKong,59859,74586,-14727
2013-08-01,Barclays,CitiBank HongKong,52125,99856,-47731
2013-09-01,Barclays,CitiBank HongKong,51386,66828,-15442
2013-10-01,Barclays,CitiBank HongKong,57584,34156,23428
2013-11-01,Barclays,CitiBank HongKong,55471,41919,13552
2013-12-01,Barclays,CitiBank HongKong,59465,46989,12476
2014-01-01,Barclays,CitiBank HongKong,55553,97452,-41899
2014-02-01,Barclays,CitiBank HongKong,59283,29169,30114
2014-03-01,Barclays,CitiBank HongKong,65491,99529,-34038
2014-04-01,Barclays,CitiBank HongKong,65216,34985,30231
2014-05-01,Barclays,CitiBank HongKong,61626,24754,36872
2014-06-01,Barclays,CitiBank HongKong,66564,86233,-19669
2014-07-01,Barclays,CitiBank HongKong,64395,11382,53013
2014-08-01,Barclays,CitiBank HongKong,62853,96328,-33475
2014-09-01,Barclays,CitiBank HongKong,66765,47621,19144
2014-10-01,Barclays,CitiBank HongKong,67935,68492,-557
2014-11-01,Barclays,CitiBank HongKong,67433,73784,-6351
2014-12-01,Barclays,CitiBank HongKong,61417,87231,-25814
2015-01-01,Barclays,CitiBank HongKong,73268,23277,49991
2015-02-01,Barclays,CitiBank HongKong,72489,34443,38046
2015-03-01,Barclays,CitiBank HongKong,73213,37182,36031
2015-04-01,Barclays,CitiBank HongKong,74863,47282,27581
2015-05-01,Barclays,CitiBank HongKong,75723,26943,48780
2015-06-01,Barclays,CitiBank HongKong,72549,71266,1283
2015-07-01,Barclays,CitiBank HongKong,78342,28548,49794
2015-08-01,Barclays,CitiBank HongKong,74425,27333,47092
2015-09-01,Barclays,CitiBank HongKong,75943,26417,49526
2015-10-01,Barclays,CitiBank HongKong,77732,74919,2813
2015-11-01,Barclays,CitiBank HongKong,88389,52641,35748
2015-12-01,Barclays,CitiBank HongKong,84148,16825,67323
2016-01-01,Barclays,CitiBank HongKong,87474,43939,43535
2016-02-01,Barclays,CitiBank HongKong,82119,26757,55362
2016-03-01,Barclays,CitiBank HongKong,82149,52426,29723
2016-04-01,Barclays,CitiBank HongKong,89822,74391,15431
2016-05-01,Barclays,CitiBank HongKong,87921,27797,60124
2016-06-01,Barclays,CitiBank HongKong,81633,98584,-16951
2016-07-01,Barclays,CitiBank HongKong,81187,64366,16821
2016-08-01,Barclays,CitiBank HongKong,88267,61874,26393
2016-09-01,Barclays,CitiBank HongKong,95247,35895,59352
2016-10-01,Barclays,CitiBank HongKong,92625,18691,73934
2016-11-01,Barclays,CitiBank HongKong,92242,67653,24589
2016-12-01,Barclays,CitiBank HongKong,94179,21137,73042
2017-01-01,Barclays,CitiBank HongKong,97635,95314,2321
2017-02-01,Barclays,CitiBank HongKong,98186,95672,2514
2017-03-01,Barclays,CitiBank HongKong,98874,44199,54675
2017-04-01,Barclays,CitiBank HongKong,98972,45544,53428
2017-05-01,Barclays,CitiBank HongKong,95597,95267,330
2017-06-01,Barclays,CitiBank HongKong,95958,36717,59241
2017-07-01,Barclays,CitiBank HongKong,103496,37763,65733
2017-08-01,Barclays,CitiBank HongKong,109344,53859,55485
2017-09-01,Barclays,CitiBank HongKong,105338,88493,16845
2017-10-01,Barclays,CitiBank HongKong,101868,48635,53233
2017-11-01,Barclays,CitiBank HongKong,105359,93965,11394
2017-12-01,Barclays,CitiBank HongKong,103597,54818,48779
2018-01-01,Barclays,CitiBank HongKong,108638,67741,40897
2018-02-01,Barclays,CitiBank HongKong,109651,42847,66804
2018-03-01,Barclays,CitiBank HongKong,105199,83756,21443
2018-04-01,Barclays,CitiBank HongKong,103956,22539,81417
