Date,Client Name,Legal Entity,Received Amount,Delivered Amount,Net Amount
2010-01-01,HSBC,CitiBank New York,56989,56748,241
2010-02-01,HSBC,CitiBank New York,52467,53783,-1316
2010-03-01,HSBC,CitiBank New York,51562,55422,-3860
2010-04-01,HSBC,CitiBank New York,58686,54272,4414
2010-05-01,HSBC,CitiBank New York,52532,56418,-3886
2010-06-01,HSBC,CitiBank New York,55693,52595,3098
2010-07-01,HSBC,CitiBank New York,51952,56575,-4623
2010-08-01,HSBC,CitiBank New York,54489,57215,-2726
2010-09-01,HSBC,CitiBank New York,52849,52444,405
2010-10-01,HSBC,CitiBank New York,55765,57835,-2070
2010-11-01,HSBC,CitiBank New York,52612,51672,940
2010-12-01,HSBC,CitiBank New York,58171,56859,1312
2011-01-01,HSBC,CitiBank New York,55239,54111,1128
2011-02-01,HSBC,CitiBank New York,51699,57777,-6078
2011-03-01,HSBC,CitiBank New York,59838,56824,3014
2011-04-01,HSBC,CitiBank New York,53267,55158,-1891
2011-05-01,HSBC,CitiBank New York,58676,51742,6934
2011-06-01,HSBC,CitiBank New York,59839,56151,3688
2011-07-01,HSBC,CitiBank New York,51988,55961,-3973
2011-08-01,HSBC,CitiBank New York,59619,53776,5843
2011-09-01,HSBC,CitiBank New York,61928,69644,-7716
2011-10-01,HSBC,CitiBank New York,62657,64746,-2089
2011-11-01,HSBC,CitiBank New York,68273,63287,4986
2011-12-01,HSBC,CitiBank New York,67517,63257,4260
2012-01-01,HSBC,CitiBank New York,68951,65216,3735
2012-02-01,HSBC,CitiBank New York,66679,69682,-3003
2012-03-01,HSBC,CitiBank New York,62161,63972,-1811
2012-04-01,HSBC,CitiBank New York,63582,64691,-1109
2012-05-01,HSBC,CitiBank New York,64647,63841,806
2012-06-01,HSBC,CitiBank New York,64639,65314,-675
2012-07-01,HSBC,CitiBank New York,66991,63414,3577
2012-08-01,HSBC,CitiBank New York,69784,66269,3515
2012-09-01,HSBC,CitiBank New York,69565,63319,6246
2012-10-01,HSBC,CitiBank New York,63491,67763,-4272
2012-11-01,HSBC,CitiBank New York,62988,62134,854
2012-12-01,HSBC,CitiBank New York,64784,66959,-2175
2013-01-01,HSBC,CitiBank New York,63495,64775,-1280
2013-02-01,HSBC,CitiBank New York,66722,69533,-2811
2013-03-01,HSBC,CitiBank New York,62891,68938,-6047
2013-04-01,HSBC,CitiBank New York,66879,63353,3526
2013-05-01,HSBC,CitiBank New York,78568,72467,6101
2013-06-01,HSBC,CitiBank New York,76695,78465,-1770
2013-07-01,HSBC,CitiBank New York,71286,78347,-7061
2013-08-01,HSBC,CitiBank New York,75845,72485,3360
2013-09-01,HSBC,CitiBank New York,77542,77778,-236
2013-10-01,HSBC,CitiBank New York,77797,74932,2865
2013-11-01,HSBC,CitiBank New York,78537,73378,5159
2013-12-01,HSBC,CitiBank New York,72994,79769,-6775
2014-01-01,HSBC,CitiBank New York,76364,77351,-987
2014-02-01,HSBC,CitiBank New York,72787,74184,-1397
2014-03-01,HSBC,CitiBank New York,71279,72827,-1548
2014-04-01,HSBC,CitiBank New York,77128,72858,4270
2014-05-01,HSBC,CitiBank New York,75277,75685,-408
2014-06-01,HSBC,CitiBank New York,74421,74817,-396
2014-07-01,HSBC,CitiBank New York,79512,72414,7098
2014-08-01,HSBC,CitiBank New York,74152,76414,-2262
2014-09-01,HSBC,CitiBank New York,79994,72711,7283
2014-10-01,HSBC,CitiBank New York,71736,77573,-5837
2014-11-01,HSBC,CitiBank New York,77318,71892,5426
2014-12-01,HSBC,CitiBank New York,77682,75259,2423
2015-01-01,HSBC,CitiBank New York,89655,85499,4156
2015-02-01,HSBC,CitiBank New York,88962,83994,4968
2015-03-01,HSBC,CitiBank New York,89285,88249,1036
2015-04-01,HSBC,CitiBank New York,88189,82279,5910
2015-05-01,HSBC,CitiBank New York,83866,89611,-5745
2015-06-01,HSBC,CitiBank New York,88253,87172,1081
2015-07-01,HSBC,CitiBank New York,85113,84745,368
2015-08-01,HSBC,CitiBank New York,84945,89526,-4581
2015-09-01,HSBC,CitiBank New York,86726,89131,-2405
2015-10-01,HSBC,CitiBank New York,81292,86731,-5439
2015-11-01,HSBC,CitiBank New York,84593,82717,1876
2015-12-01,HSBC,CitiBank New York,89251,82883,6368
2016-01-01,HSBC,CitiBank New York,81195,81498,-303
2016-02-01,HSBC,CitiBank New York,83189,89516,-6327
2016-03-01,HSBC,CitiBank New York,82778,88876,-6098
2016-04-01,HSBC,CitiBank New York,86222,82811,3411
2016-05-01,HSBC,CitiBank New York,84289,84976,-687
2016-06-01,HSBC,CitiBank New York,81365,88866,-7501
2016-07-01,HSBC,CitiBank New York,82418,83518,-1100
2016-08-01,HSBC,CitiBank New York,86391,82345,4046
2016-09-01,HSBC,CitiBank New York,91272,92368,-1096
2016-10-01,HSBC,CitiBank New York,94865,94326,539
2016-11-01,HSBC,CitiBank New York,93329,98226,-4897
2016-12-01,HSBC,CitiBank New York,92769,95561,-2792
2017-01-01,HSBC,CitiBank New York,96136,96624,-488
2017-02-01,HSBC,CitiBank New York,99962,94827,5135
2017-03-01,HSBC,CitiBank New York,94558,91586,2972
2017-04-01,HSBC,CitiBank New York,95172,98752,-3580
2017-05-01,HSBC,CitiBank New York,97797,96696,1101
2017-06-01,HSBC,CitiBank New York,94661,96965,-2304
2017-07-01,HSBC,CitiBank New York,95538,92372,3166
2017-08-01,HSBC,CitiBank New York,97492,97433,59
2017-09-01,HSBC,CitiBank New York,93812,99311,-5499
2017-10-01,HSBC,CitiBank New York,95635,96161,-526
2017-11-01,HSBC,CitiBank New York,96561,91471,5090
2017-12-01,HSBC,CitiBank New York,95183,96213,-1030
2018-01-01,HSBC,CitiBank New York,97933,99536,-1603
2018-02-01,HSBC,CitiBank New York,95587,95549,38
2018-03-01,HSBC,CitiBank New York,95758,98474,-2716
2018-04-01,HSBC,CitiBank New York,98855,91652,7203
2010-01-01,HSBC,CitiBank London,52665,51436,1229
2010-02-01,HSBC,CitiBank London,58259,54123,4136
2010-03-01,HSBC,CitiBank London,52767,57335,-4568
2010-04-01,HSBC,CitiBank London,51997,52988,-991
2010-05-01,HSBC,CitiBank London,56433,59431,-2998
2010-06-01,HSBC,CitiBank London,58686,52493,6193
2010-07-01,HSBC,CitiBank London,53535,56931,-3396
2010-08-01,HSBC,CitiBank London,53342,57869,-4527
2010-09-01,HSBC,CitiBank London,56679,53834,2845
2010-10-01,HSBC,CitiBank London,55144,58559,-3415
2010-11-01,HSBC,CitiBank London,58574,52894,5680
2010-12-01,HSBC,CitiBank London,55256,51452,3804
2011-01-01,HSBC,CitiBank London,51484,55973,-4489
2011-02-01,HSBC,CitiBank London,56588,51611,4977
2011-03-01,HSBC,CitiBank London,55662,58794,-3132
2011-04-01,HSBC,CitiBank London,57933,54268,3665
2011-05-01,HSBC,CitiBank London,51847,57436,-5589
2011-06-01,HSBC,CitiBank London,58223,53242,4981
2011-07-01,HSBC,CitiBank London,57541,56823,718
2011-08-01,HSBC,CitiBank London,57223,55349,1874
2011-09-01,HSBC,CitiBank London,67463,65876,1587
2011-10-01,HSBC,CitiBank London,65541,62374,3167
2011-11-01,HSBC,CitiBank London,68215,62123,6092
2011-12-01,HSBC,CitiBank London,67259,67194,65
2012-01-01,HSBC,CitiBank London,67657,68139,-482
2012-02-01,HSBC,CitiBank London,64663,64156,507
2012-03-01,HSBC,CitiBank London,63412,69382,-5970
2012-04-01,HSBC,CitiBank London,67821,65941,1880
2012-05-01,HSBC,CitiBank London,67735,61998,5737
2012-06-01,HSBC,CitiBank London,65324,61212,4112
2012-07-01,HSBC,CitiBank London,62623,68764,-6141
2012-08-01,HSBC,CitiBank London,68678,68938,-260
2012-09-01,HSBC,CitiBank London,61779,68696,-6917
2012-10-01,HSBC,CitiBank London,65436,64597,839
2012-11-01,HSBC,CitiBank London,67893,64487,3406
2012-12-01,HSBC,CitiBank London,65883,66385,-502
2013-01-01,HSBC,CitiBank London,65952,66918,-966
2013-02-01,HSBC,CitiBank London,61655,65586,-3931
2013-03-01,HSBC,CitiBank London,63376,64852,-1476
2013-04-01,HSBC,CitiBank London,65688,63187,2501
2013-05-01,HSBC,CitiBank London,76769,72671,4098
2013-06-01,HSBC,CitiBank London,78226,77192,1034
2013-07-01,HSBC,CitiBank London,73363,77958,-4595
2013-08-01,HSBC,CitiBank London,76426,75435,991
2013-09-01,HSBC,CitiBank London,72861,71294,1567
2013-10-01,HSBC,CitiBank London,74179,71434,2745
2013-11-01,HSBC,CitiBank London,79827,72562,7265
2013-12-01,HSBC,CitiBank London,79548,76559,2989
2014-01-01,HSBC,CitiBank London,74297,76133,-1836
2014-02-01,HSBC,CitiBank London,77713,72182,5531
2014-03-01,HSBC,CitiBank London,76194,78768,-2574
2014-04-01,HSBC,CitiBank London,71726,79391,-7665
2014-05-01,HSBC,CitiBank London,71629,74346,-2717
2014-06-01,HSBC,CitiBank London,72591,71554,1037
2014-07-01,HSBC,CitiBank London,71322,73254,-1932
2014-08-01,HSBC,CitiBank London,74412,72662,1750
2014-09-01,HSBC,CitiBank London,72567,77657,-5090
2014-10-01,HSBC,CitiBank London,79312,73974,5338
2014-11-01,HSBC,CitiBank London,73141,79631,-6490
2014-12-01,HSBC,CitiBank London,75116,76377,-1261
2015-01-01,HSBC,CitiBank London,84431,85456,-1025
2015-02-01,HSBC,CitiBank London,89453,87548,1905
2015-03-01,HSBC,CitiBank London,88169,86889,1280
2015-04-01,HSBC,CitiBank London,84842,83964,878
2015-05-01,HSBC,CitiBank London,89723,83323,6400
2015-06-01,HSBC,CitiBank London,85449,86433,-984
2015-07-01,HSBC,CitiBank London,89678,81593,8085
2015-08-01,HSBC,CitiBank London,87576,83571,4005
2015-09-01,HSBC,CitiBank London,81724,87425,-5701
2015-10-01,HSBC,CitiBank London,82445,87328,-4883
2015-11-01,HSBC,CitiBank London,88236,85732,2504
2015-12-01,HSBC,CitiBank London,86977,83933,3044
2016-01-01,HSBC,CitiBank London,81193,83111,-1918
2016-02-01,HSBC,CitiBank London,81571,86674,-5103
2016-03-01,HSBC,CitiBank London,88864,88825,39
2016-04-01,HSBC,CitiBank London,83125,81475,1650
2016-05-01,HSBC,CitiBank London,85743,81735,4008
2016-06-01,HSBC,CitiBank London,85565,87312,-1747
2016-07-01,HSBC,CitiBank London,81613,88744,-7131
2016-08-01,HSBC,CitiBank London,85471,87897,-2426
2016-09-01,HSBC,CitiBank London,96524,98865,-2341
2016-10-01,HSBC,CitiBank London,98977,98572,405
2016-11-01,HSBC,CitiBank London,93917,94838,-921
2016-12-01,HSBC,CitiBank London,98767,93648,5119
2017-01-01,HSBC,CitiBank London,95728,91334,4394
2017-02-01,HSBC,CitiBank London,93543,98661,-5118
2017-03-01,HSBC,CitiBank London,94462,95457,-995
2017-04-01,HSBC,CitiBank London,91981,98365,-6384
2017-05-01,HSBC,CitiBank London,94985,98768,-3783
2017-06-01,HSBC,CitiBank London,92117,96258,-4141
2017-07-01,HSBC,CitiBank London,98322,97626,696
2017-08-01,HSBC,CitiBank London,93433,95226,-1793
2017-09-01,HSBC,CitiBank London,98821,93521,5300
2017-10-01,HSBC,CitiBank London,98141,92559,5582
2017-11-01,HSBC,CitiBank London,98897,96532,2365
2017-12-01,HSBC,CitiBank London,99155,94184,4971
2018-01-01,HSBC,CitiBank London,96483,97168,-685
2018-02-01,HSBC,CitiBank London,93171,91647,1524
2018-03-01,HSBC,CitiBank London,95968,94289,1679
2018-04-01,HSBC,CitiBank London,93165,97391,-4226
2010-01-01,HSBC,CitiBank Pune,56327,52543,3784
2010-02-01,HSBC,CitiBank Pune,52379,58772,-6393
2010-03-01,HSBC,CitiBank Pune,53297,59671,-6374
2010-04-01,HSBC,CitiBank Pune,56655,51393,5262
2010-05-01,HSBC,CitiBank Pune,56288,52736,3552
2010-06-01,HSBC,CitiBank Pune,56922,58743,-1821
2010-07-01,HSBC,CitiBank Pune,53696,59946,-6250
2010-08-01,HSBC,CitiBank Pune,59421,51677,7744
2010-09-01,HSBC,CitiBank Pune,58125,56186,1939
2010-10-01,HSBC,CitiBank Pune,58131,59666,-1535
2010-11-01,HSBC,CitiBank Pune,56932,57953,-1021
2010-12-01,HSBC,CitiBank Pune,51873,59626,-7753
2011-01-01,HSBC,CitiBank Pune,51265,57667,-6402
2011-02-01,HSBC,CitiBank Pune,56517,53655,2862
2011-03-01,HSBC,CitiBank Pune,51875,52881,-1006
2011-04-01,HSBC,CitiBank Pune,59355,53691,5664
2011-05-01,HSBC,CitiBank Pune,52629,58495,-5866
2011-06-01,HSBC,CitiBank Pune,52785,53492,-707
2011-07-01,HSBC,CitiBank Pune,57637,52298,5339
2011-08-01,HSBC,CitiBank Pune,56197,57364,-1167
2011-09-01,HSBC,CitiBank Pune,67979,64882,3097
2011-10-01,HSBC,CitiBank Pune,66698,65234,1464
2011-11-01,HSBC,CitiBank Pune,61776,61967,-191
2011-12-01,HSBC,CitiBank Pune,62492,67663,-5171
2012-01-01,HSBC,CitiBank Pune,68248,62833,5415
2012-02-01,HSBC,CitiBank Pune,66588,68534,-1946
2012-03-01,HSBC,CitiBank Pune,65673,64838,835
2012-04-01,HSBC,CitiBank Pune,63387,68225,-4838
2012-05-01,HSBC,CitiBank Pune,63166,68764,-5598
2012-06-01,HSBC,CitiBank Pune,61639,66933,-5294
2012-07-01,HSBC,CitiBank Pune,69319,67447,1872
2012-08-01,HSBC,CitiBank Pune,67637,61523,6114
2012-09-01,HSBC,CitiBank Pune,64125,68527,-4402
2012-10-01,HSBC,CitiBank Pune,63871,65872,-2001
2012-11-01,HSBC,CitiBank Pune,64387,67229,-2842
2012-12-01,HSBC,CitiBank Pune,66847,63374,3473
2013-01-01,HSBC,CitiBank Pune,69346,62445,6901
2013-02-01,HSBC,CitiBank Pune,69956,61899,8057
2013-03-01,HSBC,CitiBank Pune,64527,65848,-1321
2013-04-01,HSBC,CitiBank Pune,62291,65945,-3654
2013-05-01,HSBC,CitiBank Pune,78358,79136,-778
2013-06-01,HSBC,CitiBank Pune,75385,76449,-1064
2013-07-01,HSBC,CitiBank Pune,72696,72735,-39
2013-08-01,HSBC,CitiBank Pune,77538,77583,-45
2013-09-01,HSBC,CitiBank Pune,75918,76432,-514
2013-10-01,HSBC,CitiBank Pune,75556,71136,4420
2013-11-01,HSBC,CitiBank Pune,71226,73248,-2022
2013-12-01,HSBC,CitiBank Pune,73572,71988,1584
2014-01-01,HSBC,CitiBank Pune,79815,76929,2886
2014-02-01,HSBC,CitiBank Pune,73398,75589,-2191
2014-03-01,HSBC,CitiBank Pune,77438,73761,3677
2014-04-01,HSBC,CitiBank Pune,76567,73261,3306
2014-05-01,HSBC,CitiBank Pune,78442,78531,-89
2014-06-01,HSBC,CitiBank Pune,73397,79923,-6526
2014-07-01,HSBC,CitiBank Pune,71599,74633,-3034
2014-08-01,HSBC,CitiBank Pune,75996,76261,-265
2014-09-01,HSBC,CitiBank Pune,75578,75618,-40
2014-10-01,HSBC,CitiBank Pune,71498,75286,-3788
2014-11-01,HSBC,CitiBank Pune,72455,76824,-4369
2014-12-01,HSBC,CitiBank Pune,79375,73714,5661
2015-01-01,HSBC,CitiBank Pune,87757,84881,2876
2015-02-01,HSBC,CitiBank Pune,88164,82219,5945
2015-03-01,HSBC,CitiBank Pune,85828,82653,3175
2015-04-01,HSBC,CitiBank Pune,87172,83161,4011
2015-05-01,HSBC,CitiBank Pune,88154,87299,855
2015-06-01,HSBC,CitiBank Pune,83424,84121,-697
2015-07-01,HSBC,CitiBank Pune,85939,82151,3788
2015-08-01,HSBC,CitiBank Pune,87654,89483,-1829
2015-09-01,HSBC,CitiBank Pune,84163,81634,2529
2015-10-01,HSBC,CitiBank Pune,87856,83751,4105
2015-11-01,HSBC,CitiBank Pune,83799,82837,962
2015-12-01,HSBC,CitiBank Pune,83283,86272,-2989
2016-01-01,HSBC,CitiBank Pune,87639,87676,-37
2016-02-01,HSBC,CitiBank Pune,85774,89412,-3638
2016-03-01,HSBC,CitiBank Pune,81596,89979,-8383
2016-04-01,HSBC,CitiBank Pune,87679,87247,432
2016-05-01,HSBC,CitiBank Pune,88182,89743,-1561
2016-06-01,HSBC,CitiBank Pune,85699,88366,-2667
2016-07-01,HSBC,CitiBank Pune,86697,83565,3132
2016-08-01,HSBC,CitiBank Pune,82633,89372,-6739
2016-09-01,HSBC,CitiBank Pune,92118,98559,-6441
2016-10-01,HSBC,CitiBank Pune,92296,98117,-5821
2016-11-01,HSBC,CitiBank Pune,99388,96631,2757
2016-12-01,HSBC,CitiBank Pune,95191,91549,3642
2017-01-01,HSBC,CitiBank Pune,99128,99565,-437
2017-02-01,HSBC,CitiBank Pune,92955,91255,1700
2017-03-01,HSBC,CitiBank Pune,98252,94799,3453
2017-04-01,HSBC,CitiBank Pune,98776,91948,6828
2017-05-01,HSBC,CitiBank Pune,99776,95922,3854
2017-06-01,HSBC,CitiBank Pune,91347,93487,-2140
2017-07-01,HSBC,CitiBank Pune,97634,95965,1669
2017-08-01,HSBC,CitiBank Pune,96286,98169,-1883
2017-09-01,HSBC,CitiBank Pune,97872,93484,4388
2017-10-01,HSBC,CitiBank Pune,94533,99876,-5343
2017-11-01,HSBC,CitiBank Pune,94998,94247,751
2017-12-01,HSBC,CitiBank Pune,98847,98166,681
2018-01-01,HSBC,CitiBank Pune,94937,98371,-3434
2018-02-01,HSBC,CitiBank Pune,94247,92728,1519
2018-03-01,HSBC,CitiBank Pune,92624,98661,-6037
2018-04-01,HSBC,CitiBank Pune,99677,94811,4866
2010-01-01,HSBC,CitiBank Singapore,55447,58325,-2878
2010-02-01,HSBC,CitiBank Singapore,56665,55814,851
2010-03-01,HSBC,CitiBank Singapore,54789,51893,2896
2010-04-01,HSBC,CitiBank Singapore,59457,51713,7744
2010-05-01,HSBC,CitiBank Singapore,57779,56456,1323
2010-06-01,HSBC,CitiBank Singapore,53681,53351,330
2010-07-01,HSBC,CitiBank Singapore,54246,56782,-2536
2010-08-01,HSBC,CitiBank Singapore,55849,56145,-296
2010-09-01,HSBC,CitiBank Singapore,57333,56411,922
2010-10-01,HSBC,CitiBank Singapore,51438,54142,-2704
2010-11-01,HSBC,CitiBank Singapore,58569,52158,6411
2010-12-01,HSBC,CitiBank Singapore,55369,52137,3232
2011-01-01,HSBC,CitiBank Singapore,59947,55482,4465
2011-02-01,HSBC,CitiBank Singapore,54118,54758,-640
2011-03-01,HSBC,CitiBank Singapore,56813,55433,1380
2011-04-01,HSBC,CitiBank Singapore,54316,52332,1984
2011-05-01,HSBC,CitiBank Singapore,55895,53828,2067
2011-06-01,HSBC,CitiBank Singapore,52359,59594,-7235
2011-07-01,HSBC,CitiBank Singapore,57383,51385,5998
2011-08-01,HSBC,CitiBank Singapore,59855,53355,6500
2011-09-01,HSBC,CitiBank Singapore,68299,63542,4757
2011-10-01,HSBC,CitiBank Singapore,63316,64146,-830
2011-11-01,HSBC,CitiBank Singapore,68663,61163,7500
2011-12-01,HSBC,CitiBank Singapore,66776,63923,2853
2012-01-01,HSBC,CitiBank Singapore,66924,61255,5669
2012-02-01,HSBC,CitiBank Singapore,68251,67446,805
2012-03-01,HSBC,CitiBank Singapore,65275,64681,594
2012-04-01,HSBC,CitiBank Singapore,63158,69554,-6396
2012-05-01,HSBC,CitiBank Singapore,66579,69963,-3384
2012-06-01,HSBC,CitiBank Singapore,66442,67894,-1452
2012-07-01,HSBC,CitiBank Singapore,61268,66956,-5688
2012-08-01,HSBC,CitiBank Singapore,68382,63546,4836
2012-09-01,HSBC,CitiBank Singapore,64915,62471,2444
2012-10-01,HSBC,CitiBank Singapore,64664,61237,3427
2012-11-01,HSBC,CitiBank Singapore,62752,63581,-829
2012-12-01,HSBC,CitiBank Singapore,64697,65858,-1161
2013-01-01,HSBC,CitiBank Singapore,63117,69818,-6701
2013-02-01,HSBC,CitiBank Singapore,67937,63479,4458
2013-03-01,HSBC,CitiBank Singapore,68679,69521,-842
2013-04-01,HSBC,CitiBank Singapore,66378,62365,4013
2013-05-01,HSBC,CitiBank Singapore,77289,72834,4455
2013-06-01,HSBC,CitiBank Singapore,78112,73849,4263
2013-07-01,HSBC,CitiBank Singapore,72638,71678,960
2013-08-01,HSBC,CitiBank Singapore,73941,74823,-882
2013-09-01,HSBC,CitiBank Singapore,72791,77936,-5145
2013-10-01,HSBC,CitiBank Singapore,72553,72814,-261
2013-11-01,HSBC,CitiBank Singapore,77367,79483,-2116
2013-12-01,HSBC,CitiBank Singapore,75957,77112,-1155
2014-01-01,HSBC,CitiBank Singapore,72171,73134,-963
2014-02-01,HSBC,CitiBank Singapore,76699,78744,-2045
2014-03-01,HSBC,CitiBank Singapore,77625,78484,-859
2014-04-01,HSBC,CitiBank Singapore,77446,78527,-1081
2014-05-01,HSBC,CitiBank Singapore,74743,73623,1120
2014-06-01,HSBC,CitiBank Singapore,76692,71533,5159
2014-07-01,HSBC,CitiBank Singapore,76718,75382,1336
2014-08-01,HSBC,CitiBank Singapore,76817,73567,3250
2014-09-01,HSBC,CitiBank Singapore,71871,71745,126
2014-10-01,HSBC,CitiBank Singapore,71986,73734,-1748
2014-11-01,HSBC,CitiBank Singapore,71788,76173,-4385
2014-12-01,HSBC,CitiBank Singapore,72852,71816,1036
2015-01-01,HSBC,CitiBank Singapore,81443,82316,-873
2015-02-01,HSBC,CitiBank Singapore,83662,87995,-4333
2015-03-01,HSBC,CitiBank Singapore,87227,84991,2236
2015-04-01,HSBC,CitiBank Singapore,85229,83592,1637
2015-05-01,HSBC,CitiBank Singapore,83479,84193,-714
2015-06-01,HSBC,CitiBank Singapore,81373,89626,-8253
2015-07-01,HSBC,CitiBank Singapore,88988,87133,1855
2015-08-01,HSBC,CitiBank Singapore,86286,89861,-3575
2015-09-01,HSBC,CitiBank Singapore,86346,81774,4572
2015-10-01,HSBC,CitiBank Singapore,84217,83571,646
2015-11-01,HSBC,CitiBank Singapore,87876,89354,-1478
2015-12-01,HSBC,CitiBank Singapore,88466,87471,995
2016-01-01,HSBC,CitiBank Singapore,84663,88385,-3722
2016-02-01,HSBC,CitiBank Singapore,88856,88477,379
2016-03-01,HSBC,CitiBank Singapore,82523,82517,6
2016-04-01,HSBC,CitiBank Singapore,83827,87625,-3798
2016-05-01,HSBC,CitiBank Singapore,83444,83272,172
2016-06-01,HSBC,CitiBank Singapore,84897,87145,-2248
2016-07-01,HSBC,CitiBank Singapore,81768,89312,-7544
2016-08-01,HSBC,CitiBank Singapore,89374,81166,8208
2016-09-01,HSBC,CitiBank Singapore,92739,96538,-3799
2016-10-01,HSBC,CitiBank Singapore,93798,91656,2142
2016-11-01,HSBC,CitiBank Singapore,94327,91733,2594
2016-12-01,HSBC,CitiBank Singapore,97799,98834,-1035
2017-01-01,HSBC,CitiBank Singapore,91242,96494,-5252
2017-02-01,HSBC,CitiBank Singapore,97753,91724,6029
2017-03-01,HSBC,CitiBank Singapore,99134,99761,-627
2017-04-01,HSBC,CitiBank Singapore,91468,94854,-3386
2017-05-01,HSBC,CitiBank Singapore,99973,98743,1230
2017-06-01,HSBC,CitiBank Singapore,99771,99684,87
2017-07-01,HSBC,CitiBank Singapore,98968,96645,2323
2017-08-01,HSBC,CitiBank Singapore,98716,98523,193
2017-09-01,HSBC,CitiBank Singapore,92439,97588,-5149
2017-10-01,HSBC,CitiBank Singapore,91333,91788,-455
2017-11-01,HSBC,CitiBank Singapore,97117,95196,1921
2017-12-01,HSBC,CitiBank Singapore,97437,99484,-2047
2018-01-01,HSBC,CitiBank Singapore,91172,94411,-3239
2018-02-01,HSBC,CitiBank Singapore,92219,96326,-4107
2018-03-01,HSBC,CitiBank Singapore,94835,96762,-1927
2018-04-01,HSBC,CitiBank Singapore,96948,98715,-1767
2010-01-01,HSBC,CitiBank HongKong,57891,51826,6065
2010-02-01,HSBC,CitiBank HongKong,57681,51562,6119
2010-03-01,HSBC,CitiBank HongKong,57493,56863,630
2010-04-01,HSBC,CitiBank HongKong,54378,58553,-4175
2010-05-01,HSBC,CitiBank HongKong,52824,54972,-2148
2010-06-01,HSBC,CitiBank HongKong,57594,58754,-1160
2010-07-01,HSBC,CitiBank HongKong,55358,51732,3626
2010-08-01,HSBC,CitiBank HongKong,59654,59981,-327
2010-09-01,HSBC,CitiBank HongKong,51443,52752,-1309
2010-10-01,HSBC,CitiBank HongKong,57933,52668,5265
2010-11-01,HSBC,CitiBank HongKong,53385,55717,-2332
2010-12-01,HSBC,CitiBank HongKong,59596,52136,7460
2011-01-01,HSBC,CitiBank HongKong,54427,52642,1785
2011-02-01,HSBC,CitiBank HongKong,57238,55196,2042
2011-03-01,HSBC,CitiBank HongKong,51522,51383,139
2011-04-01,HSBC,CitiBank HongKong,57715,57731,-16
2011-05-01,HSBC,CitiBank HongKong,52885,57963,-5078
2011-06-01,HSBC,CitiBank HongKong,56811,57462,-651
2011-07-01,HSBC,CitiBank HongKong,58152,53542,4610
2011-08-01,HSBC,CitiBank HongKong,54546,57521,-2975
2011-09-01,HSBC,CitiBank HongKong,61979,68472,-6493
2011-10-01,HSBC,CitiBank HongKong,66325,67498,-1173
2011-11-01,HSBC,CitiBank HongKong,61419,65738,-4319
2011-12-01,HSBC,CitiBank HongKong,65271,65213,58
2012-01-01,HSBC,CitiBank HongKong,61488,68548,-7060
2012-02-01,HSBC,CitiBank HongKong,65275,65994,-719
2012-03-01,HSBC,CitiBank HongKong,62644,68951,-6307
2012-04-01,HSBC,CitiBank HongKong,64239,69285,-5046
2012-05-01,HSBC,CitiBank HongKong,64166,61889,2277
2012-06-01,HSBC,CitiBank HongKong,62579,67163,-4584
2012-07-01,HSBC,CitiBank HongKong,66383,68529,-2146
2012-08-01,HSBC,CitiBank HongKong,63416,62612,804
2012-09-01,HSBC,CitiBank HongKong,68529,61677,6852
2012-10-01,HSBC,CitiBank HongKong,65575,67825,-2250
2012-11-01,HSBC,CitiBank HongKong,63134,64764,-1630
2012-12-01,HSBC,CitiBank HongKong,68815,67589,1226
2013-01-01,HSBC,CitiBank HongKong,62944,63155,-211
2013-02-01,HSBC,CitiBank HongKong,64471,63197,1274
2013-03-01,HSBC,CitiBank HongKong,61756,69656,-7900
2013-04-01,HSBC,CitiBank HongKong,64585,63799,786
2013-05-01,HSBC,CitiBank HongKong,77898,79893,-1995
2013-06-01,HSBC,CitiBank HongKong,79672,77529,2143
2013-07-01,HSBC,CitiBank HongKong,79475,77361,2114
2013-08-01,HSBC,CitiBank HongKong,74326,73758,568
2013-09-01,HSBC,CitiBank HongKong,75699,73614,2085
2013-10-01,HSBC,CitiBank HongKong,74819,77241,-2422
2013-11-01,HSBC,CitiBank HongKong,73571,72397,1174
2013-12-01,HSBC,CitiBank HongKong,79768,75652,4116
2014-01-01,HSBC,CitiBank HongKong,73358,76425,-3067
2014-02-01,HSBC,CitiBank HongKong,74562,73833,729
2014-03-01,HSBC,CitiBank HongKong,75282,72764,2518
2014-04-01,HSBC,CitiBank HongKong,77997,75119,2878
2014-05-01,HSBC,CitiBank HongKong,72311,73447,-1136
2014-06-01,HSBC,CitiBank HongKong,74222,74196,26
2014-07-01,HSBC,CitiBank HongKong,72165,75738,-3573
2014-08-01,HSBC,CitiBank HongKong,72722,71574,1148
2014-09-01,HSBC,CitiBank HongKong,72375,73982,-1607
2014-10-01,HSBC,CitiBank HongKong,71275,78515,-7240
2014-11-01,HSBC,CitiBank HongKong,77142,72642,4500
2014-12-01,HSBC,CitiBank HongKong,78272,76436,1836
2015-01-01,HSBC,CitiBank HongKong,84583,87358,-2775
2015-02-01,HSBC,CitiBank HongKong,84439,85923,-1484
2015-03-01,HSBC,CitiBank HongKong,84165,83142,1023
2015-04-01,HSBC,CitiBank HongKong,88811,86861,1950
2015-05-01,HSBC,CitiBank HongKong,82864,85834,-2970
2015-06-01,HSBC,CitiBank HongKong,81913,89759,-7846
2015-07-01,HSBC,CitiBank HongKong,85325,89613,-4288
2015-08-01,HSBC,CitiBank HongKong,86955,88523,-1568
2015-09-01,HSBC,CitiBank HongKong,89159,82545,6614
2015-10-01,HSBC,CitiBank HongKong,84552,88613,-4061
2015-11-01,HSBC,CitiBank HongKong,85176,81188,3988
2015-12-01,HSBC,CitiBank HongKong,83686,89253,-5567
2016-01-01,HSBC,CitiBank HongKong,88567,89397,-830
2016-02-01,HSBC,CitiBank HongKong,88239,85528,2711
2016-03-01,HSBC,CitiBank HongKong,89896,89827,69
2016-04-01,HSBC,CitiBank HongKong,83451,81461,1990
2016-05-01,HSBC,CitiBank HongKong,84125,85887,-1762
2016-06-01,HSBC,CitiBank HongKong,82275,89457,-7182
2016-07-01,HSBC,CitiBank HongKong,89155,84477,4678
2016-08-01,HSBC,CitiBank HongKong,85265,81635,3630
2016-09-01,HSBC,CitiBank HongKong,97738,93969,3769
2016-10-01,HSBC,CitiBank HongKong,94458,98333,-3875
2016-11-01,HSBC,CitiBank HongKong,95634,99217,-3583
2016-12-01,HSBC,CitiBank HongKong,98689,93426,5263
2017-01-01,HSBC,CitiBank HongKong,98644,92365,6279
2017-02-01,HSBC,CitiBank HongKong,97581,91826,5755
2017-03-01,HSBC,CitiBank HongKong,93299,92875,424
2017-04-01,HSBC,CitiBank HongKong,97481,96663,818
2017-05-01,HSBC,CitiBank HongKong,91192,91551,-359
2017-06-01,HSBC,CitiBank HongKong,91834,97392,-5558
2017-07-01,HSBC,CitiBank HongKong,99739,97745,1994
2017-08-01,HSBC,CitiBank HongKong,94772,94341,431
2017-09-01,HSBC,CitiBank HongKong,97596,98873,-1277
2017-10-01,HSBC,CitiBank HongKong,98948,93699,5249
2017-11-01,HSBC,CitiBank HongKong,93495,96269,-2774
2017-12-01,HSBC,CitiBank HongKong,93123,94547,-1424
2018-01-01,HSBC,CitiBank HongKong,97696,99935,-2239
2018-02-01,HSBC,CitiBank HongKong,92657,95411,-2754
2018-03-01,HSBC,CitiBank HongKong,99863,93134,6729
2018-04-01,HSBC,CitiBank HongKong,95437,99131,-3694
2010-01-01,BNY Mellon,CitiBank New York,55126,53365,1761
2010-02-01,BNY Mellon,CitiBank New York,59944,59154,790
2010-03-01,BNY Mellon,CitiBank New York,57585,58461,-876
2010-04-01,BNY Mellon,CitiBank New York,52469,57175,-4706
2010-05-01,BNY Mellon,CitiBank New York,53677,59292,-5615
2010-06-01,BNY Mellon,CitiBank New York,53639,59545,-5906
2010-07-01,BNY Mellon,CitiBank New York,55614,58433,-2819
2010-08-01,BNY Mellon,CitiBank New York,53884,54374,-490
2010-09-01,BNY Mellon,CitiBank New York,58172,58245,-73
2010-10-01,BNY Mellon,CitiBank New York,52821,51498,1323
2010-11-01,BNY Mellon,CitiBank New York,51742,51641,101
2010-12-01,BNY Mellon,CitiBank New York,54629,51626,3003
2011-01-01,BNY Mellon,CitiBank New York,58188,54592,3596
2011-02-01,BNY Mellon,CitiBank New York,58841,55769,3072
2011-03-01,BNY Mellon,CitiBank New York,58885,52372,6513
2011-04-01,BNY Mellon,CitiBank New York,53374,56419,-3045
2011-05-01,BNY Mellon,CitiBank New York,59251,58747,504
2011-06-01,BNY Mellon,CitiBank New York,59198,51948,7250
2011-07-01,BNY Mellon,CitiBank New York,52677,52488,189
2011-08-01,BNY Mellon,CitiBank New York,54366,53834,532
2011-09-01,BNY Mellon,CitiBank New York,69878,68995,883
2011-10-01,BNY Mellon,CitiBank New York,64618,69839,-5221
2011-11-01,BNY Mellon,CitiBank New York,62154,69791,-7637
2011-12-01,BNY Mellon,CitiBank New York,68248,69694,-1446
2012-01-01,BNY Mellon,CitiBank New York,62593,63455,-862
2012-02-01,BNY Mellon,CitiBank New York,61728,67439,-5711
2012-03-01,BNY Mellon,CitiBank New York,63928,69327,-5399
2012-04-01,BNY Mellon,CitiBank New York,65757,67116,-1359
2012-05-01,BNY Mellon,CitiBank New York,69636,69398,238
2012-06-01,BNY Mellon,CitiBank New York,62594,63957,-1363
2012-07-01,BNY Mellon,CitiBank New York,63384,65945,-2561
2012-08-01,BNY Mellon,CitiBank New York,67428,65625,1803
2012-09-01,BNY Mellon,CitiBank New York,63469,63347,122
2012-10-01,BNY Mellon,CitiBank New York,68425,67153,1272
2012-11-01,BNY Mellon,CitiBank New York,62384,68865,-6481
2012-12-01,BNY Mellon,CitiBank New York,61322,61882,-560
2013-01-01,BNY Mellon,CitiBank New York,65364,63938,1426
2013-02-01,BNY Mellon,CitiBank New York,69652,61531,8121
2013-03-01,BNY Mellon,CitiBank New York,65146,68875,-3729
2013-04-01,BNY Mellon,CitiBank New York,69625,64898,4727
2013-05-01,BNY Mellon,CitiBank New York,75648,78999,-3351
2013-06-01,BNY Mellon,CitiBank New York,79689,73142,6547
2013-07-01,BNY Mellon,CitiBank New York,76818,75888,930
2013-08-01,BNY Mellon,CitiBank New York,76266,74916,1350
2013-09-01,BNY Mellon,CitiBank New York,74799,75977,-1178
2013-10-01,BNY Mellon,CitiBank New York,73462,73465,-3
2013-11-01,BNY Mellon,CitiBank New York,76245,71537,4708
2013-12-01,BNY Mellon,CitiBank New York,75176,71658,3518
2014-01-01,BNY Mellon,CitiBank New York,79388,78788,600
2014-02-01,BNY Mellon,CitiBank New York,72572,77224,-4652
2014-03-01,BNY Mellon,CitiBank New York,76613,76166,447
2014-04-01,BNY Mellon,CitiBank New York,75948,72994,2954
2014-05-01,BNY Mellon,CitiBank New York,74139,77269,-3130
2014-06-01,BNY Mellon,CitiBank New York,75156,75451,-295
2014-07-01,BNY Mellon,CitiBank New York,79371,77912,1459
2014-08-01,BNY Mellon,CitiBank New York,76245,79626,-3381
2014-09-01,BNY Mellon,CitiBank New York,79337,76769,2568
2014-10-01,BNY Mellon,CitiBank New York,71493,73712,-2219
2014-11-01,BNY Mellon,CitiBank New York,76794,77548,-754
2014-12-01,BNY Mellon,CitiBank New York,75827,75783,44
2015-01-01,BNY Mellon,CitiBank New York,82874,82693,181
2015-02-01,BNY Mellon,CitiBank New York,83891,86353,-2462
2015-03-01,BNY Mellon,CitiBank New York,84874,84733,141
2015-04-01,BNY Mellon,CitiBank New York,87182,89665,-2483
2015-05-01,BNY Mellon,CitiBank New York,85618,85441,177
2015-06-01,BNY Mellon,CitiBank New York,87843,89128,-1285
2015-07-01,BNY Mellon,CitiBank New York,86497,86648,-151
2015-08-01,BNY Mellon,CitiBank New York,86484,86227,257
2015-09-01,BNY Mellon,CitiBank New York,83447,84737,-1290
2015-10-01,BNY Mellon,CitiBank New York,89899,83174,6725
2015-11-01,BNY Mellon,CitiBank New York,86734,88638,-1904
2015-12-01,BNY Mellon,CitiBank New York,82832,87669,-4837
2016-01-01,BNY Mellon,CitiBank New York,88445,88362,83
2016-02-01,BNY Mellon,CitiBank New York,84885,89956,-5071
2016-03-01,BNY Mellon,CitiBank New York,87595,88622,-1027
2016-04-01,BNY Mellon,CitiBank New York,84225,85255,-1030
2016-05-01,BNY Mellon,CitiBank New York,89125,86597,2528
2016-06-01,BNY Mellon,CitiBank New York,87192,86463,729
2016-07-01,BNY Mellon,CitiBank New York,83989,85541,-1552
2016-08-01,BNY Mellon,CitiBank New York,81971,82973,-1002
2016-09-01,BNY Mellon,CitiBank New York,93157,95392,-2235
2016-10-01,BNY Mellon,CitiBank New York,99867,92816,7051
2016-11-01,BNY Mellon,CitiBank New York,95938,99135,-3197
2016-12-01,BNY Mellon,CitiBank New York,93166,91684,1482
2017-01-01,BNY Mellon,CitiBank New York,93655,96379,-2724
2017-02-01,BNY Mellon,CitiBank New York,94734,93899,835
2017-03-01,BNY Mellon,CitiBank New York,92214,97224,-5010
2017-04-01,BNY Mellon,CitiBank New York,99261,92628,6633
2017-05-01,BNY Mellon,CitiBank New York,93375,92424,951
2017-06-01,BNY Mellon,CitiBank New York,94722,96538,-1816
2017-07-01,BNY Mellon,CitiBank New York,95944,98745,-2801
2017-08-01,BNY Mellon,CitiBank New York,99845,92598,7247
2017-09-01,BNY Mellon,CitiBank New York,91867,92499,-632
2017-10-01,BNY Mellon,CitiBank New York,91828,95938,-4110
2017-11-01,BNY Mellon,CitiBank New York,93978,93835,143
2017-12-01,BNY Mellon,CitiBank New York,93695,93342,353
2018-01-01,BNY Mellon,CitiBank New York,95596,92745,2851
2018-02-01,BNY Mellon,CitiBank New York,91685,98636,-6951
2018-03-01,BNY Mellon,CitiBank New York,98685,96293,2392
2018-04-01,BNY Mellon,CitiBank New York,96688,91843,4845
2010-01-01,BNY Mellon,CitiBank London,54561,57653,-3092
2010-02-01,BNY Mellon,CitiBank London,54333,51212,3121
2010-03-01,BNY Mellon,CitiBank London,56712,57475,-763
2010-04-01,BNY Mellon,CitiBank London,56963,51177,5786
2010-05-01,BNY Mellon,CitiBank London,51448,58925,-7477
2010-06-01,BNY Mellon,CitiBank London,58986,53444,5542
2010-07-01,BNY Mellon,CitiBank London,53882,53165,717
2010-08-01,BNY Mellon,CitiBank London,52981,57923,-4942
2010-09-01,BNY Mellon,CitiBank London,58431,58646,-215
2010-10-01,BNY Mellon,CitiBank London,52261,59334,-7073
2010-11-01,BNY Mellon,CitiBank London,53286,59522,-6236
2010-12-01,BNY Mellon,CitiBank London,54168,58844,-4676
2011-01-01,BNY Mellon,CitiBank London,53724,57136,-3412
2011-02-01,BNY Mellon,CitiBank London,54332,54294,38
2011-03-01,BNY Mellon,CitiBank London,56146,58982,-2836
2011-04-01,BNY Mellon,CitiBank London,57826,59999,-2173
2011-05-01,BNY Mellon,CitiBank London,57176,58172,-996
2011-06-01,BNY Mellon,CitiBank London,57668,59312,-1644
2011-07-01,BNY Mellon,CitiBank London,58799,54132,4667
2011-08-01,BNY Mellon,CitiBank London,59699,54388,5311
2011-09-01,BNY Mellon,CitiBank London,61927,69823,-7896
2011-10-01,BNY Mellon,CitiBank London,67429,63128,4301
2011-11-01,BNY Mellon,CitiBank London,66821,68537,-1716
2011-12-01,BNY Mellon,CitiBank London,65432,63482,1950
2012-01-01,BNY Mellon,CitiBank London,67249,64248,3001
2012-02-01,BNY Mellon,CitiBank London,62825,68311,-5486
2012-03-01,BNY Mellon,CitiBank London,62998,68922,-5924
2012-04-01,BNY Mellon,CitiBank London,63518,68513,-4995
2012-05-01,BNY Mellon,CitiBank London,64399,61392,3007
2012-06-01,BNY Mellon,CitiBank London,64571,64284,287
2012-07-01,BNY Mellon,CitiBank London,62157,65987,-3830
2012-08-01,BNY Mellon,CitiBank London,64126,69155,-5029
2012-09-01,BNY Mellon,CitiBank London,61943,67554,-5611
2012-10-01,BNY Mellon,CitiBank London,68673,62136,6537
2012-11-01,BNY Mellon,CitiBank London,63371,65929,-2558
2012-12-01,BNY Mellon,CitiBank London,63946,63117,829
2013-01-01,BNY Mellon,CitiBank London,69784,64821,4963
2013-02-01,BNY Mellon,CitiBank London,62726,66785,-4059
2013-03-01,BNY Mellon,CitiBank London,63672,62982,690
2013-04-01,BNY Mellon,CitiBank London,65514,61187,4327
2013-05-01,BNY Mellon,CitiBank London,73339,77582,-4243
2013-06-01,BNY Mellon,CitiBank London,79138,74795,4343
2013-07-01,BNY Mellon,CitiBank London,71633,74958,-3325
2013-08-01,BNY Mellon,CitiBank London,73547,77574,-4027
2013-09-01,BNY Mellon,CitiBank London,73787,77522,-3735
2013-10-01,BNY Mellon,CitiBank London,74759,77266,-2507
2013-11-01,BNY Mellon,CitiBank London,72584,77844,-5260
2013-12-01,BNY Mellon,CitiBank London,75632,73577,2055
2014-01-01,BNY Mellon,CitiBank London,71341,75332,-3991
2014-02-01,BNY Mellon,CitiBank London,77525,73128,4397
2014-03-01,BNY Mellon,CitiBank London,71176,79834,-8658
2014-04-01,BNY Mellon,CitiBank London,79634,78786,848
2014-05-01,BNY Mellon,CitiBank London,77295,76989,306
2014-06-01,BNY Mellon,CitiBank London,73684,72284,1400
2014-07-01,BNY Mellon,CitiBank London,75553,73127,2426
2014-08-01,BNY Mellon,CitiBank London,74838,72588,2250
2014-09-01,BNY Mellon,CitiBank London,71517,74136,-2619
2014-10-01,BNY Mellon,CitiBank London,74281,74525,-244
2014-11-01,BNY Mellon,CitiBank London,75888,78514,-2626
2014-12-01,BNY Mellon,CitiBank London,74954,72687,2267
2015-01-01,BNY Mellon,CitiBank London,84942,82817,2125
2015-02-01,BNY Mellon,CitiBank London,85966,87923,-1957
2015-03-01,BNY Mellon,CitiBank London,82351,88342,-5991
2015-04-01,BNY Mellon,CitiBank London,89888,87258,2630
2015-05-01,BNY Mellon,CitiBank London,88934,84534,4400
2015-06-01,BNY Mellon,CitiBank London,83149,87864,-4715
2015-07-01,BNY Mellon,CitiBank London,84923,84794,129
2015-08-01,BNY Mellon,CitiBank London,85756,81574,4182
2015-09-01,BNY Mellon,CitiBank London,89977,81968,8009
2015-10-01,BNY Mellon,CitiBank London,81283,82254,-971
2015-11-01,BNY Mellon,CitiBank London,83552,84872,-1320
2015-12-01,BNY Mellon,CitiBank London,85216,83673,1543
2016-01-01,BNY Mellon,CitiBank London,81371,86618,-5247
2016-02-01,BNY Mellon,CitiBank London,81551,89859,-8308
2016-03-01,BNY Mellon,CitiBank London,83913,83693,220
2016-04-01,BNY Mellon,CitiBank London,85155,83127,2028
2016-05-01,BNY Mellon,CitiBank London,87697,85391,2306
2016-06-01,BNY Mellon,CitiBank London,89412,83565,5847
2016-07-01,BNY Mellon,CitiBank London,83831,88158,-4327
2016-08-01,BNY Mellon,CitiBank London,88596,83131,5465
2016-09-01,BNY Mellon,CitiBank London,95686,93121,2565
2016-10-01,BNY Mellon,CitiBank London,97576,97296,280
2016-11-01,BNY Mellon,CitiBank London,93322,95192,-1870
2016-12-01,BNY Mellon,CitiBank London,96643,99619,-2976
2017-01-01,BNY Mellon,CitiBank London,99362,91676,7686
2017-02-01,BNY Mellon,CitiBank London,92317,94659,-2342
2017-03-01,BNY Mellon,CitiBank London,98134,91877,6257
2017-04-01,BNY Mellon,CitiBank London,91198,92777,-1579
2017-05-01,BNY Mellon,CitiBank London,98799,92471,6328
2017-06-01,BNY Mellon,CitiBank London,91744,97842,-6098
2017-07-01,BNY Mellon,CitiBank London,96989,93234,3755
2017-08-01,BNY Mellon,CitiBank London,96155,97394,-1239
2017-09-01,BNY Mellon,CitiBank London,92918,92722,196
2017-10-01,BNY Mellon,CitiBank London,96174,94162,2012
2017-11-01,BNY Mellon,CitiBank London,98146,95637,2509
2017-12-01,BNY Mellon,CitiBank London,94965,95473,-508
2018-01-01,BNY Mellon,CitiBank London,94162,99931,-5769
2018-02-01,BNY Mellon,CitiBank London,96313,96584,-271
2018-03-01,BNY Mellon,CitiBank London,99743,96276,3467
2018-04-01,BNY Mellon,CitiBank London,94534,99955,-5421
2010-01-01,BNY Mellon,CitiBank Pune,56635,58189,-1554
2010-02-01,BNY Mellon,CitiBank Pune,58339,59788,-1449
2010-03-01,BNY Mellon,CitiBank Pune,52318,59571,-7253
2010-04-01,BNY Mellon,CitiBank Pune,54745,56336,-1591
2010-05-01,BNY Mellon,CitiBank Pune,53264,53278,-14
2010-06-01,BNY Mellon,CitiBank Pune,57773,54273,3500
2010-07-01,BNY Mellon,CitiBank Pune,56524,56374,150
2010-08-01,BNY Mellon,CitiBank Pune,51554,58852,-7298
2010-09-01,BNY Mellon,CitiBank Pune,57572,51365,6207
2010-10-01,BNY Mellon,CitiBank Pune,53886,51119,2767
2010-11-01,BNY Mellon,CitiBank Pune,52421,51577,844
2010-12-01,BNY Mellon,CitiBank Pune,59383,54264,5119
2011-01-01,BNY Mellon,CitiBank Pune,54944,54797,147
2011-02-01,BNY Mellon,CitiBank Pune,55299,52392,2907
2011-03-01,BNY Mellon,CitiBank Pune,57413,53581,3832
2011-04-01,BNY Mellon,CitiBank Pune,55966,55617,349
2011-05-01,BNY Mellon,CitiBank Pune,52287,53846,-1559
2011-06-01,BNY Mellon,CitiBank Pune,57126,57431,-305
2011-07-01,BNY Mellon,CitiBank Pune,56414,52835,3579
2011-08-01,BNY Mellon,CitiBank Pune,56164,53614,2550
2011-09-01,BNY Mellon,CitiBank Pune,66793,69967,-3174
2011-10-01,BNY Mellon,CitiBank Pune,66461,62397,4064
2011-11-01,BNY Mellon,CitiBank Pune,66988,62861,4127
2011-12-01,BNY Mellon,CitiBank Pune,62879,62215,664
2012-01-01,BNY Mellon,CitiBank Pune,68136,61657,6479
2012-02-01,BNY Mellon,CitiBank Pune,61758,63878,-2120
2012-03-01,BNY Mellon,CitiBank Pune,61447,65841,-4394
2012-04-01,BNY Mellon,CitiBank Pune,64164,62725,1439
2012-05-01,BNY Mellon,CitiBank Pune,69127,66121,3006
2012-06-01,BNY Mellon,CitiBank Pune,69139,65739,3400
2012-07-01,BNY Mellon,CitiBank Pune,64426,65957,-1531
2012-08-01,BNY Mellon,CitiBank Pune,63336,66715,-3379
2012-09-01,BNY Mellon,CitiBank Pune,69783,67879,1904
2012-10-01,BNY Mellon,CitiBank Pune,66515,63299,3216
2012-11-01,BNY Mellon,CitiBank Pune,64134,67729,-3595
2012-12-01,BNY Mellon,CitiBank Pune,64292,63235,1057
2013-01-01,BNY Mellon,CitiBank Pune,69729,64334,5395
2013-02-01,BNY Mellon,CitiBank Pune,68475,67274,1201
2013-03-01,BNY Mellon,CitiBank Pune,61752,66269,-4517
2013-04-01,BNY Mellon,CitiBank Pune,64565,61571,2994
2013-05-01,BNY Mellon,CitiBank Pune,72252,78771,-6519
2013-06-01,BNY Mellon,CitiBank Pune,72677,73842,-1165
2013-07-01,BNY Mellon,CitiBank Pune,78177,77566,611
2013-08-01,BNY Mellon,CitiBank Pune,71757,72994,-1237
2013-09-01,BNY Mellon,CitiBank Pune,79669,72687,6982
2013-10-01,BNY Mellon,CitiBank Pune,76358,77852,-1494
2013-11-01,BNY Mellon,CitiBank Pune,79291,71495,7796
2013-12-01,BNY Mellon,CitiBank Pune,79743,76835,2908
2014-01-01,BNY Mellon,CitiBank Pune,76491,76264,227
2014-02-01,BNY Mellon,CitiBank Pune,78572,75971,2601
2014-03-01,BNY Mellon,CitiBank Pune,74365,79328,-4963
2014-04-01,BNY Mellon,CitiBank Pune,79241,77785,1456
2014-05-01,BNY Mellon,CitiBank Pune,73847,76684,-2837
2014-06-01,BNY Mellon,CitiBank Pune,72187,72731,-544
2014-07-01,BNY Mellon,CitiBank Pune,79166,74929,4237
2014-08-01,BNY Mellon,CitiBank Pune,72954,76736,-3782
2014-09-01,BNY Mellon,CitiBank Pune,71491,76348,-4857
2014-10-01,BNY Mellon,CitiBank Pune,77328,76694,634
2014-11-01,BNY Mellon,CitiBank Pune,78416,75226,3190
2014-12-01,BNY Mellon,CitiBank Pune,78988,73268,5720
2015-01-01,BNY Mellon,CitiBank Pune,85968,81832,4136
2015-02-01,BNY Mellon,CitiBank Pune,88853,83393,5460
2015-03-01,BNY Mellon,CitiBank Pune,82911,88162,-5251
2015-04-01,BNY Mellon,CitiBank Pune,85877,81918,3959
2015-05-01,BNY Mellon,CitiBank Pune,85332,84568,764
2015-06-01,BNY Mellon,CitiBank Pune,83492,85871,-2379
2015-07-01,BNY Mellon,CitiBank Pune,88915,85986,2929
2015-08-01,BNY Mellon,CitiBank Pune,87136,81381,5755
2015-09-01,BNY Mellon,CitiBank Pune,88783,86932,1851
2015-10-01,BNY Mellon,CitiBank Pune,83967,84687,-720
2015-11-01,BNY Mellon,CitiBank Pune,86576,86298,278
2015-12-01,BNY Mellon,CitiBank Pune,81326,89226,-7900
2016-01-01,BNY Mellon,CitiBank Pune,89825,89555,270
2016-02-01,BNY Mellon,CitiBank Pune,88546,84644,3902
2016-03-01,BNY Mellon,CitiBank Pune,89959,88785,1174
2016-04-01,BNY Mellon,CitiBank Pune,89786,84284,5502
2016-05-01,BNY Mellon,CitiBank Pune,83715,89632,-5917
2016-06-01,BNY Mellon,CitiBank Pune,82734,85156,-2422
2016-07-01,BNY Mellon,CitiBank Pune,86183,86229,-46
2016-08-01,BNY Mellon,CitiBank Pune,84332,83467,865
2016-09-01,BNY Mellon,CitiBank Pune,94676,97215,-2539
2016-10-01,BNY Mellon,CitiBank Pune,96237,97897,-1660
2016-11-01,BNY Mellon,CitiBank Pune,99583,91738,7845
2016-12-01,BNY Mellon,CitiBank Pune,94534,98627,-4093
2017-01-01,BNY Mellon,CitiBank Pune,95999,92971,3028
2017-02-01,BNY Mellon,CitiBank Pune,91551,93466,-1915
2017-03-01,BNY Mellon,CitiBank Pune,93311,91382,1929
2017-04-01,BNY Mellon,CitiBank Pune,91291,94135,-2844
2017-05-01,BNY Mellon,CitiBank Pune,92598,97633,-5035
2017-06-01,BNY Mellon,CitiBank Pune,99888,99369,519
2017-07-01,BNY Mellon,CitiBank Pune,93567,92798,769
2017-08-01,BNY Mellon,CitiBank Pune,94812,97152,-2340
2017-09-01,BNY Mellon,CitiBank Pune,95389,92212,3177
2017-10-01,BNY Mellon,CitiBank Pune,99754,91756,7998
2017-11-01,BNY Mellon,CitiBank Pune,92391,98482,-6091
2017-12-01,BNY Mellon,CitiBank Pune,91463,96379,-4916
2018-01-01,BNY Mellon,CitiBank Pune,91991,99111,-7120
2018-02-01,BNY Mellon,CitiBank Pune,95267,97972,-2705
2018-03-01,BNY Mellon,CitiBank Pune,95623,97177,-1554
2018-04-01,BNY Mellon,CitiBank Pune,97964,97642,322
2010-01-01,BNY Mellon,CitiBank Singapore,51271,51835,-564
2010-02-01,BNY Mellon,CitiBank Singapore,59931,52885,7046
2010-03-01,BNY Mellon,CitiBank Singapore,53117,59661,-6544
2010-04-01,BNY Mellon,CitiBank Singapore,59688,52868,6820
2010-05-01,BNY Mellon,CitiBank Singapore,52929,52814,115
2010-06-01,BNY Mellon,CitiBank Singapore,54525,53334,1191
2010-07-01,BNY Mellon,CitiBank Singapore,58583,55668,2915
2010-08-01,BNY Mellon,CitiBank Singapore,53559,56867,-3308
2010-09-01,BNY Mellon,CitiBank Singapore,51146,51444,-298
2010-10-01,BNY Mellon,CitiBank Singapore,54954,52959,1995
2010-11-01,BNY Mellon,CitiBank Singapore,53447,52744,703
2010-12-01,BNY Mellon,CitiBank Singapore,52214,51869,345
2011-01-01,BNY Mellon,CitiBank Singapore,58155,57535,620
2011-02-01,BNY Mellon,CitiBank Singapore,52574,55381,-2807
2011-03-01,BNY Mellon,CitiBank Singapore,58568,51234,7334
2011-04-01,BNY Mellon,CitiBank Singapore,53297,53488,-191
2011-05-01,BNY Mellon,CitiBank Singapore,55318,52276,3042
2011-06-01,BNY Mellon,CitiBank Singapore,51322,58346,-7024
2011-07-01,BNY Mellon,CitiBank Singapore,59224,54985,4239
2011-08-01,BNY Mellon,CitiBank Singapore,54528,53543,985
2011-09-01,BNY Mellon,CitiBank Singapore,69794,68871,923
2011-10-01,BNY Mellon,CitiBank Singapore,61193,67364,-6171
2011-11-01,BNY Mellon,CitiBank Singapore,65932,67572,-1640
2011-12-01,BNY Mellon,CitiBank Singapore,67388,63279,4109
2012-01-01,BNY Mellon,CitiBank Singapore,66424,65962,462
2012-02-01,BNY Mellon,CitiBank Singapore,62353,64219,-1866
2012-03-01,BNY Mellon,CitiBank Singapore,68799,63777,5022
2012-04-01,BNY Mellon,CitiBank Singapore,68858,62179,6679
2012-05-01,BNY Mellon,CitiBank Singapore,64736,62627,2109
2012-06-01,BNY Mellon,CitiBank Singapore,69922,64395,5527
2012-07-01,BNY Mellon,CitiBank Singapore,66127,62476,3651
2012-08-01,BNY Mellon,CitiBank Singapore,68757,67654,1103
2012-09-01,BNY Mellon,CitiBank Singapore,64644,66913,-2269
2012-10-01,BNY Mellon,CitiBank Singapore,67196,69166,-1970
2012-11-01,BNY Mellon,CitiBank Singapore,67924,66473,1451
2012-12-01,BNY Mellon,CitiBank Singapore,69575,66113,3462
2013-01-01,BNY Mellon,CitiBank Singapore,67711,64124,3587
2013-02-01,BNY Mellon,CitiBank Singapore,62236,61981,255
2013-03-01,BNY Mellon,CitiBank Singapore,66485,63725,2760
2013-04-01,BNY Mellon,CitiBank Singapore,65579,69714,-4135
2013-05-01,BNY Mellon,CitiBank Singapore,72455,76125,-3670
2013-06-01,BNY Mellon,CitiBank Singapore,77245,78425,-1180
2013-07-01,BNY Mellon,CitiBank Singapore,78568,76217,2351
2013-08-01,BNY Mellon,CitiBank Singapore,79476,79219,257
2013-09-01,BNY Mellon,CitiBank Singapore,74111,75997,-1886
2013-10-01,BNY Mellon,CitiBank Singapore,76477,74252,2225
2013-11-01,BNY Mellon,CitiBank Singapore,76542,76246,296
2013-12-01,BNY Mellon,CitiBank Singapore,73195,74659,-1464
2014-01-01,BNY Mellon,CitiBank Singapore,77855,73899,3956
2014-02-01,BNY Mellon,CitiBank Singapore,76125,76227,-102
2014-03-01,BNY Mellon,CitiBank Singapore,72839,72956,-117
2014-04-01,BNY Mellon,CitiBank Singapore,77544,78682,-1138
2014-05-01,BNY Mellon,CitiBank Singapore,79751,78525,1226
2014-06-01,BNY Mellon,CitiBank Singapore,76642,76865,-223
2014-07-01,BNY Mellon,CitiBank Singapore,72266,74824,-2558
2014-08-01,BNY Mellon,CitiBank Singapore,71898,73677,-1779
2014-09-01,BNY Mellon,CitiBank Singapore,72373,72759,-386
2014-10-01,BNY Mellon,CitiBank Singapore,78231,77989,242
2014-11-01,BNY Mellon,CitiBank Singapore,73261,77151,-3890
2014-12-01,BNY Mellon,CitiBank Singapore,74187,72715,1472
2015-01-01,BNY Mellon,CitiBank Singapore,87564,86131,1433
2015-02-01,BNY Mellon,CitiBank Singapore,89431,87735,1696
2015-03-01,BNY Mellon,CitiBank Singapore,84228,86595,-2367
2015-04-01,BNY Mellon,CitiBank Singapore,88238,85122,3116
2015-05-01,BNY Mellon,CitiBank Singapore,87143,81246,5897
2015-06-01,BNY Mellon,CitiBank Singapore,88369,88488,-119
2015-07-01,BNY Mellon,CitiBank Singapore,85947,85926,21
2015-08-01,BNY Mellon,CitiBank Singapore,82369,88787,-6418
2015-09-01,BNY Mellon,CitiBank Singapore,84139,87769,-3630
2015-10-01,BNY Mellon,CitiBank Singapore,81187,84722,-3535
2015-11-01,BNY Mellon,CitiBank Singapore,88436,84621,3815
2015-12-01,BNY Mellon,CitiBank Singapore,82322,89946,-7624
2016-01-01,BNY Mellon,CitiBank Singapore,82873,86275,-3402
2016-02-01,BNY Mellon,CitiBank Singapore,84864,83892,972
2016-03-01,BNY Mellon,CitiBank Singapore,85352,89432,-4080
2016-04-01,BNY Mellon,CitiBank Singapore,84875,88464,-3589
2016-05-01,BNY Mellon,CitiBank Singapore,81469,84681,-3212
2016-06-01,BNY Mellon,CitiBank Singapore,87977,86987,990
2016-07-01,BNY Mellon,CitiBank Singapore,81741,86371,-4630
2016-08-01,BNY Mellon,CitiBank Singapore,81646,87852,-6206
2016-09-01,BNY Mellon,CitiBank Singapore,91187,91379,-192
2016-10-01,BNY Mellon,CitiBank Singapore,91219,95761,-4542
2016-11-01,BNY Mellon,CitiBank Singapore,91193,96447,-5254
2016-12-01,BNY Mellon,CitiBank Singapore,92423,95345,-2922
2017-01-01,BNY Mellon,CitiBank Singapore,92218,93183,-965
2017-02-01,BNY Mellon,CitiBank Singapore,97628,97798,-170
2017-03-01,BNY Mellon,CitiBank Singapore,97488,92263,5225
2017-04-01,BNY Mellon,CitiBank Singapore,93252,96517,-3265
2017-05-01,BNY Mellon,CitiBank Singapore,95493,94197,1296
2017-06-01,BNY Mellon,CitiBank Singapore,96361,91922,4439
2017-07-01,BNY Mellon,CitiBank Singapore,94928,97584,-2656
2017-08-01,BNY Mellon,CitiBank Singapore,98478,92325,6153
2017-09-01,BNY Mellon,CitiBank Singapore,97342,92541,4801
2017-10-01,BNY Mellon,CitiBank Singapore,91852,93566,-1714
2017-11-01,BNY Mellon,CitiBank Singapore,93939,96781,-2842
2017-12-01,BNY Mellon,CitiBank Singapore,99298,98687,611
2018-01-01,BNY Mellon,CitiBank Singapore,91322,93215,-1893
2018-02-01,BNY Mellon,CitiBank Singapore,96876,97682,-806
2018-03-01,BNY Mellon,CitiBank Singapore,92479,93575,-1096
2018-04-01,BNY Mellon,CitiBank Singapore,93783,96816,-3033
2010-01-01,BNY Mellon,CitiBank HongKong,53333,55277,-1944
2010-02-01,BNY Mellon,CitiBank HongKong,56277,51164,5113
2010-03-01,BNY Mellon,CitiBank HongKong,53833,51725,2108
2010-04-01,BNY Mellon,CitiBank HongKong,57769,51642,6127
2010-05-01,BNY Mellon,CitiBank HongKong,54858,51836,3022
2010-06-01,BNY Mellon,CitiBank HongKong,57555,56789,766
2010-07-01,BNY Mellon,CitiBank HongKong,53299,52466,833
2010-08-01,BNY Mellon,CitiBank HongKong,55858,54311,1547
2010-09-01,BNY Mellon,CitiBank HongKong,53837,53375,462
2010-10-01,BNY Mellon,CitiBank HongKong,53431,55113,-1682
2010-11-01,BNY Mellon,CitiBank HongKong,55244,59972,-4728
2010-12-01,BNY Mellon,CitiBank HongKong,52374,57784,-5410
2011-01-01,BNY Mellon,CitiBank HongKong,52649,54487,-1838
2011-02-01,BNY Mellon,CitiBank HongKong,57355,52557,4798
2011-03-01,BNY Mellon,CitiBank HongKong,52457,57921,-5464
2011-04-01,BNY Mellon,CitiBank HongKong,51883,59772,-7889
2011-05-01,BNY Mellon,CitiBank HongKong,58151,53827,4324
2011-06-01,BNY Mellon,CitiBank HongKong,58414,58867,-453
2011-07-01,BNY Mellon,CitiBank HongKong,57116,51673,5443
2011-08-01,BNY Mellon,CitiBank HongKong,57642,52837,4805
2011-09-01,BNY Mellon,CitiBank HongKong,66927,62929,3998
2011-10-01,BNY Mellon,CitiBank HongKong,66877,67118,-241
2011-11-01,BNY Mellon,CitiBank HongKong,63381,67652,-4271
2011-12-01,BNY Mellon,CitiBank HongKong,63613,63744,-131
2012-01-01,BNY Mellon,CitiBank HongKong,62584,62657,-73
2012-02-01,BNY Mellon,CitiBank HongKong,62582,64783,-2201
2012-03-01,BNY Mellon,CitiBank HongKong,66568,66993,-425
2012-04-01,BNY Mellon,CitiBank HongKong,68851,64897,3954
2012-05-01,BNY Mellon,CitiBank HongKong,67155,61387,5768
2012-06-01,BNY Mellon,CitiBank HongKong,68633,61531,7102
2012-07-01,BNY Mellon,CitiBank HongKong,61839,63252,-1413
2012-08-01,BNY Mellon,CitiBank HongKong,69554,62355,7199
2012-09-01,BNY Mellon,CitiBank HongKong,65164,68569,-3405
2012-10-01,BNY Mellon,CitiBank HongKong,66454,65617,837
2012-11-01,BNY Mellon,CitiBank HongKong,62882,69512,-6630
2012-12-01,BNY Mellon,CitiBank HongKong,62237,63132,-895
2013-01-01,BNY Mellon,CitiBank HongKong,65437,64436,1001
2013-02-01,BNY Mellon,CitiBank HongKong,62217,69953,-7736
2013-03-01,BNY Mellon,CitiBank HongKong,67134,61156,5978
2013-04-01,BNY Mellon,CitiBank HongKong,63579,68739,-5160
2013-05-01,BNY Mellon,CitiBank HongKong,75844,74382,1462
2013-06-01,BNY Mellon,CitiBank HongKong,76925,79497,-2572
2013-07-01,BNY Mellon,CitiBank HongKong,71811,74924,-3113
2013-08-01,BNY Mellon,CitiBank HongKong,79469,71662,7807
2013-09-01,BNY Mellon,CitiBank HongKong,77997,71646,6351
2013-10-01,BNY Mellon,CitiBank HongKong,74693,71864,2829
2013-11-01,BNY Mellon,CitiBank HongKong,73544,71754,1790
2013-12-01,BNY Mellon,CitiBank HongKong,75959,74525,1434
2014-01-01,BNY Mellon,CitiBank HongKong,72695,73321,-626
2014-02-01,BNY Mellon,CitiBank HongKong,78133,72572,5561
2014-03-01,BNY Mellon,CitiBank HongKong,78477,78769,-292
2014-04-01,BNY Mellon,CitiBank HongKong,73924,74117,-193
2014-05-01,BNY Mellon,CitiBank HongKong,73518,73988,-470
2014-06-01,BNY Mellon,CitiBank HongKong,73889,77279,-3390
2014-07-01,BNY Mellon,CitiBank HongKong,73921,73257,664
2014-08-01,BNY Mellon,CitiBank HongKong,72354,79279,-6925
2014-09-01,BNY Mellon,CitiBank HongKong,77917,75318,2599
2014-10-01,BNY Mellon,CitiBank HongKong,73348,76754,-3406
2014-11-01,BNY Mellon,CitiBank HongKong,73691,78944,-5253
2014-12-01,BNY Mellon,CitiBank HongKong,76444,76859,-415
2015-01-01,BNY Mellon,CitiBank HongKong,84826,89193,-4367
2015-02-01,BNY Mellon,CitiBank HongKong,89849,82451,7398
2015-03-01,BNY Mellon,CitiBank HongKong,86887,89281,-2394
2015-04-01,BNY Mellon,CitiBank HongKong,88957,83327,5630
2015-05-01,BNY Mellon,CitiBank HongKong,87678,85188,2490
2015-06-01,BNY Mellon,CitiBank HongKong,89979,86349,3630
2015-07-01,BNY Mellon,CitiBank HongKong,82918,88585,-5667
2015-08-01,BNY Mellon,CitiBank HongKong,87653,84246,3407
2015-09-01,BNY Mellon,CitiBank HongKong,82854,88276,-5422
2015-10-01,BNY Mellon,CitiBank HongKong,81411,82525,-1114
2015-11-01,BNY Mellon,CitiBank HongKong,83179,84575,-1396
2015-12-01,BNY Mellon,CitiBank HongKong,81935,82771,-836
2016-01-01,BNY Mellon,CitiBank HongKong,87424,88535,-1111
2016-02-01,BNY Mellon,CitiBank HongKong,81252,81866,-614
2016-03-01,BNY Mellon,CitiBank HongKong,86618,83392,3226
2016-04-01,BNY Mellon,CitiBank HongKong,85985,83617,2368
2016-05-01,BNY Mellon,CitiBank HongKong,85657,83444,2213
2016-06-01,BNY Mellon,CitiBank HongKong,89294,82861,6433
2016-07-01,BNY Mellon,CitiBank HongKong,84856,86558,-1702
2016-08-01,BNY Mellon,CitiBank HongKong,87337,83347,3990
2016-09-01,BNY Mellon,CitiBank HongKong,91963,96981,-5018
2016-10-01,BNY Mellon,CitiBank HongKong,97174,95884,1290
2016-11-01,BNY Mellon,CitiBank HongKong,94564,92578,1986
2016-12-01,BNY Mellon,CitiBank HongKong,98811,91358,7453
2017-01-01,BNY Mellon,CitiBank HongKong,92435,99299,-6864
2017-02-01,BNY Mellon,CitiBank HongKong,92694,97956,-5262
2017-03-01,BNY Mellon,CitiBank HongKong,95538,93421,2117
2017-04-01,BNY Mellon,CitiBank HongKong,95211,99866,-4655
2017-05-01,BNY Mellon,CitiBank HongKong,93637,91833,1804
2017-06-01,BNY Mellon,CitiBank HongKong,95939,93362,2577
2017-07-01,BNY Mellon,CitiBank HongKong,97756,96347,1409
2017-08-01,BNY Mellon,CitiBank HongKong,98445,97477,968
2017-09-01,BNY Mellon,CitiBank HongKong,96181,93817,2364
2017-10-01,BNY Mellon,CitiBank HongKong,99256,95672,3584
2017-11-01,BNY Mellon,CitiBank HongKong,98441,95327,3114
2017-12-01,BNY Mellon,CitiBank HongKong,94334,91621,2713
2018-01-01,BNY Mellon,CitiBank HongKong,98343,99367,-1024
2018-02-01,BNY Mellon,CitiBank HongKong,99722,95588,4134
2018-03-01,BNY Mellon,CitiBank HongKong,97126,99197,-2071
2018-04-01,BNY Mellon,CitiBank HongKong,94755,95353,-598
2010-01-01,Goldman Sachs,CitiBank New York,58388,59627,-1239
2010-02-01,Goldman Sachs,CitiBank New York,55799,59859,-4060
2010-03-01,Goldman Sachs,CitiBank New York,58475,56871,1604
2010-04-01,Goldman Sachs,CitiBank New York,56644,59317,-2673
2010-05-01,Goldman Sachs,CitiBank New York,52866,59896,-7030
2010-06-01,Goldman Sachs,CitiBank New York,59482,53922,5560
2010-07-01,Goldman Sachs,CitiBank New York,57227,51969,5258
2010-08-01,Goldman Sachs,CitiBank New York,55165,55977,-812
2010-09-01,Goldman Sachs,CitiBank New York,55192,51595,3597
2010-10-01,Goldman Sachs,CitiBank New York,58115,52827,5288
2010-11-01,Goldman Sachs,CitiBank New York,52917,57752,-4835
2010-12-01,Goldman Sachs,CitiBank New York,56535,53992,2543
2011-01-01,Goldman Sachs,CitiBank New York,53499,53176,323
2011-02-01,Goldman Sachs,CitiBank New York,56548,56553,-5
2011-03-01,Goldman Sachs,CitiBank New York,53878,56531,-2653
2011-04-01,Goldman Sachs,CitiBank New York,57247,52361,4886
2011-05-01,Goldman Sachs,CitiBank New York,55498,56838,-1340
2011-06-01,Goldman Sachs,CitiBank New York,58888,57184,1704
2011-07-01,Goldman Sachs,CitiBank New York,57778,53229,4549
2011-08-01,Goldman Sachs,CitiBank New York,52673,54282,-1609
2011-09-01,Goldman Sachs,CitiBank New York,65362,61375,3987
2011-10-01,Goldman Sachs,CitiBank New York,69429,65291,4138
2011-11-01,Goldman Sachs,CitiBank New York,61675,64954,-3279
2011-12-01,Goldman Sachs,CitiBank New York,62721,65138,-2417
2012-01-01,Goldman Sachs,CitiBank New York,62969,66623,-3654
2012-02-01,Goldman Sachs,CitiBank New York,63796,63626,170
2012-03-01,Goldman Sachs,CitiBank New York,68138,67121,1017
2012-04-01,Goldman Sachs,CitiBank New York,62343,62881,-538
2012-05-01,Goldman Sachs,CitiBank New York,66463,67783,-1320
2012-06-01,Goldman Sachs,CitiBank New York,61572,65245,-3673
2012-07-01,Goldman Sachs,CitiBank New York,63937,64122,-185
2012-08-01,Goldman Sachs,CitiBank New York,65326,67165,-1839
2012-09-01,Goldman Sachs,CitiBank New York,65455,63227,2228
2012-10-01,Goldman Sachs,CitiBank New York,66163,62568,3595
2012-11-01,Goldman Sachs,CitiBank New York,62845,65693,-2848
2012-12-01,Goldman Sachs,CitiBank New York,62217,65329,-3112
2013-01-01,Goldman Sachs,CitiBank New York,65245,68915,-3670
2013-02-01,Goldman Sachs,CitiBank New York,68649,66836,1813
2013-03-01,Goldman Sachs,CitiBank New York,63144,61587,1557
2013-04-01,Goldman Sachs,CitiBank New York,66443,68857,-2414
2013-05-01,Goldman Sachs,CitiBank New York,76127,75525,602
2013-06-01,Goldman Sachs,CitiBank New York,74152,74265,-113
2013-07-01,Goldman Sachs,CitiBank New York,73669,76723,-3054
2013-08-01,Goldman Sachs,CitiBank New York,74127,75571,-1444
2013-09-01,Goldman Sachs,CitiBank New York,79325,75755,3570
2013-10-01,Goldman Sachs,CitiBank New York,76558,71251,5307
2013-11-01,Goldman Sachs,CitiBank New York,73393,71226,2167
2013-12-01,Goldman Sachs,CitiBank New York,79335,79831,-496
2014-01-01,Goldman Sachs,CitiBank New York,78751,77468,1283
2014-02-01,Goldman Sachs,CitiBank New York,71335,72975,-1640
2014-03-01,Goldman Sachs,CitiBank New York,71861,71385,476
2014-04-01,Goldman Sachs,CitiBank New York,75732,74665,1067
2014-05-01,Goldman Sachs,CitiBank New York,74165,71663,2502
2014-06-01,Goldman Sachs,CitiBank New York,78519,76471,2048
2014-07-01,Goldman Sachs,CitiBank New York,78655,71931,6724
2014-08-01,Goldman Sachs,CitiBank New York,77321,71918,5403
2014-09-01,Goldman Sachs,CitiBank New York,78225,79285,-1060
2014-10-01,Goldman Sachs,CitiBank New York,76851,79243,-2392
2014-11-01,Goldman Sachs,CitiBank New York,75963,73994,1969
2014-12-01,Goldman Sachs,CitiBank New York,78691,78142,549
2015-01-01,Goldman Sachs,CitiBank New York,86928,82174,4754
2015-02-01,Goldman Sachs,CitiBank New York,83875,87454,-3579
2015-03-01,Goldman Sachs,CitiBank New York,85496,87134,-1638
2015-04-01,Goldman Sachs,CitiBank New York,86337,88345,-2008
2015-05-01,Goldman Sachs,CitiBank New York,84663,89632,-4969
2015-06-01,Goldman Sachs,CitiBank New York,84832,82225,2607
2015-07-01,Goldman Sachs,CitiBank New York,85817,85471,346
2015-08-01,Goldman Sachs,CitiBank New York,82955,89968,-7013
2015-09-01,Goldman Sachs,CitiBank New York,82376,83516,-1140
2015-10-01,Goldman Sachs,CitiBank New York,82169,85796,-3627
2015-11-01,Goldman Sachs,CitiBank New York,83594,87338,-3744
2015-12-01,Goldman Sachs,CitiBank New York,86293,87218,-925
2016-01-01,Goldman Sachs,CitiBank New York,82821,87379,-4558
2016-02-01,Goldman Sachs,CitiBank New York,88417,89635,-1218
2016-03-01,Goldman Sachs,CitiBank New York,86157,82274,3883
2016-04-01,Goldman Sachs,CitiBank New York,81749,89456,-7707
2016-05-01,Goldman Sachs,CitiBank New York,83866,89638,-5772
2016-06-01,Goldman Sachs,CitiBank New York,81355,86684,-5329
2016-07-01,Goldman Sachs,CitiBank New York,82793,82772,21
2016-08-01,Goldman Sachs,CitiBank New York,86745,84941,1804
2016-09-01,Goldman Sachs,CitiBank New York,93593,93296,297
2016-10-01,Goldman Sachs,CitiBank New York,92313,94853,-2540
2016-11-01,Goldman Sachs,CitiBank New York,91344,92153,-809
2016-12-01,Goldman Sachs,CitiBank New York,98281,91919,6362
2017-01-01,Goldman Sachs,CitiBank New York,94148,99916,-5768
2017-02-01,Goldman Sachs,CitiBank New York,93747,96543,-2796
2017-03-01,Goldman Sachs,CitiBank New York,93655,92965,690
2017-04-01,Goldman Sachs,CitiBank New York,91116,98568,-7452
2017-05-01,Goldman Sachs,CitiBank New York,97445,93431,4014
2017-06-01,Goldman Sachs,CitiBank New York,91362,91929,-567
2017-07-01,Goldman Sachs,CitiBank New York,98823,96819,2004
2017-08-01,Goldman Sachs,CitiBank New York,95466,91215,4251
2017-09-01,Goldman Sachs,CitiBank New York,95917,97462,-1545
2017-10-01,Goldman Sachs,CitiBank New York,93543,99189,-5646
2017-11-01,Goldman Sachs,CitiBank New York,94866,95493,-627
2017-12-01,Goldman Sachs,CitiBank New York,92164,98267,-6103
2018-01-01,Goldman Sachs,CitiBank New York,94182,99176,-4994
2018-02-01,Goldman Sachs,CitiBank New York,97574,98493,-919
2018-03-01,Goldman Sachs,CitiBank New York,94591,94988,-397
2018-04-01,Goldman Sachs,CitiBank New York,99765,94284,5481
2010-01-01,Goldman Sachs,CitiBank London,51298,52349,-1051
2010-02-01,Goldman Sachs,CitiBank London,57945,57265,680
2010-03-01,Goldman Sachs,CitiBank London,54146,52783,1363
2010-04-01,Goldman Sachs,CitiBank London,52813,58312,-5499
2010-05-01,Goldman Sachs,CitiBank London,51122,57461,-6339
2010-06-01,Goldman Sachs,CitiBank London,55485,52127,3358
2010-07-01,Goldman Sachs,CitiBank London,52663,58185,-5522
2010-08-01,Goldman Sachs,CitiBank London,53432,55493,-2061
2010-09-01,Goldman Sachs,CitiBank London,58875,54691,4184
2010-10-01,Goldman Sachs,CitiBank London,55983,56737,-754
2010-11-01,Goldman Sachs,CitiBank London,59635,57587,2048
2010-12-01,Goldman Sachs,CitiBank London,58561,56261,2300
2011-01-01,Goldman Sachs,CitiBank London,53635,55954,-2319
2011-02-01,Goldman Sachs,CitiBank London,53415,55148,-1733
2011-03-01,Goldman Sachs,CitiBank London,57943,57516,427
2011-04-01,Goldman Sachs,CitiBank London,56291,52966,3325
2011-05-01,Goldman Sachs,CitiBank London,51338,52972,-1634
2011-06-01,Goldman Sachs,CitiBank London,52516,53466,-950
2011-07-01,Goldman Sachs,CitiBank London,59295,56696,2599
2011-08-01,Goldman Sachs,CitiBank London,56611,51656,4955
2011-09-01,Goldman Sachs,CitiBank London,65421,67473,-2052
2011-10-01,Goldman Sachs,CitiBank London,68968,66814,2154
2011-11-01,Goldman Sachs,CitiBank London,65587,63982,1605
2011-12-01,Goldman Sachs,CitiBank London,66821,66868,-47
2012-01-01,Goldman Sachs,CitiBank London,61936,67415,-5479
2012-02-01,Goldman Sachs,CitiBank London,65731,66332,-601
2012-03-01,Goldman Sachs,CitiBank London,67972,62292,5680
2012-04-01,Goldman Sachs,CitiBank London,66664,63924,2740
2012-05-01,Goldman Sachs,CitiBank London,69156,61883,7273
2012-06-01,Goldman Sachs,CitiBank London,66438,66893,-455
2012-07-01,Goldman Sachs,CitiBank London,67215,63358,3857
2012-08-01,Goldman Sachs,CitiBank London,68145,61666,6479
2012-09-01,Goldman Sachs,CitiBank London,63211,66544,-3333
2012-10-01,Goldman Sachs,CitiBank London,61238,61632,-394
2012-11-01,Goldman Sachs,CitiBank London,61361,68357,-6996
2012-12-01,Goldman Sachs,CitiBank London,68159,61445,6714
2013-01-01,Goldman Sachs,CitiBank London,66482,68899,-2417
2013-02-01,Goldman Sachs,CitiBank London,67567,69223,-1656
2013-03-01,Goldman Sachs,CitiBank London,62975,66669,-3694
2013-04-01,Goldman Sachs,CitiBank London,63821,62421,1400
2013-05-01,Goldman Sachs,CitiBank London,73376,74426,-1050
2013-06-01,Goldman Sachs,CitiBank London,73385,78141,-4756
2013-07-01,Goldman Sachs,CitiBank London,75795,75713,82
2013-08-01,Goldman Sachs,CitiBank London,77646,71572,6074
2013-09-01,Goldman Sachs,CitiBank London,74259,76341,-2082
2013-10-01,Goldman Sachs,CitiBank London,74123,71674,2449
2013-11-01,Goldman Sachs,CitiBank London,71429,77646,-6217
2013-12-01,Goldman Sachs,CitiBank London,77672,78275,-603
2014-01-01,Goldman Sachs,CitiBank London,75941,79525,-3584
2014-02-01,Goldman Sachs,CitiBank London,72571,79824,-7253
2014-03-01,Goldman Sachs,CitiBank London,72257,76149,-3892
2014-04-01,Goldman Sachs,CitiBank London,76621,77846,-1225
2014-05-01,Goldman Sachs,CitiBank London,77781,73528,4253
2014-06-01,Goldman Sachs,CitiBank London,78983,76347,2636
2014-07-01,Goldman Sachs,CitiBank London,74529,76981,-2452
2014-08-01,Goldman Sachs,CitiBank London,79985,79835,150
2014-09-01,Goldman Sachs,CitiBank London,72346,71457,889
2014-10-01,Goldman Sachs,CitiBank London,75484,79937,-4453
2014-11-01,Goldman Sachs,CitiBank London,79877,78615,1262
2014-12-01,Goldman Sachs,CitiBank London,77487,73218,4269
2015-01-01,Goldman Sachs,CitiBank London,87165,89614,-2449
2015-02-01,Goldman Sachs,CitiBank London,89894,84457,5437
2015-03-01,Goldman Sachs,CitiBank London,82329,84212,-1883
2015-04-01,Goldman Sachs,CitiBank London,84157,84484,-327
2015-05-01,Goldman Sachs,CitiBank London,83883,84617,-734
2015-06-01,Goldman Sachs,CitiBank London,83569,83549,20
2015-07-01,Goldman Sachs,CitiBank London,84234,84789,-555
2015-08-01,Goldman Sachs,CitiBank London,88428,89853,-1425
2015-09-01,Goldman Sachs,CitiBank London,88526,86829,1697
2015-10-01,Goldman Sachs,CitiBank London,82339,89542,-7203
2015-11-01,Goldman Sachs,CitiBank London,82961,83582,-621
2015-12-01,Goldman Sachs,CitiBank London,88888,87837,1051
2016-01-01,Goldman Sachs,CitiBank London,87774,84454,3320
2016-02-01,Goldman Sachs,CitiBank London,85227,89438,-4211
2016-03-01,Goldman Sachs,CitiBank London,88414,83395,5019
2016-04-01,Goldman Sachs,CitiBank London,87137,88828,-1691
2016-05-01,Goldman Sachs,CitiBank London,88766,87833,933
2016-06-01,Goldman Sachs,CitiBank London,81197,88427,-7230
2016-07-01,Goldman Sachs,CitiBank London,89698,81871,7827
2016-08-01,Goldman Sachs,CitiBank London,82835,85972,-3137
2016-09-01,Goldman Sachs,CitiBank London,96266,95266,1000
2016-10-01,Goldman Sachs,CitiBank London,98644,98677,-33
2016-11-01,Goldman Sachs,CitiBank London,97818,97574,244
2016-12-01,Goldman Sachs,CitiBank London,93929,92351,1578
2017-01-01,Goldman Sachs,CitiBank London,96734,96769,-35
2017-02-01,Goldman Sachs,CitiBank London,93837,99158,-5321
2017-03-01,Goldman Sachs,CitiBank London,91132,96392,-5260
2017-04-01,Goldman Sachs,CitiBank London,95162,96177,-1015
2017-05-01,Goldman Sachs,CitiBank London,95676,97332,-1656
2017-06-01,Goldman Sachs,CitiBank London,94158,95463,-1305
2017-07-01,Goldman Sachs,CitiBank London,92462,91943,519
2017-08-01,Goldman Sachs,CitiBank London,96139,92873,3266
2017-09-01,Goldman Sachs,CitiBank London,97842,92746,5096
2017-10-01,Goldman Sachs,CitiBank London,95455,92591,2864
2017-11-01,Goldman Sachs,CitiBank London,92484,98243,-5759
2017-12-01,Goldman Sachs,CitiBank London,92998,98579,-5581
2018-01-01,Goldman Sachs,CitiBank London,93486,93873,-387
2018-02-01,Goldman Sachs,CitiBank London,92336,91836,500
2018-03-01,Goldman Sachs,CitiBank London,96911,97153,-242
2018-04-01,Goldman Sachs,CitiBank London,95615,97462,-1847
2010-01-01,Goldman Sachs,CitiBank Pune,51528,56752,-5224
2010-02-01,Goldman Sachs,CitiBank Pune,55143,58438,-3295
2010-03-01,Goldman Sachs,CitiBank Pune,53554,56186,-2632
2010-04-01,Goldman Sachs,CitiBank Pune,52154,54624,-2470
2010-05-01,Goldman Sachs,CitiBank Pune,55187,54517,670
2010-06-01,Goldman Sachs,CitiBank Pune,57364,52225,5139
2010-07-01,Goldman Sachs,CitiBank Pune,51452,58342,-6890
2010-08-01,Goldman Sachs,CitiBank Pune,57784,51111,6673
2010-09-01,Goldman Sachs,CitiBank Pune,58658,59887,-1229
2010-10-01,Goldman Sachs,CitiBank Pune,51354,56939,-5585
2010-11-01,Goldman Sachs,CitiBank Pune,57935,57317,618
2010-12-01,Goldman Sachs,CitiBank Pune,56654,56986,-332
2011-01-01,Goldman Sachs,CitiBank Pune,58131,56286,1845
2011-02-01,Goldman Sachs,CitiBank Pune,56228,58468,-2240
2011-03-01,Goldman Sachs,CitiBank Pune,59441,59194,247
2011-04-01,Goldman Sachs,CitiBank Pune,55858,52556,3302
2011-05-01,Goldman Sachs,CitiBank Pune,54966,57358,-2392
2011-06-01,Goldman Sachs,CitiBank Pune,55691,51255,4436
2011-07-01,Goldman Sachs,CitiBank Pune,57397,55689,1708
2011-08-01,Goldman Sachs,CitiBank Pune,55626,58961,-3335
2011-09-01,Goldman Sachs,CitiBank Pune,63248,62385,863
2011-10-01,Goldman Sachs,CitiBank Pune,62667,66227,-3560
2011-11-01,Goldman Sachs,CitiBank Pune,67236,66565,671
2011-12-01,Goldman Sachs,CitiBank Pune,62896,61219,1677
2012-01-01,Goldman Sachs,CitiBank Pune,64665,63436,1229
2012-02-01,Goldman Sachs,CitiBank Pune,68833,69216,-383
2012-03-01,Goldman Sachs,CitiBank Pune,66967,62744,4223
2012-04-01,Goldman Sachs,CitiBank Pune,69811,62894,6917
2012-05-01,Goldman Sachs,CitiBank Pune,68756,61926,6830
2012-06-01,Goldman Sachs,CitiBank Pune,62156,62797,-641
2012-07-01,Goldman Sachs,CitiBank Pune,66712,67499,-787
2012-08-01,Goldman Sachs,CitiBank Pune,64723,65851,-1128
2012-09-01,Goldman Sachs,CitiBank Pune,68375,65534,2841
2012-10-01,Goldman Sachs,CitiBank Pune,66333,62311,4022
2012-11-01,Goldman Sachs,CitiBank Pune,65855,69597,-3742
2012-12-01,Goldman Sachs,CitiBank Pune,67332,65823,1509
2013-01-01,Goldman Sachs,CitiBank Pune,61218,66937,-5719
2013-02-01,Goldman Sachs,CitiBank Pune,61486,66139,-4653
2013-03-01,Goldman Sachs,CitiBank Pune,66376,65777,599
2013-04-01,Goldman Sachs,CitiBank Pune,68635,68746,-111
2013-05-01,Goldman Sachs,CitiBank Pune,77896,77451,445
2013-06-01,Goldman Sachs,CitiBank Pune,75945,71626,4319
2013-07-01,Goldman Sachs,CitiBank Pune,77278,79163,-1885
2013-08-01,Goldman Sachs,CitiBank Pune,73496,78689,-5193
2013-09-01,Goldman Sachs,CitiBank Pune,78391,79736,-1345
2013-10-01,Goldman Sachs,CitiBank Pune,77423,77929,-506
2013-11-01,Goldman Sachs,CitiBank Pune,78342,75358,2984
2013-12-01,Goldman Sachs,CitiBank Pune,75422,76112,-690
2014-01-01,Goldman Sachs,CitiBank Pune,71598,72989,-1391
2014-02-01,Goldman Sachs,CitiBank Pune,78614,76526,2088
2014-03-01,Goldman Sachs,CitiBank Pune,75812,71789,4023
2014-04-01,Goldman Sachs,CitiBank Pune,75121,78289,-3168
2014-05-01,Goldman Sachs,CitiBank Pune,79773,79473,300
2014-06-01,Goldman Sachs,CitiBank Pune,77864,74537,3327
2014-07-01,Goldman Sachs,CitiBank Pune,72881,77292,-4411
2014-08-01,Goldman Sachs,CitiBank Pune,78646,71641,7005
2014-09-01,Goldman Sachs,CitiBank Pune,73993,71585,2408
2014-10-01,Goldman Sachs,CitiBank Pune,77641,78344,-703
2014-11-01,Goldman Sachs,CitiBank Pune,78739,75745,2994
2014-12-01,Goldman Sachs,CitiBank Pune,78564,72876,5688
2015-01-01,Goldman Sachs,CitiBank Pune,89659,81717,7942
2015-02-01,Goldman Sachs,CitiBank Pune,85972,85174,798
2015-03-01,Goldman Sachs,CitiBank Pune,82956,88486,-5530
2015-04-01,Goldman Sachs,CitiBank Pune,84523,85687,-1164
2015-05-01,Goldman Sachs,CitiBank Pune,88456,84666,3790
2015-06-01,Goldman Sachs,CitiBank Pune,84677,89391,-4714
2015-07-01,Goldman Sachs,CitiBank Pune,83929,88463,-4534
2015-08-01,Goldman Sachs,CitiBank Pune,82952,85894,-2942
2015-09-01,Goldman Sachs,CitiBank Pune,82267,86196,-3929
2015-10-01,Goldman Sachs,CitiBank Pune,83971,86522,-2551
2015-11-01,Goldman Sachs,CitiBank Pune,85568,83556,2012
2015-12-01,Goldman Sachs,CitiBank Pune,81176,89913,-8737
2016-01-01,Goldman Sachs,CitiBank Pune,83134,85657,-2523
2016-02-01,Goldman Sachs,CitiBank Pune,84984,82858,2126
2016-03-01,Goldman Sachs,CitiBank Pune,89674,87241,2433
2016-04-01,Goldman Sachs,CitiBank Pune,86183,89524,-3341
2016-05-01,Goldman Sachs,CitiBank Pune,89744,82877,6867
2016-06-01,Goldman Sachs,CitiBank Pune,85255,81485,3770
2016-07-01,Goldman Sachs,CitiBank Pune,84797,84831,-34
2016-08-01,Goldman Sachs,CitiBank Pune,86123,85735,388
2016-09-01,Goldman Sachs,CitiBank Pune,95832,92563,3269
2016-10-01,Goldman Sachs,CitiBank Pune,98283,99551,-1268
2016-11-01,Goldman Sachs,CitiBank Pune,92386,92525,-139
2016-12-01,Goldman Sachs,CitiBank Pune,93829,95875,-2046
2017-01-01,Goldman Sachs,CitiBank Pune,99798,99627,171
2017-02-01,Goldman Sachs,CitiBank Pune,96144,93231,2913
2017-03-01,Goldman Sachs,CitiBank Pune,98585,91276,7309
2017-04-01,Goldman Sachs,CitiBank Pune,91666,95933,-4267
2017-05-01,Goldman Sachs,CitiBank Pune,93813,96261,-2448
2017-06-01,Goldman Sachs,CitiBank Pune,95864,91778,4086
2017-07-01,Goldman Sachs,CitiBank Pune,98583,98274,309
2017-08-01,Goldman Sachs,CitiBank Pune,99635,93561,6074
2017-09-01,Goldman Sachs,CitiBank Pune,98327,97735,592
2017-10-01,Goldman Sachs,CitiBank Pune,92166,91945,221
2017-11-01,Goldman Sachs,CitiBank Pune,98443,98854,-411
2017-12-01,Goldman Sachs,CitiBank Pune,98516,96482,2034
2018-01-01,Goldman Sachs,CitiBank Pune,91667,91953,-286
2018-02-01,Goldman Sachs,CitiBank Pune,95896,93539,2357
2018-03-01,Goldman Sachs,CitiBank Pune,92491,98511,-6020
2018-04-01,Goldman Sachs,CitiBank Pune,98194,98522,-328
2010-01-01,Goldman Sachs,CitiBank Singapore,57449,57985,-536
2010-02-01,Goldman Sachs,CitiBank Singapore,57563,54383,3180
2010-03-01,Goldman Sachs,CitiBank Singapore,59643,58314,1329
2010-04-01,Goldman Sachs,CitiBank Singapore,57857,52962,4895
2010-05-01,Goldman Sachs,CitiBank Singapore,51934,55253,-3319
2010-06-01,Goldman Sachs,CitiBank Singapore,56775,51368,5407
2010-07-01,Goldman Sachs,CitiBank Singapore,56969,55176,1793
2010-08-01,Goldman Sachs,CitiBank Singapore,56693,51148,5545
2010-09-01,Goldman Sachs,CitiBank Singapore,59475,56476,2999
2010-10-01,Goldman Sachs,CitiBank Singapore,56483,51338,5145
2010-11-01,Goldman Sachs,CitiBank Singapore,51132,53753,-2621
2010-12-01,Goldman Sachs,CitiBank Singapore,58945,59882,-937
2011-01-01,Goldman Sachs,CitiBank Singapore,51932,58281,-6349
2011-02-01,Goldman Sachs,CitiBank Singapore,59677,56495,3182
2011-03-01,Goldman Sachs,CitiBank Singapore,55188,59588,-4400
2011-04-01,Goldman Sachs,CitiBank Singapore,54777,54826,-49
2011-05-01,Goldman Sachs,CitiBank Singapore,57691,57268,423
2011-06-01,Goldman Sachs,CitiBank Singapore,57166,52543,4623
2011-07-01,Goldman Sachs,CitiBank Singapore,53629,59889,-6260
2011-08-01,Goldman Sachs,CitiBank Singapore,55553,51293,4260
2011-09-01,Goldman Sachs,CitiBank Singapore,67888,65313,2575
2011-10-01,Goldman Sachs,CitiBank Singapore,62511,65566,-3055
2011-11-01,Goldman Sachs,CitiBank Singapore,61753,61712,41
2011-12-01,Goldman Sachs,CitiBank Singapore,61335,66585,-5250
2012-01-01,Goldman Sachs,CitiBank Singapore,67168,64718,2450
2012-02-01,Goldman Sachs,CitiBank Singapore,65977,65535,442
2012-03-01,Goldman Sachs,CitiBank Singapore,67637,63975,3662
2012-04-01,Goldman Sachs,CitiBank Singapore,63866,63831,35
2012-05-01,Goldman Sachs,CitiBank Singapore,66586,62682,3904
2012-06-01,Goldman Sachs,CitiBank Singapore,64174,63112,1062
2012-07-01,Goldman Sachs,CitiBank Singapore,68294,64966,3328
2012-08-01,Goldman Sachs,CitiBank Singapore,64353,66721,-2368
2012-09-01,Goldman Sachs,CitiBank Singapore,65162,69373,-4211
2012-10-01,Goldman Sachs,CitiBank Singapore,65744,66384,-640
2012-11-01,Goldman Sachs,CitiBank Singapore,65912,62481,3431
2012-12-01,Goldman Sachs,CitiBank Singapore,62457,64445,-1988
2013-01-01,Goldman Sachs,CitiBank Singapore,64978,61466,3512
2013-02-01,Goldman Sachs,CitiBank Singapore,61163,62643,-1480
2013-03-01,Goldman Sachs,CitiBank Singapore,62357,64243,-1886
2013-04-01,Goldman Sachs,CitiBank Singapore,63566,63419,147
2013-05-01,Goldman Sachs,CitiBank Singapore,72369,73681,-1312
2013-06-01,Goldman Sachs,CitiBank Singapore,79184,78164,1020
2013-07-01,Goldman Sachs,CitiBank Singapore,79892,71863,8029
2013-08-01,Goldman Sachs,CitiBank Singapore,78533,76386,2147
2013-09-01,Goldman Sachs,CitiBank Singapore,76186,73736,2450
2013-10-01,Goldman Sachs,CitiBank Singapore,72458,75789,-3331
2013-11-01,Goldman Sachs,CitiBank Singapore,72316,73838,-1522
2013-12-01,Goldman Sachs,CitiBank Singapore,77738,74463,3275
2014-01-01,Goldman Sachs,CitiBank Singapore,76223,73225,2998
2014-02-01,Goldman Sachs,CitiBank Singapore,77837,76425,1412
2014-03-01,Goldman Sachs,CitiBank Singapore,71548,76777,-5229
2014-04-01,Goldman Sachs,CitiBank Singapore,75698,73381,2317
2014-05-01,Goldman Sachs,CitiBank Singapore,79226,72378,6848
2014-06-01,Goldman Sachs,CitiBank Singapore,72931,78543,-5612
2014-07-01,Goldman Sachs,CitiBank Singapore,79841,79474,367
2014-08-01,Goldman Sachs,CitiBank Singapore,79184,76966,2218
2014-09-01,Goldman Sachs,CitiBank Singapore,71698,75912,-4214
2014-10-01,Goldman Sachs,CitiBank Singapore,75597,73366,2231
2014-11-01,Goldman Sachs,CitiBank Singapore,71719,79115,-7396
2014-12-01,Goldman Sachs,CitiBank Singapore,75582,74593,989
2015-01-01,Goldman Sachs,CitiBank Singapore,89338,85459,3879
2015-02-01,Goldman Sachs,CitiBank Singapore,84373,81946,2427
2015-03-01,Goldman Sachs,CitiBank Singapore,88765,84328,4437
2015-04-01,Goldman Sachs,CitiBank Singapore,83577,87819,-4242
2015-05-01,Goldman Sachs,CitiBank Singapore,86994,89135,-2141
2015-06-01,Goldman Sachs,CitiBank Singapore,81341,89381,-8040
2015-07-01,Goldman Sachs,CitiBank Singapore,84128,85634,-1506
2015-08-01,Goldman Sachs,CitiBank Singapore,85129,86332,-1203
2015-09-01,Goldman Sachs,CitiBank Singapore,83798,88273,-4475
2015-10-01,Goldman Sachs,CitiBank Singapore,83659,88816,-5157
2015-11-01,Goldman Sachs,CitiBank Singapore,89898,84275,5623
2015-12-01,Goldman Sachs,CitiBank Singapore,82164,82549,-385
2016-01-01,Goldman Sachs,CitiBank Singapore,83992,84526,-534
2016-02-01,Goldman Sachs,CitiBank Singapore,82333,84471,-2138
2016-03-01,Goldman Sachs,CitiBank Singapore,87766,88788,-1022
2016-04-01,Goldman Sachs,CitiBank Singapore,86439,87276,-837
2016-05-01,Goldman Sachs,CitiBank Singapore,84374,84197,177
2016-06-01,Goldman Sachs,CitiBank Singapore,86315,84611,1704
2016-07-01,Goldman Sachs,CitiBank Singapore,88755,85882,2873
2016-08-01,Goldman Sachs,CitiBank Singapore,81469,83131,-1662
2016-09-01,Goldman Sachs,CitiBank Singapore,98622,91118,7504
2016-10-01,Goldman Sachs,CitiBank Singapore,93425,91852,1573
2016-11-01,Goldman Sachs,CitiBank Singapore,96137,99379,-3242
2016-12-01,Goldman Sachs,CitiBank Singapore,92222,91138,1084
2017-01-01,Goldman Sachs,CitiBank Singapore,93612,96875,-3263
2017-02-01,Goldman Sachs,CitiBank Singapore,93719,93743,-24
2017-03-01,Goldman Sachs,CitiBank Singapore,93378,94834,-1456
2017-04-01,Goldman Sachs,CitiBank Singapore,96378,98676,-2298
2017-05-01,Goldman Sachs,CitiBank Singapore,96739,97625,-886
2017-06-01,Goldman Sachs,CitiBank Singapore,98799,96782,2017
2017-07-01,Goldman Sachs,CitiBank Singapore,91877,92851,-974
2017-08-01,Goldman Sachs,CitiBank Singapore,99562,98612,950
2017-09-01,Goldman Sachs,CitiBank Singapore,94266,99199,-4933
2017-10-01,Goldman Sachs,CitiBank Singapore,96543,91869,4674
2017-11-01,Goldman Sachs,CitiBank Singapore,93641,99838,-6197
2017-12-01,Goldman Sachs,CitiBank Singapore,97723,98822,-1099
2018-01-01,Goldman Sachs,CitiBank Singapore,92461,97179,-4718
2018-02-01,Goldman Sachs,CitiBank Singapore,97313,97968,-655
2018-03-01,Goldman Sachs,CitiBank Singapore,94169,97693,-3524
2018-04-01,Goldman Sachs,CitiBank Singapore,99231,92246,6985
2010-01-01,Goldman Sachs,CitiBank HongKong,56163,57839,-1676
2010-02-01,Goldman Sachs,CitiBank HongKong,59358,55697,3661
2010-03-01,Goldman Sachs,CitiBank HongKong,58849,52174,6675
2010-04-01,Goldman Sachs,CitiBank HongKong,55493,51327,4166
2010-05-01,Goldman Sachs,CitiBank HongKong,54485,51879,2606
2010-06-01,Goldman Sachs,CitiBank HongKong,53614,57132,-3518
2010-07-01,Goldman Sachs,CitiBank HongKong,53312,54419,-1107
2010-08-01,Goldman Sachs,CitiBank HongKong,59625,52859,6766
2010-09-01,Goldman Sachs,CitiBank HongKong,58572,55996,2576
2010-10-01,Goldman Sachs,CitiBank HongKong,58953,53936,5017
2010-11-01,Goldman Sachs,CitiBank HongKong,53485,53193,292
2010-12-01,Goldman Sachs,CitiBank HongKong,55845,52515,3330
2011-01-01,Goldman Sachs,CitiBank HongKong,56463,53251,3212
2011-02-01,Goldman Sachs,CitiBank HongKong,53368,52394,974
2011-03-01,Goldman Sachs,CitiBank HongKong,54376,57981,-3605
2011-04-01,Goldman Sachs,CitiBank HongKong,56541,56692,-151
2011-05-01,Goldman Sachs,CitiBank HongKong,54881,53169,1712
2011-06-01,Goldman Sachs,CitiBank HongKong,51177,51143,34
2011-07-01,Goldman Sachs,CitiBank HongKong,57557,56383,1174
2011-08-01,Goldman Sachs,CitiBank HongKong,51568,58288,-6720
2011-09-01,Goldman Sachs,CitiBank HongKong,66553,67115,-562
2011-10-01,Goldman Sachs,CitiBank HongKong,66415,65844,571
2011-11-01,Goldman Sachs,CitiBank HongKong,65665,69553,-3888
2011-12-01,Goldman Sachs,CitiBank HongKong,69897,63565,6332
2012-01-01,Goldman Sachs,CitiBank HongKong,65496,66617,-1121
2012-02-01,Goldman Sachs,CitiBank HongKong,61195,64886,-3691
2012-03-01,Goldman Sachs,CitiBank HongKong,65924,65544,380
2012-04-01,Goldman Sachs,CitiBank HongKong,65432,65111,321
2012-05-01,Goldman Sachs,CitiBank HongKong,62387,66132,-3745
2012-06-01,Goldman Sachs,CitiBank HongKong,64639,67811,-3172
2012-07-01,Goldman Sachs,CitiBank HongKong,67738,64816,2922
2012-08-01,Goldman Sachs,CitiBank HongKong,61959,62966,-1007
2012-09-01,Goldman Sachs,CitiBank HongKong,68449,68516,-67
2012-10-01,Goldman Sachs,CitiBank HongKong,66291,68986,-2695
2012-11-01,Goldman Sachs,CitiBank HongKong,68487,65173,3314
2012-12-01,Goldman Sachs,CitiBank HongKong,62499,68587,-6088
2013-01-01,Goldman Sachs,CitiBank HongKong,62112,64199,-2087
2013-02-01,Goldman Sachs,CitiBank HongKong,67457,66648,809
2013-03-01,Goldman Sachs,CitiBank HongKong,65547,69818,-4271
2013-04-01,Goldman Sachs,CitiBank HongKong,66742,62547,4195
2013-05-01,Goldman Sachs,CitiBank HongKong,77674,74455,3219
2013-06-01,Goldman Sachs,CitiBank HongKong,77524,71585,5939
2013-07-01,Goldman Sachs,CitiBank HongKong,77328,78249,-921
2013-08-01,Goldman Sachs,CitiBank HongKong,71996,71323,673
2013-09-01,Goldman Sachs,CitiBank HongKong,73731,77438,-3707
2013-10-01,Goldman Sachs,CitiBank HongKong,74991,74267,724
2013-11-01,Goldman Sachs,CitiBank HongKong,79761,77726,2035
2013-12-01,Goldman Sachs,CitiBank HongKong,75245,79464,-4219
2014-01-01,Goldman Sachs,CitiBank HongKong,72928,77951,-5023
2014-02-01,Goldman Sachs,CitiBank HongKong,76548,75137,1411
2014-03-01,Goldman Sachs,CitiBank HongKong,73762,73959,-197
2014-04-01,Goldman Sachs,CitiBank HongKong,77865,76587,1278
2014-05-01,Goldman Sachs,CitiBank HongKong,75152,74396,756
2014-06-01,Goldman Sachs,CitiBank HongKong,77468,76444,1024
2014-07-01,Goldman Sachs,CitiBank HongKong,71189,79329,-8140
2014-08-01,Goldman Sachs,CitiBank HongKong,71482,76682,-5200
2014-09-01,Goldman Sachs,CitiBank HongKong,76588,78292,-1704
2014-10-01,Goldman Sachs,CitiBank HongKong,76584,71594,4990
2014-11-01,Goldman Sachs,CitiBank HongKong,74764,78383,-3619
2014-12-01,Goldman Sachs,CitiBank HongKong,75287,71676,3611
2015-01-01,Goldman Sachs,CitiBank HongKong,89611,82755,6856
2015-02-01,Goldman Sachs,CitiBank HongKong,89993,81147,8846
2015-03-01,Goldman Sachs,CitiBank HongKong,83471,84224,-753
2015-04-01,Goldman Sachs,CitiBank HongKong,84379,89737,-5358
2015-05-01,Goldman Sachs,CitiBank HongKong,83443,87244,-3801
2015-06-01,Goldman Sachs,CitiBank HongKong,82665,86149,-3484
2015-07-01,Goldman Sachs,CitiBank HongKong,83136,82373,763
2015-08-01,Goldman Sachs,CitiBank HongKong,82554,84597,-2043
2015-09-01,Goldman Sachs,CitiBank HongKong,82469,86434,-3965
2015-10-01,Goldman Sachs,CitiBank HongKong,83126,85636,-2510
2015-11-01,Goldman Sachs,CitiBank HongKong,85894,88718,-2824
2015-12-01,Goldman Sachs,CitiBank HongKong,84225,86379,-2154
2016-01-01,Goldman Sachs,CitiBank HongKong,83527,82558,969
2016-02-01,Goldman Sachs,CitiBank HongKong,84623,85713,-1090
2016-03-01,Goldman Sachs,CitiBank HongKong,89572,89956,-384
2016-04-01,Goldman Sachs,CitiBank HongKong,82834,84423,-1589
2016-05-01,Goldman Sachs,CitiBank HongKong,84964,84431,533
2016-06-01,Goldman Sachs,CitiBank HongKong,82652,83633,-981
2016-07-01,Goldman Sachs,CitiBank HongKong,83458,85673,-2215
2016-08-01,Goldman Sachs,CitiBank HongKong,81642,87546,-5904
2016-09-01,Goldman Sachs,CitiBank HongKong,97629,94951,2678
2016-10-01,Goldman Sachs,CitiBank HongKong,92178,92792,-614
2016-11-01,Goldman Sachs,CitiBank HongKong,97569,94337,3232
2016-12-01,Goldman Sachs,CitiBank HongKong,95648,98579,-2931
2017-01-01,Goldman Sachs,CitiBank HongKong,96216,93566,2650
2017-02-01,Goldman Sachs,CitiBank HongKong,91769,98744,-6975
2017-03-01,Goldman Sachs,CitiBank HongKong,93122,97885,-4763
2017-04-01,Goldman Sachs,CitiBank HongKong,93963,98879,-4916
2017-05-01,Goldman Sachs,CitiBank HongKong,93782,93269,513
2017-06-01,Goldman Sachs,CitiBank HongKong,99466,92672,6794
2017-07-01,Goldman Sachs,CitiBank HongKong,92936,93417,-481
2017-08-01,Goldman Sachs,CitiBank HongKong,97962,97675,287
2017-09-01,Goldman Sachs,CitiBank HongKong,93568,92649,919
2017-10-01,Goldman Sachs,CitiBank HongKong,98739,94444,4295
2017-11-01,Goldman Sachs,CitiBank HongKong,98147,91264,6883
2017-12-01,Goldman Sachs,CitiBank HongKong,97836,92175,5661
2018-01-01,Goldman Sachs,CitiBank HongKong,91229,92789,-1560
2018-02-01,Goldman Sachs,CitiBank HongKong,94354,98148,-3794
2018-03-01,Goldman Sachs,CitiBank HongKong,92452,96497,-4045
2018-04-01,Goldman Sachs,CitiBank HongKong,93755,91424,2331
2010-01-01,Deutsche Bank,CitiBank New York,54284,51329,2955
2010-02-01,Deutsche Bank,CitiBank New York,55714,58816,-3102
2010-03-01,Deutsche Bank,CitiBank New York,58396,53445,4951
2010-04-01,Deutsche Bank,CitiBank New York,57839,56443,1396
2010-05-01,Deutsche Bank,CitiBank New York,57227,59215,-1988
2010-06-01,Deutsche Bank,CitiBank New York,55922,58484,-2562
2010-07-01,Deutsche Bank,CitiBank New York,51854,51211,643
2010-08-01,Deutsche Bank,CitiBank New York,52873,52748,125
2010-09-01,Deutsche Bank,CitiBank New York,57179,55136,2043
2010-10-01,Deutsche Bank,CitiBank New York,58774,55455,3319
2010-11-01,Deutsche Bank,CitiBank New York,56712,56515,197
2010-12-01,Deutsche Bank,CitiBank New York,53324,55781,-2457
2011-01-01,Deutsche Bank,CitiBank New York,56248,56161,87
2011-02-01,Deutsche Bank,CitiBank New York,51919,52575,-656
2011-03-01,Deutsche Bank,CitiBank New York,55269,55416,-147
2011-04-01,Deutsche Bank,CitiBank New York,53526,56648,-3122
2011-05-01,Deutsche Bank,CitiBank New York,55134,51994,3140
2011-06-01,Deutsche Bank,CitiBank New York,59353,54673,4680
2011-07-01,Deutsche Bank,CitiBank New York,59236,56561,2675
2011-08-01,Deutsche Bank,CitiBank New York,53268,53344,-76
2011-09-01,Deutsche Bank,CitiBank New York,65247,68735,-3488
2011-10-01,Deutsche Bank,CitiBank New York,61979,65583,-3604
2011-11-01,Deutsche Bank,CitiBank New York,61438,65419,-3981
2011-12-01,Deutsche Bank,CitiBank New York,62599,68477,-5878
2012-01-01,Deutsche Bank,CitiBank New York,67658,69746,-2088
2012-02-01,Deutsche Bank,CitiBank New York,65194,63195,1999
2012-03-01,Deutsche Bank,CitiBank New York,62624,66475,-3851
2012-04-01,Deutsche Bank,CitiBank New York,63678,66892,-3214
2012-05-01,Deutsche Bank,CitiBank New York,68884,65213,3671
2012-06-01,Deutsche Bank,CitiBank New York,67258,69764,-2506
2012-07-01,Deutsche Bank,CitiBank New York,65877,67215,-1338
2012-08-01,Deutsche Bank,CitiBank New York,65544,65925,-381
2012-09-01,Deutsche Bank,CitiBank New York,62429,62758,-329
2012-10-01,Deutsche Bank,CitiBank New York,66177,62939,3238
2012-11-01,Deutsche Bank,CitiBank New York,62912,61513,1399
2012-12-01,Deutsche Bank,CitiBank New York,66314,66518,-204
2013-01-01,Deutsche Bank,CitiBank New York,65617,68286,-2669
2013-02-01,Deutsche Bank,CitiBank New York,63365,67325,-3960
2013-03-01,Deutsche Bank,CitiBank New York,61488,68646,-7158
2013-04-01,Deutsche Bank,CitiBank New York,68535,64669,3866
2013-05-01,Deutsche Bank,CitiBank New York,73334,78239,-4905
2013-06-01,Deutsche Bank,CitiBank New York,73792,73167,625
2013-07-01,Deutsche Bank,CitiBank New York,79691,74444,5247
2013-08-01,Deutsche Bank,CitiBank New York,75761,74974,787
2013-09-01,Deutsche Bank,CitiBank New York,73777,72417,1360
2013-10-01,Deutsche Bank,CitiBank New York,76712,72791,3921
2013-11-01,Deutsche Bank,CitiBank New York,72674,75276,-2602
2013-12-01,Deutsche Bank,CitiBank New York,76378,79881,-3503
2014-01-01,Deutsche Bank,CitiBank New York,78671,72335,6336
2014-02-01,Deutsche Bank,CitiBank New York,72682,74158,-1476
2014-03-01,Deutsche Bank,CitiBank New York,78669,79662,-993
2014-04-01,Deutsche Bank,CitiBank New York,71573,77918,-6345
2014-05-01,Deutsche Bank,CitiBank New York,71777,71536,241
2014-06-01,Deutsche Bank,CitiBank New York,74353,71235,3118
2014-07-01,Deutsche Bank,CitiBank New York,77241,78775,-1534
2014-08-01,Deutsche Bank,CitiBank New York,73725,79523,-5798
2014-09-01,Deutsche Bank,CitiBank New York,71516,71995,-479
2014-10-01,Deutsche Bank,CitiBank New York,76969,79146,-2177
2014-11-01,Deutsche Bank,CitiBank New York,78267,79218,-951
2014-12-01,Deutsche Bank,CitiBank New York,74716,79139,-4423
2015-01-01,Deutsche Bank,CitiBank New York,83874,85128,-1254
2015-02-01,Deutsche Bank,CitiBank New York,88418,85294,3124
2015-03-01,Deutsche Bank,CitiBank New York,82614,89612,-6998
2015-04-01,Deutsche Bank,CitiBank New York,83162,82973,189
2015-05-01,Deutsche Bank,CitiBank New York,82577,89856,-7279
2015-06-01,Deutsche Bank,CitiBank New York,84229,84668,-439
2015-07-01,Deutsche Bank,CitiBank New York,89449,81661,7788
2015-08-01,Deutsche Bank,CitiBank New York,84267,87211,-2944
2015-09-01,Deutsche Bank,CitiBank New York,83855,87737,-3882
2015-10-01,Deutsche Bank,CitiBank New York,81462,82358,-896
2015-11-01,Deutsche Bank,CitiBank New York,85893,81757,4136
2015-12-01,Deutsche Bank,CitiBank New York,84677,82921,1756
2016-01-01,Deutsche Bank,CitiBank New York,81221,85773,-4552
2016-02-01,Deutsche Bank,CitiBank New York,81677,87973,-6296
2016-03-01,Deutsche Bank,CitiBank New York,84819,82959,1860
2016-04-01,Deutsche Bank,CitiBank New York,83152,86575,-3423
2016-05-01,Deutsche Bank,CitiBank New York,88687,87621,1066
2016-06-01,Deutsche Bank,CitiBank New York,81373,82159,-786
2016-07-01,Deutsche Bank,CitiBank New York,86331,84192,2139
2016-08-01,Deutsche Bank,CitiBank New York,84659,83357,1302
2016-09-01,Deutsche Bank,CitiBank New York,93529,95857,-2328
2016-10-01,Deutsche Bank,CitiBank New York,95825,91972,3853
2016-11-01,Deutsche Bank,CitiBank New York,96699,97471,-772
2016-12-01,Deutsche Bank,CitiBank New York,97416,93537,3879
2017-01-01,Deutsche Bank,CitiBank New York,94769,93788,981
2017-02-01,Deutsche Bank,CitiBank New York,96944,96915,29
2017-03-01,Deutsche Bank,CitiBank New York,98274,96334,1940
2017-04-01,Deutsche Bank,CitiBank New York,99983,93615,6368
2017-05-01,Deutsche Bank,CitiBank New York,96792,98242,-1450
2017-06-01,Deutsche Bank,CitiBank New York,96563,95837,726
2017-07-01,Deutsche Bank,CitiBank New York,99765,96199,3566
2017-08-01,Deutsche Bank,CitiBank New York,94283,96815,-2532
2017-09-01,Deutsche Bank,CitiBank New York,91975,98651,-6676
2017-10-01,Deutsche Bank,CitiBank New York,99558,91546,8012
2017-11-01,Deutsche Bank,CitiBank New York,99873,97765,2108
2017-12-01,Deutsche Bank,CitiBank New York,96176,97511,-1335
2018-01-01,Deutsche Bank,CitiBank New York,97412,99519,-2107
2018-02-01,Deutsche Bank,CitiBank New York,93543,99151,-5608
2018-03-01,Deutsche Bank,CitiBank New York,93935,91327,2608
2018-04-01,Deutsche Bank,CitiBank New York,94519,95224,-705
2010-01-01,Deutsche Bank,CitiBank London,59339,56224,3115
2010-02-01,Deutsche Bank,CitiBank London,53781,58737,-4956
2010-03-01,Deutsche Bank,CitiBank London,52365,59728,-7363
2010-04-01,Deutsche Bank,CitiBank London,58783,58447,336
2010-05-01,Deutsche Bank,CitiBank London,58518,56961,1557
2010-06-01,Deutsche Bank,CitiBank London,56891,51917,4974
2010-07-01,Deutsche Bank,CitiBank London,53218,51464,1754
2010-08-01,Deutsche Bank,CitiBank London,51295,56552,-5257
2010-09-01,Deutsche Bank,CitiBank London,52889,56253,-3364
2010-10-01,Deutsche Bank,CitiBank London,57985,51372,6613
2010-11-01,Deutsche Bank,CitiBank London,55155,58231,-3076
2010-12-01,Deutsche Bank,CitiBank London,59767,59741,26
2011-01-01,Deutsche Bank,CitiBank London,55741,52922,2819
2011-02-01,Deutsche Bank,CitiBank London,51484,57992,-6508
2011-03-01,Deutsche Bank,CitiBank London,58434,56176,2258
2011-04-01,Deutsche Bank,CitiBank London,53276,56848,-3572
2011-05-01,Deutsche Bank,CitiBank London,55284,59283,-3999
2011-06-01,Deutsche Bank,CitiBank London,59157,54717,4440
2011-07-01,Deutsche Bank,CitiBank London,54936,55763,-827
2011-08-01,Deutsche Bank,CitiBank London,52698,59922,-7224
2011-09-01,Deutsche Bank,CitiBank London,63631,67878,-4247
2011-10-01,Deutsche Bank,CitiBank London,61372,65414,-4042
2011-11-01,Deutsche Bank,CitiBank London,65337,69559,-4222
2011-12-01,Deutsche Bank,CitiBank London,69227,63745,5482
2012-01-01,Deutsche Bank,CitiBank London,65932,69558,-3626
2012-02-01,Deutsche Bank,CitiBank London,68671,65318,3353
2012-03-01,Deutsche Bank,CitiBank London,68793,65169,3624
2012-04-01,Deutsche Bank,CitiBank London,63485,69821,-6336
2012-05-01,Deutsche Bank,CitiBank London,61931,67181,-5250
2012-06-01,Deutsche Bank,CitiBank London,68849,69523,-674
2012-07-01,Deutsche Bank,CitiBank London,64716,65668,-952
2012-08-01,Deutsche Bank,CitiBank London,67579,67576,3
2012-09-01,Deutsche Bank,CitiBank London,67455,64354,3101
2012-10-01,Deutsche Bank,CitiBank London,64648,63567,1081
2012-11-01,Deutsche Bank,CitiBank London,69444,63931,5513
2012-12-01,Deutsche Bank,CitiBank London,64343,64892,-549
2013-01-01,Deutsche Bank,CitiBank London,66884,64198,2686
2013-02-01,Deutsche Bank,CitiBank London,63726,69899,-6173
2013-03-01,Deutsche Bank,CitiBank London,66295,62752,3543
2013-04-01,Deutsche Bank,CitiBank London,66141,65847,294
2013-05-01,Deutsche Bank,CitiBank London,71383,73782,-2399
2013-06-01,Deutsche Bank,CitiBank London,78534,73365,5169
2013-07-01,Deutsche Bank,CitiBank London,73298,74169,-871
2013-08-01,Deutsche Bank,CitiBank London,76113,78832,-2719
2013-09-01,Deutsche Bank,CitiBank London,76798,79438,-2640
2013-10-01,Deutsche Bank,CitiBank London,78755,71234,7521
2013-11-01,Deutsche Bank,CitiBank London,72361,73158,-797
2013-12-01,Deutsche Bank,CitiBank London,79129,77747,1382
2014-01-01,Deutsche Bank,CitiBank London,76674,79476,-2802
2014-02-01,Deutsche Bank,CitiBank London,77833,76947,886
2014-03-01,Deutsche Bank,CitiBank London,79493,78768,725
2014-04-01,Deutsche Bank,CitiBank London,77253,71676,5577
2014-05-01,Deutsche Bank,CitiBank London,75324,77514,-2190
2014-06-01,Deutsche Bank,CitiBank London,73141,73269,-128
2014-07-01,Deutsche Bank,CitiBank London,79532,78496,1036
2014-08-01,Deutsche Bank,CitiBank London,75166,74794,372
2014-09-01,Deutsche Bank,CitiBank London,75161,73266,1895
2014-10-01,Deutsche Bank,CitiBank London,75548,77556,-2008
2014-11-01,Deutsche Bank,CitiBank London,72826,74219,-1393
2014-12-01,Deutsche Bank,CitiBank London,71772,79342,-7570
2015-01-01,Deutsche Bank,CitiBank London,89178,82639,6539
2015-02-01,Deutsche Bank,CitiBank London,88763,87285,1478
2015-03-01,Deutsche Bank,CitiBank London,85857,81443,4414
2015-04-01,Deutsche Bank,CitiBank London,84137,86663,-2526
2015-05-01,Deutsche Bank,CitiBank London,81464,85575,-4111
2015-06-01,Deutsche Bank,CitiBank London,89785,83213,6572
2015-07-01,Deutsche Bank,CitiBank London,81454,87313,-5859
2015-08-01,Deutsche Bank,CitiBank London,87814,82465,5349
2015-09-01,Deutsche Bank,CitiBank London,88839,89337,-498
2015-10-01,Deutsche Bank,CitiBank London,87451,83135,4316
2015-11-01,Deutsche Bank,CitiBank London,85267,88663,-3396
2015-12-01,Deutsche Bank,CitiBank London,88685,85645,3040
2016-01-01,Deutsche Bank,CitiBank London,88232,89621,-1389
2016-02-01,Deutsche Bank,CitiBank London,86587,83216,3371
2016-03-01,Deutsche Bank,CitiBank London,86743,86899,-156
2016-04-01,Deutsche Bank,CitiBank London,81126,88926,-7800
2016-05-01,Deutsche Bank,CitiBank London,87746,81174,6572
2016-06-01,Deutsche Bank,CitiBank London,89412,82782,6630
2016-07-01,Deutsche Bank,CitiBank London,82811,88512,-5701
2016-08-01,Deutsche Bank,CitiBank London,86567,82375,4192
2016-09-01,Deutsche Bank,CitiBank London,97687,91212,6475
2016-10-01,Deutsche Bank,CitiBank London,95685,92871,2814
2016-11-01,Deutsche Bank,CitiBank London,91849,97538,-5689
2016-12-01,Deutsche Bank,CitiBank London,96669,97467,-798
2017-01-01,Deutsche Bank,CitiBank London,98669,92779,5890
2017-02-01,Deutsche Bank,CitiBank London,91356,99584,-8228
2017-03-01,Deutsche Bank,CitiBank London,97264,96879,385
2017-04-01,Deutsche Bank,CitiBank London,96533,94385,2148
2017-05-01,Deutsche Bank,CitiBank London,95969,95177,792
2017-06-01,Deutsche Bank,CitiBank London,97911,91556,6355
2017-07-01,Deutsche Bank,CitiBank London,98936,95357,3579
2017-08-01,Deutsche Bank,CitiBank London,98119,99625,-1506
2017-09-01,Deutsche Bank,CitiBank London,93121,99994,-6873
2017-10-01,Deutsche Bank,CitiBank London,93683,98776,-5093
2017-11-01,Deutsche Bank,CitiBank London,95881,95856,25
2017-12-01,Deutsche Bank,CitiBank London,96138,97911,-1773
2018-01-01,Deutsche Bank,CitiBank London,92919,92826,93
2018-02-01,Deutsche Bank,CitiBank London,96529,95425,1104
2018-03-01,Deutsche Bank,CitiBank London,95547,91785,3762
2018-04-01,Deutsche Bank,CitiBank London,94316,96953,-2637
2010-01-01,Deutsche Bank,CitiBank Pune,54242,57638,-3396
2010-02-01,Deutsche Bank,CitiBank Pune,56137,51169,4968
2010-03-01,Deutsche Bank,CitiBank Pune,57743,55865,1878
2010-04-01,Deutsche Bank,CitiBank Pune,56819,53279,3540
2010-05-01,Deutsche Bank,CitiBank Pune,55162,51933,3229
2010-06-01,Deutsche Bank,CitiBank Pune,58158,57785,373
2010-07-01,Deutsche Bank,CitiBank Pune,51843,57668,-5825
2010-08-01,Deutsche Bank,CitiBank Pune,58491,57252,1239
2010-09-01,Deutsche Bank,CitiBank Pune,52767,53892,-1125
2010-10-01,Deutsche Bank,CitiBank Pune,57988,55727,2261
2010-11-01,Deutsche Bank,CitiBank Pune,54623,51776,2847
2010-12-01,Deutsche Bank,CitiBank Pune,58134,58556,-422
2011-01-01,Deutsche Bank,CitiBank Pune,57988,53439,4549
2011-02-01,Deutsche Bank,CitiBank Pune,51329,56518,-5189
2011-03-01,Deutsche Bank,CitiBank Pune,58174,59537,-1363
2011-04-01,Deutsche Bank,CitiBank Pune,55175,55737,-562
2011-05-01,Deutsche Bank,CitiBank Pune,55578,55887,-309
2011-06-01,Deutsche Bank,CitiBank Pune,55486,54386,1100
2011-07-01,Deutsche Bank,CitiBank Pune,51366,51287,79
2011-08-01,Deutsche Bank,CitiBank Pune,58279,51198,7081
2011-09-01,Deutsche Bank,CitiBank Pune,61256,68622,-7366
2011-10-01,Deutsche Bank,CitiBank Pune,64796,61652,3144
2011-11-01,Deutsche Bank,CitiBank Pune,67368,63354,4014
2011-12-01,Deutsche Bank,CitiBank Pune,68916,68555,361
2012-01-01,Deutsche Bank,CitiBank Pune,68591,64555,4036
2012-02-01,Deutsche Bank,CitiBank Pune,68969,69536,-567
2012-03-01,Deutsche Bank,CitiBank Pune,65728,68667,-2939
2012-04-01,Deutsche Bank,CitiBank Pune,65213,63914,1299
2012-05-01,Deutsche Bank,CitiBank Pune,67171,66631,540
2012-06-01,Deutsche Bank,CitiBank Pune,65177,69267,-4090
2012-07-01,Deutsche Bank,CitiBank Pune,62535,64357,-1822
2012-08-01,Deutsche Bank,CitiBank Pune,64185,63846,339
2012-09-01,Deutsche Bank,CitiBank Pune,66375,62716,3659
2012-10-01,Deutsche Bank,CitiBank Pune,66677,69914,-3237
2012-11-01,Deutsche Bank,CitiBank Pune,69489,64216,5273
2012-12-01,Deutsche Bank,CitiBank Pune,64581,61737,2844
2013-01-01,Deutsche Bank,CitiBank Pune,63112,69487,-6375
2013-02-01,Deutsche Bank,CitiBank Pune,69477,63164,6313
2013-03-01,Deutsche Bank,CitiBank Pune,67116,66334,782
2013-04-01,Deutsche Bank,CitiBank Pune,65886,62828,3058
2013-05-01,Deutsche Bank,CitiBank Pune,75284,72895,2389
2013-06-01,Deutsche Bank,CitiBank Pune,71513,73156,-1643
2013-07-01,Deutsche Bank,CitiBank Pune,71841,72825,-984
2013-08-01,Deutsche Bank,CitiBank Pune,72427,73728,-1301
2013-09-01,Deutsche Bank,CitiBank Pune,73562,79598,-6036
2013-10-01,Deutsche Bank,CitiBank Pune,74817,76895,-2078
2013-11-01,Deutsche Bank,CitiBank Pune,79982,74367,5615
2013-12-01,Deutsche Bank,CitiBank Pune,79891,79293,598
2014-01-01,Deutsche Bank,CitiBank Pune,72677,71153,1524
2014-02-01,Deutsche Bank,CitiBank Pune,75688,71612,4076
2014-03-01,Deutsche Bank,CitiBank Pune,72936,73249,-313
2014-04-01,Deutsche Bank,CitiBank Pune,74749,79764,-5015
2014-05-01,Deutsche Bank,CitiBank Pune,77119,76134,985
2014-06-01,Deutsche Bank,CitiBank Pune,71154,79233,-8079
2014-07-01,Deutsche Bank,CitiBank Pune,78413,71169,7244
2014-08-01,Deutsche Bank,CitiBank Pune,78615,73738,4877
2014-09-01,Deutsche Bank,CitiBank Pune,72257,73769,-1512
2014-10-01,Deutsche Bank,CitiBank Pune,76615,78491,-1876
2014-11-01,Deutsche Bank,CitiBank Pune,79426,71459,7967
2014-12-01,Deutsche Bank,CitiBank Pune,77478,77887,-409
2015-01-01,Deutsche Bank,CitiBank Pune,85423,86245,-822
2015-02-01,Deutsche Bank,CitiBank Pune,83216,81963,1253
2015-03-01,Deutsche Bank,CitiBank Pune,89314,84171,5143
2015-04-01,Deutsche Bank,CitiBank Pune,89526,86431,3095
2015-05-01,Deutsche Bank,CitiBank Pune,88987,89634,-647
2015-06-01,Deutsche Bank,CitiBank Pune,85265,89618,-4353
2015-07-01,Deutsche Bank,CitiBank Pune,84235,83615,620
2015-08-01,Deutsche Bank,CitiBank Pune,89445,83397,6048
2015-09-01,Deutsche Bank,CitiBank Pune,81441,89498,-8057
2015-10-01,Deutsche Bank,CitiBank Pune,88958,85638,3320
2015-11-01,Deutsche Bank,CitiBank Pune,86293,88533,-2240
2015-12-01,Deutsche Bank,CitiBank Pune,89449,89225,224
2016-01-01,Deutsche Bank,CitiBank Pune,89969,89116,853
2016-02-01,Deutsche Bank,CitiBank Pune,82117,84492,-2375
2016-03-01,Deutsche Bank,CitiBank Pune,88875,81146,7729
2016-04-01,Deutsche Bank,CitiBank Pune,83451,88188,-4737
2016-05-01,Deutsche Bank,CitiBank Pune,81127,83811,-2684
2016-06-01,Deutsche Bank,CitiBank Pune,84426,81658,2768
2016-07-01,Deutsche Bank,CitiBank Pune,81733,86885,-5152
2016-08-01,Deutsche Bank,CitiBank Pune,85927,89794,-3867
2016-09-01,Deutsche Bank,CitiBank Pune,98679,97531,1148
2016-10-01,Deutsche Bank,CitiBank Pune,96544,97165,-621
2016-11-01,Deutsche Bank,CitiBank Pune,94742,93313,1429
2016-12-01,Deutsche Bank,CitiBank Pune,91975,96138,-4163
2017-01-01,Deutsche Bank,CitiBank Pune,95481,98414,-2933
2017-02-01,Deutsche Bank,CitiBank Pune,94968,99184,-4216
2017-03-01,Deutsche Bank,CitiBank Pune,97526,94755,2771
2017-04-01,Deutsche Bank,CitiBank Pune,97932,93514,4418
2017-05-01,Deutsche Bank,CitiBank Pune,93627,96188,-2561
2017-06-01,Deutsche Bank,CitiBank Pune,94376,93757,619
2017-07-01,Deutsche Bank,CitiBank Pune,98431,91847,6584
2017-08-01,Deutsche Bank,CitiBank Pune,93766,94927,-1161
2017-09-01,Deutsche Bank,CitiBank Pune,95858,96727,-869
2017-10-01,Deutsche Bank,CitiBank Pune,99242,92588,6654
2017-11-01,Deutsche Bank,CitiBank Pune,95113,94848,265
2017-12-01,Deutsche Bank,CitiBank Pune,97731,94895,2836
2018-01-01,Deutsche Bank,CitiBank Pune,96259,97156,-897
2018-02-01,Deutsche Bank,CitiBank Pune,99899,94978,4921
2018-03-01,Deutsche Bank,CitiBank Pune,92484,98486,-6002
2018-04-01,Deutsche Bank,CitiBank Pune,92716,92167,549
2010-01-01,Deutsche Bank,CitiBank Singapore,58749,57477,1272
2010-02-01,Deutsche Bank,CitiBank Singapore,59477,51849,7628
2010-03-01,Deutsche Bank,CitiBank Singapore,55713,54938,775
2010-04-01,Deutsche Bank,CitiBank Singapore,57656,56766,890
2010-05-01,Deutsche Bank,CitiBank Singapore,54672,51556,3116
2010-06-01,Deutsche Bank,CitiBank Singapore,52471,53774,-1303
2010-07-01,Deutsche Bank,CitiBank Singapore,55676,57468,-1792
2010-08-01,Deutsche Bank,CitiBank Singapore,54123,59538,-5415
2010-09-01,Deutsche Bank,CitiBank Singapore,52136,56755,-4619
2010-10-01,Deutsche Bank,CitiBank Singapore,52426,57344,-4918
2010-11-01,Deutsche Bank,CitiBank Singapore,51976,56598,-4622
2010-12-01,Deutsche Bank,CitiBank Singapore,51816,51615,201
2011-01-01,Deutsche Bank,CitiBank Singapore,51279,55526,-4247
2011-02-01,Deutsche Bank,CitiBank Singapore,55283,54861,422
2011-03-01,Deutsche Bank,CitiBank Singapore,59987,59125,862
2011-04-01,Deutsche Bank,CitiBank Singapore,51425,55193,-3768
2011-05-01,Deutsche Bank,CitiBank Singapore,51242,54472,-3230
2011-06-01,Deutsche Bank,CitiBank Singapore,55437,58272,-2835
2011-07-01,Deutsche Bank,CitiBank Singapore,54474,56952,-2478
2011-08-01,Deutsche Bank,CitiBank Singapore,57465,59717,-2252
2011-09-01,Deutsche Bank,CitiBank Singapore,64325,63887,438
2011-10-01,Deutsche Bank,CitiBank Singapore,69434,61486,7948
2011-11-01,Deutsche Bank,CitiBank Singapore,67273,69397,-2124
2011-12-01,Deutsche Bank,CitiBank Singapore,65281,63242,2039
2012-01-01,Deutsche Bank,CitiBank Singapore,62692,61159,1533
2012-02-01,Deutsche Bank,CitiBank Singapore,61395,62843,-1448
2012-03-01,Deutsche Bank,CitiBank Singapore,64912,62783,2129
2012-04-01,Deutsche Bank,CitiBank Singapore,69148,67938,1210
2012-05-01,Deutsche Bank,CitiBank Singapore,68338,63737,4601
2012-06-01,Deutsche Bank,CitiBank Singapore,69479,68313,1166
2012-07-01,Deutsche Bank,CitiBank Singapore,62648,63975,-1327
2012-08-01,Deutsche Bank,CitiBank Singapore,62934,61241,1693
2012-09-01,Deutsche Bank,CitiBank Singapore,67791,69432,-1641
2012-10-01,Deutsche Bank,CitiBank Singapore,65861,65468,393
2012-11-01,Deutsche Bank,CitiBank Singapore,62691,63153,-462
2012-12-01,Deutsche Bank,CitiBank Singapore,68222,61294,6928
2013-01-01,Deutsche Bank,CitiBank Singapore,67142,61266,5876
2013-02-01,Deutsche Bank,CitiBank Singapore,69871,67526,2345
2013-03-01,Deutsche Bank,CitiBank Singapore,67763,66532,1231
2013-04-01,Deutsche Bank,CitiBank Singapore,61139,66886,-5747
2013-05-01,Deutsche Bank,CitiBank Singapore,73468,73612,-144
2013-06-01,Deutsche Bank,CitiBank Singapore,71865,72498,-633
2013-07-01,Deutsche Bank,CitiBank Singapore,73517,78592,-5075
2013-08-01,Deutsche Bank,CitiBank Singapore,72419,79868,-7449
2013-09-01,Deutsche Bank,CitiBank Singapore,77969,73944,4025
2013-10-01,Deutsche Bank,CitiBank Singapore,71337,79523,-8186
2013-11-01,Deutsche Bank,CitiBank Singapore,71863,73211,-1348
2013-12-01,Deutsche Bank,CitiBank Singapore,79356,79329,27
2014-01-01,Deutsche Bank,CitiBank Singapore,71652,74118,-2466
2014-02-01,Deutsche Bank,CitiBank Singapore,73758,72344,1414
2014-03-01,Deutsche Bank,CitiBank Singapore,73716,79838,-6122
2014-04-01,Deutsche Bank,CitiBank Singapore,79228,76321,2907
2014-05-01,Deutsche Bank,CitiBank Singapore,79216,74778,4438
2014-06-01,Deutsche Bank,CitiBank Singapore,77162,75916,1246
2014-07-01,Deutsche Bank,CitiBank Singapore,79468,72445,7023
2014-08-01,Deutsche Bank,CitiBank Singapore,79973,72373,7600
2014-09-01,Deutsche Bank,CitiBank Singapore,73696,78321,-4625
2014-10-01,Deutsche Bank,CitiBank Singapore,75327,77911,-2584
2014-11-01,Deutsche Bank,CitiBank Singapore,74882,77469,-2587
2014-12-01,Deutsche Bank,CitiBank Singapore,77647,75395,2252
2015-01-01,Deutsche Bank,CitiBank Singapore,85176,82353,2823
2015-02-01,Deutsche Bank,CitiBank Singapore,85595,85189,406
2015-03-01,Deutsche Bank,CitiBank Singapore,87941,83252,4689
2015-04-01,Deutsche Bank,CitiBank Singapore,85234,84699,535
2015-05-01,Deutsche Bank,CitiBank Singapore,85535,81596,3939
2015-06-01,Deutsche Bank,CitiBank Singapore,81826,84686,-2860
2015-07-01,Deutsche Bank,CitiBank Singapore,85617,86967,-1350
2015-08-01,Deutsche Bank,CitiBank Singapore,85557,85487,70
2015-09-01,Deutsche Bank,CitiBank Singapore,84926,85347,-421
2015-10-01,Deutsche Bank,CitiBank Singapore,87756,81253,6503
2015-11-01,Deutsche Bank,CitiBank Singapore,82817,83666,-849
2015-12-01,Deutsche Bank,CitiBank Singapore,89749,87277,2472
2016-01-01,Deutsche Bank,CitiBank Singapore,82261,82666,-405
2016-02-01,Deutsche Bank,CitiBank Singapore,84524,82564,1960
2016-03-01,Deutsche Bank,CitiBank Singapore,88218,88641,-423
2016-04-01,Deutsche Bank,CitiBank Singapore,81795,86936,-5141
2016-05-01,Deutsche Bank,CitiBank Singapore,85285,81416,3869
2016-06-01,Deutsche Bank,CitiBank Singapore,83656,87856,-4200
2016-07-01,Deutsche Bank,CitiBank Singapore,84661,89218,-4557
2016-08-01,Deutsche Bank,CitiBank Singapore,88973,82313,6660
2016-09-01,Deutsche Bank,CitiBank Singapore,91122,96147,-5025
2016-10-01,Deutsche Bank,CitiBank Singapore,95416,96437,-1021
2016-11-01,Deutsche Bank,CitiBank Singapore,98754,93287,5467
2016-12-01,Deutsche Bank,CitiBank Singapore,92131,96231,-4100
2017-01-01,Deutsche Bank,CitiBank Singapore,96752,96587,165
2017-02-01,Deutsche Bank,CitiBank Singapore,99411,98458,953
2017-03-01,Deutsche Bank,CitiBank Singapore,94267,98219,-3952
2017-04-01,Deutsche Bank,CitiBank Singapore,96216,94726,1490
2017-05-01,Deutsche Bank,CitiBank Singapore,99339,91765,7574
2017-06-01,Deutsche Bank,CitiBank Singapore,94935,92481,2454
2017-07-01,Deutsche Bank,CitiBank Singapore,97579,94838,2741
2017-08-01,Deutsche Bank,CitiBank Singapore,98915,94693,4222
2017-09-01,Deutsche Bank,CitiBank Singapore,94222,98492,-4270
2017-10-01,Deutsche Bank,CitiBank Singapore,91638,96137,-4499
2017-11-01,Deutsche Bank,CitiBank Singapore,97553,94243,3310
2017-12-01,Deutsche Bank,CitiBank Singapore,93528,97863,-4335
2018-01-01,Deutsche Bank,CitiBank Singapore,99376,96314,3062
2018-02-01,Deutsche Bank,CitiBank Singapore,92261,97722,-5461
2018-03-01,Deutsche Bank,CitiBank Singapore,96492,97628,-1136
2018-04-01,Deutsche Bank,CitiBank Singapore,99848,94863,4985
2010-01-01,Deutsche Bank,CitiBank HongKong,55785,56611,-826
2010-02-01,Deutsche Bank,CitiBank HongKong,57145,56262,883
2010-03-01,Deutsche Bank,CitiBank HongKong,52168,56385,-4217
2010-04-01,Deutsche Bank,CitiBank HongKong,56561,59914,-3353
2010-05-01,Deutsche Bank,CitiBank HongKong,57883,56332,1551
2010-06-01,Deutsche Bank,CitiBank HongKong,54525,59477,-4952
2010-07-01,Deutsche Bank,CitiBank HongKong,57918,51367,6551
2010-08-01,Deutsche Bank,CitiBank HongKong,55423,56231,-808
2010-09-01,Deutsche Bank,CitiBank HongKong,59913,54134,5779
2010-10-01,Deutsche Bank,CitiBank HongKong,52433,59118,-6685
2010-11-01,Deutsche Bank,CitiBank HongKong,55848,53491,2357
2010-12-01,Deutsche Bank,CitiBank HongKong,59433,55748,3685
2011-01-01,Deutsche Bank,CitiBank HongKong,55659,55979,-320
2011-02-01,Deutsche Bank,CitiBank HongKong,56955,55316,1639
2011-03-01,Deutsche Bank,CitiBank HongKong,55642,55425,217
2011-04-01,Deutsche Bank,CitiBank HongKong,56159,52389,3770
2011-05-01,Deutsche Bank,CitiBank HongKong,51395,57912,-6517
2011-06-01,Deutsche Bank,CitiBank HongKong,54146,53374,772
2011-07-01,Deutsche Bank,CitiBank HongKong,59546,51424,8122
2011-08-01,Deutsche Bank,CitiBank HongKong,53567,54379,-812
2011-09-01,Deutsche Bank,CitiBank HongKong,61886,61124,762
2011-10-01,Deutsche Bank,CitiBank HongKong,61774,64127,-2353
2011-11-01,Deutsche Bank,CitiBank HongKong,65296,63571,1725
2011-12-01,Deutsche Bank,CitiBank HongKong,69325,66845,2480
2012-01-01,Deutsche Bank,CitiBank HongKong,62359,64469,-2110
2012-02-01,Deutsche Bank,CitiBank HongKong,63839,67819,-3980
2012-03-01,Deutsche Bank,CitiBank HongKong,68545,62961,5584
2012-04-01,Deutsche Bank,CitiBank HongKong,64817,64167,650
2012-05-01,Deutsche Bank,CitiBank HongKong,67895,65765,2130
2012-06-01,Deutsche Bank,CitiBank HongKong,62324,66834,-4510
2012-07-01,Deutsche Bank,CitiBank HongKong,66775,66881,-106
2012-08-01,Deutsche Bank,CitiBank HongKong,66241,67488,-1247
2012-09-01,Deutsche Bank,CitiBank HongKong,65513,65729,-216
2012-10-01,Deutsche Bank,CitiBank HongKong,64341,63191,1150
2012-11-01,Deutsche Bank,CitiBank HongKong,67158,69483,-2325
2012-12-01,Deutsche Bank,CitiBank HongKong,69294,62353,6941
2013-01-01,Deutsche Bank,CitiBank HongKong,65155,62465,2690
2013-02-01,Deutsche Bank,CitiBank HongKong,69586,65156,4430
2013-03-01,Deutsche Bank,CitiBank HongKong,66522,68326,-1804
2013-04-01,Deutsche Bank,CitiBank HongKong,68575,61517,7058
2013-05-01,Deutsche Bank,CitiBank HongKong,79312,73847,5465
2013-06-01,Deutsche Bank,CitiBank HongKong,79911,79651,260
2013-07-01,Deutsche Bank,CitiBank HongKong,77333,75925,1408
2013-08-01,Deutsche Bank,CitiBank HongKong,76313,75432,881
2013-09-01,Deutsche Bank,CitiBank HongKong,72971,75794,-2823
2013-10-01,Deutsche Bank,CitiBank HongKong,73341,74733,-1392
2013-11-01,Deutsche Bank,CitiBank HongKong,78549,72228,6321
2013-12-01,Deutsche Bank,CitiBank HongKong,78192,74387,3805
2014-01-01,Deutsche Bank,CitiBank HongKong,71855,74144,-2289
2014-02-01,Deutsche Bank,CitiBank HongKong,79234,74811,4423
2014-03-01,Deutsche Bank,CitiBank HongKong,77115,77589,-474
2014-04-01,Deutsche Bank,CitiBank HongKong,78261,76192,2069
2014-05-01,Deutsche Bank,CitiBank HongKong,73781,78522,-4741
2014-06-01,Deutsche Bank,CitiBank HongKong,77539,71664,5875
2014-07-01,Deutsche Bank,CitiBank HongKong,79785,76731,3054
2014-08-01,Deutsche Bank,CitiBank HongKong,73661,76875,-3214
2014-09-01,Deutsche Bank,CitiBank HongKong,78221,78959,-738
2014-10-01,Deutsche Bank,CitiBank HongKong,72524,72834,-310
2014-11-01,Deutsche Bank,CitiBank HongKong,72255,72239,16
2014-12-01,Deutsche Bank,CitiBank HongKong,73849,71189,2660
2015-01-01,Deutsche Bank,CitiBank HongKong,87164,85149,2015
2015-02-01,Deutsche Bank,CitiBank HongKong,89361,81763,7598
2015-03-01,Deutsche Bank,CitiBank HongKong,89187,85155,4032
2015-04-01,Deutsche Bank,CitiBank HongKong,89845,86772,3073
2015-05-01,Deutsche Bank,CitiBank HongKong,83385,87596,-4211
2015-06-01,Deutsche Bank,CitiBank HongKong,81662,85922,-4260
2015-07-01,Deutsche Bank,CitiBank HongKong,89941,85177,4764
2015-08-01,Deutsche Bank,CitiBank HongKong,85154,81758,3396
2015-09-01,Deutsche Bank,CitiBank HongKong,87918,88233,-315
2015-10-01,Deutsche Bank,CitiBank HongKong,84442,82752,1690
2015-11-01,Deutsche Bank,CitiBank HongKong,87622,83357,4265
2015-12-01,Deutsche Bank,CitiBank HongKong,82941,85867,-2926
2016-01-01,Deutsche Bank,CitiBank HongKong,84317,82896,1421
2016-02-01,Deutsche Bank,CitiBank HongKong,89223,84559,4664
2016-03-01,Deutsche Bank,CitiBank HongKong,82993,88135,-5142
2016-04-01,Deutsche Bank,CitiBank HongKong,83978,84445,-467
2016-05-01,Deutsche Bank,CitiBank HongKong,83292,84133,-841
2016-06-01,Deutsche Bank,CitiBank HongKong,86244,89461,-3217
2016-07-01,Deutsche Bank,CitiBank HongKong,86916,83896,3020
2016-08-01,Deutsche Bank,CitiBank HongKong,89698,81814,7884
2016-09-01,Deutsche Bank,CitiBank HongKong,94453,99973,-5520
2016-10-01,Deutsche Bank,CitiBank HongKong,97342,92947,4395
2016-11-01,Deutsche Bank,CitiBank HongKong,99751,97143,2608
2016-12-01,Deutsche Bank,CitiBank HongKong,97471,95748,1723
2017-01-01,Deutsche Bank,CitiBank HongKong,98958,97288,1670
2017-02-01,Deutsche Bank,CitiBank HongKong,99244,98528,716
2017-03-01,Deutsche Bank,CitiBank HongKong,99662,98144,1518
2017-04-01,Deutsche Bank,CitiBank HongKong,96175,91196,4979
2017-05-01,Deutsche Bank,CitiBank HongKong,97538,91413,6125
2017-06-01,Deutsche Bank,CitiBank HongKong,93994,94727,-733
2017-07-01,Deutsche Bank,CitiBank HongKong,97864,94664,3200
2017-08-01,Deutsche Bank,CitiBank HongKong,95767,98257,-2490
2017-09-01,Deutsche Bank,CitiBank HongKong,96319,97931,-1612
2017-10-01,Deutsche Bank,CitiBank HongKong,92227,95371,-3144
2017-11-01,Deutsche Bank,CitiBank HongKong,98369,96356,2013
2017-12-01,Deutsche Bank,CitiBank HongKong,98928,99173,-245
2018-01-01,Deutsche Bank,CitiBank HongKong,94735,95339,-604
2018-02-01,Deutsche Bank,CitiBank HongKong,92244,97472,-5228
2018-03-01,Deutsche Bank,CitiBank HongKong,91164,99723,-8559
2018-04-01,Deutsche Bank,CitiBank HongKong,99736,96155,3581
2010-01-01,JP Morgan,CitiBank New York,53185,54498,-1313
2010-02-01,JP Morgan,CitiBank New York,59719,52468,7251
2010-03-01,JP Morgan,CitiBank New York,59413,56635,2778
2010-04-01,JP Morgan,CitiBank New York,53717,51681,2036
2010-05-01,JP Morgan,CitiBank New York,55992,51736,4256
2010-06-01,JP Morgan,CitiBank New York,55818,55318,500
2010-07-01,JP Morgan,CitiBank New York,51779,58114,-6335
2010-08-01,JP Morgan,CitiBank New York,55963,56178,-215
2010-09-01,JP Morgan,CitiBank New York,51457,55711,-4254
2010-10-01,JP Morgan,CitiBank New York,55387,52161,3226
2010-11-01,JP Morgan,CitiBank New York,54194,58819,-4625
2010-12-01,JP Morgan,CitiBank New York,53494,53154,340
2011-01-01,JP Morgan,CitiBank New York,53131,55155,-2024
2011-02-01,JP Morgan,CitiBank New York,55631,57658,-2027
2011-03-01,JP Morgan,CitiBank New York,56694,59385,-2691
2011-04-01,JP Morgan,CitiBank New York,54771,56945,-2174
2011-05-01,JP Morgan,CitiBank New York,57912,52562,5350
2011-06-01,JP Morgan,CitiBank New York,59813,58546,1267
2011-07-01,JP Morgan,CitiBank New York,56846,57545,-699
2011-08-01,JP Morgan,CitiBank New York,54915,52751,2164
2011-09-01,JP Morgan,CitiBank New York,63278,64434,-1156
2011-10-01,JP Morgan,CitiBank New York,64439,63327,1112
2011-11-01,JP Morgan,CitiBank New York,62935,69534,-6599
2011-12-01,JP Morgan,CitiBank New York,65832,69252,-3420
2012-01-01,JP Morgan,CitiBank New York,64198,64287,-89
2012-02-01,JP Morgan,CitiBank New York,63233,68772,-5539
2012-03-01,JP Morgan,CitiBank New York,65971,64395,1576
2012-04-01,JP Morgan,CitiBank New York,68986,65716,3270
2012-05-01,JP Morgan,CitiBank New York,66122,62876,3246
2012-06-01,JP Morgan,CitiBank New York,62571,62552,19
2012-07-01,JP Morgan,CitiBank New York,69522,69571,-49
2012-08-01,JP Morgan,CitiBank New York,66438,65114,1324
2012-09-01,JP Morgan,CitiBank New York,66824,63489,3335
2012-10-01,JP Morgan,CitiBank New York,63363,62984,379
2012-11-01,JP Morgan,CitiBank New York,67177,63154,4023
2012-12-01,JP Morgan,CitiBank New York,65728,66346,-618
2013-01-01,JP Morgan,CitiBank New York,62851,63925,-1074
2013-02-01,JP Morgan,CitiBank New York,65578,61467,4111
2013-03-01,JP Morgan,CitiBank New York,66334,68827,-2493
2013-04-01,JP Morgan,CitiBank New York,62327,68136,-5809
2013-05-01,JP Morgan,CitiBank New York,76563,73111,3452
2013-06-01,JP Morgan,CitiBank New York,77118,78689,-1571
2013-07-01,JP Morgan,CitiBank New York,79923,74212,5711
2013-08-01,JP Morgan,CitiBank New York,78971,78857,114
2013-09-01,JP Morgan,CitiBank New York,76358,72771,3587
2013-10-01,JP Morgan,CitiBank New York,71667,73168,-1501
2013-11-01,JP Morgan,CitiBank New York,71316,79343,-8027
2013-12-01,JP Morgan,CitiBank New York,78993,75173,3820
2014-01-01,JP Morgan,CitiBank New York,79521,78228,1293
2014-02-01,JP Morgan,CitiBank New York,72484,73931,-1447
2014-03-01,JP Morgan,CitiBank New York,77147,78745,-1598
2014-04-01,JP Morgan,CitiBank New York,74276,71293,2983
2014-05-01,JP Morgan,CitiBank New York,77367,72277,5090
2014-06-01,JP Morgan,CitiBank New York,72715,76663,-3948
2014-07-01,JP Morgan,CitiBank New York,76579,72481,4098
2014-08-01,JP Morgan,CitiBank New York,74273,74155,118
2014-09-01,JP Morgan,CitiBank New York,77981,77595,386
2014-10-01,JP Morgan,CitiBank New York,72572,71586,986
2014-11-01,JP Morgan,CitiBank New York,79731,74563,5168
2014-12-01,JP Morgan,CitiBank New York,79738,73356,6382
2015-01-01,JP Morgan,CitiBank New York,81958,84739,-2781
2015-02-01,JP Morgan,CitiBank New York,84952,88395,-3443
2015-03-01,JP Morgan,CitiBank New York,82433,82585,-152
2015-04-01,JP Morgan,CitiBank New York,85335,86781,-1446
2015-05-01,JP Morgan,CitiBank New York,84631,85644,-1013
2015-06-01,JP Morgan,CitiBank New York,84764,83257,1507
2015-07-01,JP Morgan,CitiBank New York,86497,83543,2954
2015-08-01,JP Morgan,CitiBank New York,87291,85622,1669
2015-09-01,JP Morgan,CitiBank New York,84511,86626,-2115
2015-10-01,JP Morgan,CitiBank New York,85756,83926,1830
2015-11-01,JP Morgan,CitiBank New York,88294,85242,3052
2015-12-01,JP Morgan,CitiBank New York,87217,86623,594
2016-01-01,JP Morgan,CitiBank New York,84474,82173,2301
2016-02-01,JP Morgan,CitiBank New York,88423,86524,1899
2016-03-01,JP Morgan,CitiBank New York,84118,85736,-1618
2016-04-01,JP Morgan,CitiBank New York,87315,82468,4847
2016-05-01,JP Morgan,CitiBank New York,83426,84815,-1389
2016-06-01,JP Morgan,CitiBank New York,87796,85441,2355
2016-07-01,JP Morgan,CitiBank New York,89812,81682,8130
2016-08-01,JP Morgan,CitiBank New York,83584,81973,1611
2016-09-01,JP Morgan,CitiBank New York,97675,94526,3149
2016-10-01,JP Morgan,CitiBank New York,94415,97772,-3357
2016-11-01,JP Morgan,CitiBank New York,98454,94135,4319
2016-12-01,JP Morgan,CitiBank New York,96721,98676,-1955
2017-01-01,JP Morgan,CitiBank New York,95684,93449,2235
2017-02-01,JP Morgan,CitiBank New York,94718,91425,3293
2017-03-01,JP Morgan,CitiBank New York,96862,93722,3140
2017-04-01,JP Morgan,CitiBank New York,96294,96747,-453
2017-05-01,JP Morgan,CitiBank New York,93464,98152,-4688
2017-06-01,JP Morgan,CitiBank New York,96883,99457,-2574
2017-07-01,JP Morgan,CitiBank New York,97333,99488,-2155
2017-08-01,JP Morgan,CitiBank New York,91915,96619,-4704
2017-09-01,JP Morgan,CitiBank New York,94911,91799,3112
2017-10-01,JP Morgan,CitiBank New York,98813,91663,7150
2017-11-01,JP Morgan,CitiBank New York,99398,98334,1064
2017-12-01,JP Morgan,CitiBank New York,98245,91388,6857
2018-01-01,JP Morgan,CitiBank New York,94884,99545,-4661
2018-02-01,JP Morgan,CitiBank New York,98688,94213,4475
2018-03-01,JP Morgan,CitiBank New York,93285,94843,-1558
2018-04-01,JP Morgan,CitiBank New York,92288,93672,-1384
2010-01-01,JP Morgan,CitiBank London,54893,56659,-1766
2010-02-01,JP Morgan,CitiBank London,59963,52515,7448
2010-03-01,JP Morgan,CitiBank London,52617,52885,-268
2010-04-01,JP Morgan,CitiBank London,55287,59129,-3842
2010-05-01,JP Morgan,CitiBank London,52221,54498,-2277
2010-06-01,JP Morgan,CitiBank London,57475,56679,796
2010-07-01,JP Morgan,CitiBank London,54789,55936,-1147
2010-08-01,JP Morgan,CitiBank London,52977,56651,-3674
2010-09-01,JP Morgan,CitiBank London,53581,52693,888
2010-10-01,JP Morgan,CitiBank London,57854,57236,618
2010-11-01,JP Morgan,CitiBank London,56363,52768,3595
2010-12-01,JP Morgan,CitiBank London,57288,53236,4052
2011-01-01,JP Morgan,CitiBank London,59468,55961,3507
2011-02-01,JP Morgan,CitiBank London,59827,56991,2836
2011-03-01,JP Morgan,CitiBank London,52163,59167,-7004
2011-04-01,JP Morgan,CitiBank London,53923,59353,-5430
2011-05-01,JP Morgan,CitiBank London,52881,57193,-4312
2011-06-01,JP Morgan,CitiBank London,56764,59798,-3034
2011-07-01,JP Morgan,CitiBank London,59518,51427,8091
2011-08-01,JP Morgan,CitiBank London,54518,54726,-208
2011-09-01,JP Morgan,CitiBank London,69183,64658,4525
2011-10-01,JP Morgan,CitiBank London,68147,62351,5796
2011-11-01,JP Morgan,CitiBank London,63621,65521,-1900
2011-12-01,JP Morgan,CitiBank London,61146,65165,-4019
2012-01-01,JP Morgan,CitiBank London,67928,67217,711
2012-02-01,JP Morgan,CitiBank London,64883,61738,3145
2012-03-01,JP Morgan,CitiBank London,63275,69867,-6592
2012-04-01,JP Morgan,CitiBank London,67598,61648,5950
2012-05-01,JP Morgan,CitiBank London,66643,64829,1814
2012-06-01,JP Morgan,CitiBank London,67527,64932,2595
2012-07-01,JP Morgan,CitiBank London,68746,66127,2619
2012-08-01,JP Morgan,CitiBank London,62133,68652,-6519
2012-09-01,JP Morgan,CitiBank London,65388,64879,509
2012-10-01,JP Morgan,CitiBank London,67794,69835,-2041
2012-11-01,JP Morgan,CitiBank London,69866,63855,6011
2012-12-01,JP Morgan,CitiBank London,61318,66888,-5570
2013-01-01,JP Morgan,CitiBank London,69437,65521,3916
2013-02-01,JP Morgan,CitiBank London,65694,62487,3207
2013-03-01,JP Morgan,CitiBank London,67619,66666,953
2013-04-01,JP Morgan,CitiBank London,63617,68432,-4815
2013-05-01,JP Morgan,CitiBank London,77236,78648,-1412
2013-06-01,JP Morgan,CitiBank London,78621,78491,130
2013-07-01,JP Morgan,CitiBank London,72458,75629,-3171
2013-08-01,JP Morgan,CitiBank London,74894,79849,-4955
2013-09-01,JP Morgan,CitiBank London,73775,79443,-5668
2013-10-01,JP Morgan,CitiBank London,75712,79661,-3949
2013-11-01,JP Morgan,CitiBank London,71482,78366,-6884
2013-12-01,JP Morgan,CitiBank London,76474,76598,-124
2014-01-01,JP Morgan,CitiBank London,75792,73778,2014
2014-02-01,JP Morgan,CitiBank London,75833,72129,3704
2014-03-01,JP Morgan,CitiBank London,76792,73612,3180
2014-04-01,JP Morgan,CitiBank London,78647,71117,7530
2014-05-01,JP Morgan,CitiBank London,75492,72924,2568
2014-06-01,JP Morgan,CitiBank London,79598,75182,4416
2014-07-01,JP Morgan,CitiBank London,75785,74648,1137
2014-08-01,JP Morgan,CitiBank London,75566,75965,-399
2014-09-01,JP Morgan,CitiBank London,76785,71178,5607
2014-10-01,JP Morgan,CitiBank London,77872,77474,398
2014-11-01,JP Morgan,CitiBank London,76689,77251,-562
2014-12-01,JP Morgan,CitiBank London,75763,72655,3108
2015-01-01,JP Morgan,CitiBank London,81389,85139,-3750
2015-02-01,JP Morgan,CitiBank London,88979,89375,-396
2015-03-01,JP Morgan,CitiBank London,88743,82493,6250
2015-04-01,JP Morgan,CitiBank London,87511,89554,-2043
2015-05-01,JP Morgan,CitiBank London,89497,88237,1260
2015-06-01,JP Morgan,CitiBank London,88381,86477,1904
2015-07-01,JP Morgan,CitiBank London,81119,83718,-2599
2015-08-01,JP Morgan,CitiBank London,88392,84779,3613
2015-09-01,JP Morgan,CitiBank London,85983,86824,-841
2015-10-01,JP Morgan,CitiBank London,83241,85845,-2604
2015-11-01,JP Morgan,CitiBank London,84661,86355,-1694
2015-12-01,JP Morgan,CitiBank London,88329,84941,3388
2016-01-01,JP Morgan,CitiBank London,84663,88528,-3865
2016-02-01,JP Morgan,CitiBank London,87681,83499,4182
2016-03-01,JP Morgan,CitiBank London,85459,88588,-3129
2016-04-01,JP Morgan,CitiBank London,89598,83698,5900
2016-05-01,JP Morgan,CitiBank London,86569,84242,2327
2016-06-01,JP Morgan,CitiBank London,85826,82251,3575
2016-07-01,JP Morgan,CitiBank London,84172,88266,-4094
2016-08-01,JP Morgan,CitiBank London,85499,88786,-3287
2016-09-01,JP Morgan,CitiBank London,97497,94679,2818
2016-10-01,JP Morgan,CitiBank London,97411,98475,-1064
2016-11-01,JP Morgan,CitiBank London,95486,92143,3343
2016-12-01,JP Morgan,CitiBank London,92569,95774,-3205
2017-01-01,JP Morgan,CitiBank London,99751,91692,8059
2017-02-01,JP Morgan,CitiBank London,97485,92884,4601
2017-03-01,JP Morgan,CitiBank London,92363,94442,-2079
2017-04-01,JP Morgan,CitiBank London,93221,98421,-5200
2017-05-01,JP Morgan,CitiBank London,91813,92128,-315
2017-06-01,JP Morgan,CitiBank London,98992,92673,6319
2017-07-01,JP Morgan,CitiBank London,98615,93194,5421
2017-08-01,JP Morgan,CitiBank London,96164,92173,3991
2017-09-01,JP Morgan,CitiBank London,91292,95264,-3972
2017-10-01,JP Morgan,CitiBank London,91949,91791,158
2017-11-01,JP Morgan,CitiBank London,93857,97394,-3537
2017-12-01,JP Morgan,CitiBank London,96297,99196,-2899
2018-01-01,JP Morgan,CitiBank London,95515,98479,-2964
2018-02-01,JP Morgan,CitiBank London,95715,97459,-1744
2018-03-01,JP Morgan,CitiBank London,95955,96267,-312
2018-04-01,JP Morgan,CitiBank London,98822,94486,4336
2010-01-01,JP Morgan,CitiBank Pune,52368,59235,-6867
2010-02-01,JP Morgan,CitiBank Pune,56319,53449,2870
2010-03-01,JP Morgan,CitiBank Pune,53674,56772,-3098
2010-04-01,JP Morgan,CitiBank Pune,59996,58125,1871
2010-05-01,JP Morgan,CitiBank Pune,57787,56614,1173
2010-06-01,JP Morgan,CitiBank Pune,57925,57754,171
2010-07-01,JP Morgan,CitiBank Pune,56792,51636,5156
2010-08-01,JP Morgan,CitiBank Pune,56625,54459,2166
2010-09-01,JP Morgan,CitiBank Pune,51876,53283,-1407
2010-10-01,JP Morgan,CitiBank Pune,58428,54593,3835
2010-11-01,JP Morgan,CitiBank Pune,51589,55562,-3973
2010-12-01,JP Morgan,CitiBank Pune,58111,55774,2337
2011-01-01,JP Morgan,CitiBank Pune,54815,55313,-498
2011-02-01,JP Morgan,CitiBank Pune,55245,59449,-4204
2011-03-01,JP Morgan,CitiBank Pune,59143,58793,350
2011-04-01,JP Morgan,CitiBank Pune,57544,52438,5106
2011-05-01,JP Morgan,CitiBank Pune,52249,56912,-4663
2011-06-01,JP Morgan,CitiBank Pune,55158,57419,-2261
2011-07-01,JP Morgan,CitiBank Pune,58761,59997,-1236
2011-08-01,JP Morgan,CitiBank Pune,56194,57337,-1143
2011-09-01,JP Morgan,CitiBank Pune,64679,62213,2466
2011-10-01,JP Morgan,CitiBank Pune,68325,69464,-1139
2011-11-01,JP Morgan,CitiBank Pune,64185,67957,-3772
2011-12-01,JP Morgan,CitiBank Pune,64512,65585,-1073
2012-01-01,JP Morgan,CitiBank Pune,69131,69176,-45
2012-02-01,JP Morgan,CitiBank Pune,62888,64821,-1933
2012-03-01,JP Morgan,CitiBank Pune,67669,61825,5844
2012-04-01,JP Morgan,CitiBank Pune,63812,61779,2033
2012-05-01,JP Morgan,CitiBank Pune,69213,65698,3515
2012-06-01,JP Morgan,CitiBank Pune,68344,63537,4807
2012-07-01,JP Morgan,CitiBank Pune,63715,61299,2416
2012-08-01,JP Morgan,CitiBank Pune,69266,65567,3699
2012-09-01,JP Morgan,CitiBank Pune,61558,66993,-5435
2012-10-01,JP Morgan,CitiBank Pune,63249,64625,-1376
2012-11-01,JP Morgan,CitiBank Pune,62768,68142,-5374
2012-12-01,JP Morgan,CitiBank Pune,63332,66336,-3004
2013-01-01,JP Morgan,CitiBank Pune,64831,61972,2859
2013-02-01,JP Morgan,CitiBank Pune,66441,66458,-17
2013-03-01,JP Morgan,CitiBank Pune,65455,69781,-4326
2013-04-01,JP Morgan,CitiBank Pune,62376,66831,-4455
2013-05-01,JP Morgan,CitiBank Pune,75996,71779,4217
2013-06-01,JP Morgan,CitiBank Pune,73279,77373,-4094
2013-07-01,JP Morgan,CitiBank Pune,72481,75913,-3432
2013-08-01,JP Morgan,CitiBank Pune,79238,71667,7571
2013-09-01,JP Morgan,CitiBank Pune,75421,77113,-1692
2013-10-01,JP Morgan,CitiBank Pune,73382,78134,-4752
2013-11-01,JP Morgan,CitiBank Pune,71557,71382,175
2013-12-01,JP Morgan,CitiBank Pune,74688,76247,-1559
2014-01-01,JP Morgan,CitiBank Pune,74444,73698,746
2014-02-01,JP Morgan,CitiBank Pune,78258,72724,5534
2014-03-01,JP Morgan,CitiBank Pune,76811,79437,-2626
2014-04-01,JP Morgan,CitiBank Pune,75432,71558,3874
2014-05-01,JP Morgan,CitiBank Pune,79641,75622,4019
2014-06-01,JP Morgan,CitiBank Pune,79478,77826,1652
2014-07-01,JP Morgan,CitiBank Pune,71326,72337,-1011
2014-08-01,JP Morgan,CitiBank Pune,73346,71561,1785
2014-09-01,JP Morgan,CitiBank Pune,72485,72763,-278
2014-10-01,JP Morgan,CitiBank Pune,73395,73268,127
2014-11-01,JP Morgan,CitiBank Pune,73635,71417,2218
2014-12-01,JP Morgan,CitiBank Pune,72191,79331,-7140
2015-01-01,JP Morgan,CitiBank Pune,86857,89463,-2606
2015-02-01,JP Morgan,CitiBank Pune,84256,85249,-993
2015-03-01,JP Morgan,CitiBank Pune,87542,88632,-1090
2015-04-01,JP Morgan,CitiBank Pune,83132,82878,254
2015-05-01,JP Morgan,CitiBank Pune,84947,89283,-4336
2015-06-01,JP Morgan,CitiBank Pune,81391,86485,-5094
2015-07-01,JP Morgan,CitiBank Pune,88969,85657,3312
2015-08-01,JP Morgan,CitiBank Pune,81833,81494,339
2015-09-01,JP Morgan,CitiBank Pune,88163,87187,976
2015-10-01,JP Morgan,CitiBank Pune,86528,87342,-814
2015-11-01,JP Morgan,CitiBank Pune,81489,82142,-653
2015-12-01,JP Morgan,CitiBank Pune,86355,85167,1188
2016-01-01,JP Morgan,CitiBank Pune,84733,81859,2874
2016-02-01,JP Morgan,CitiBank Pune,81452,83695,-2243
2016-03-01,JP Morgan,CitiBank Pune,89477,81993,7484
2016-04-01,JP Morgan,CitiBank Pune,85491,87186,-1695
2016-05-01,JP Morgan,CitiBank Pune,85124,87228,-2104
2016-06-01,JP Morgan,CitiBank Pune,81929,87273,-5344
2016-07-01,JP Morgan,CitiBank Pune,84513,82112,2401
2016-08-01,JP Morgan,CitiBank Pune,86894,89462,-2568
2016-09-01,JP Morgan,CitiBank Pune,98271,99556,-1285
2016-10-01,JP Morgan,CitiBank Pune,97371,92657,4714
2016-11-01,JP Morgan,CitiBank Pune,92672,94413,-1741
2016-12-01,JP Morgan,CitiBank Pune,96835,98938,-2103
2017-01-01,JP Morgan,CitiBank Pune,96498,94842,1656
2017-02-01,JP Morgan,CitiBank Pune,99286,96616,2670
2017-03-01,JP Morgan,CitiBank Pune,91466,92922,-1456
2017-04-01,JP Morgan,CitiBank Pune,93371,98341,-4970
2017-05-01,JP Morgan,CitiBank Pune,98495,95531,2964
2017-06-01,JP Morgan,CitiBank Pune,91524,98865,-7341
2017-07-01,JP Morgan,CitiBank Pune,97822,99637,-1815
2017-08-01,JP Morgan,CitiBank Pune,93848,94338,-490
2017-09-01,JP Morgan,CitiBank Pune,97638,98825,-1187
2017-10-01,JP Morgan,CitiBank Pune,91198,98384,-7186
2017-11-01,JP Morgan,CitiBank Pune,99463,98662,801
2017-12-01,JP Morgan,CitiBank Pune,93276,98183,-4907
2018-01-01,JP Morgan,CitiBank Pune,94994,95415,-421
2018-02-01,JP Morgan,CitiBank Pune,99595,98647,948
2018-03-01,JP Morgan,CitiBank Pune,99365,92218,7147
2018-04-01,JP Morgan,CitiBank Pune,93973,99239,-5266
2010-01-01,JP Morgan,CitiBank Singapore,51256,53412,-2156
2010-02-01,JP Morgan,CitiBank Singapore,58737,51857,6880
2010-03-01,JP Morgan,CitiBank Singapore,59761,58155,1606
2010-04-01,JP Morgan,CitiBank Singapore,54266,59199,-4933
2010-05-01,JP Morgan,CitiBank Singapore,55664,51127,4537
2010-06-01,JP Morgan,CitiBank Singapore,58988,59395,-407
2010-07-01,JP Morgan,CitiBank Singapore,51394,57374,-5980
2010-08-01,JP Morgan,CitiBank Singapore,52162,57484,-5322
2010-09-01,JP Morgan,CitiBank Singapore,59992,54639,5353
2010-10-01,JP Morgan,CitiBank Singapore,59345,54852,4493
2010-11-01,JP Morgan,CitiBank Singapore,51612,52144,-532
2010-12-01,JP Morgan,CitiBank Singapore,55287,57897,-2610
2011-01-01,JP Morgan,CitiBank Singapore,56488,58272,-1784
2011-02-01,JP Morgan,CitiBank Singapore,52411,58531,-6120
2011-03-01,JP Morgan,CitiBank Singapore,59429,56313,3116
2011-04-01,JP Morgan,CitiBank Singapore,55277,51243,4034
2011-05-01,JP Morgan,CitiBank Singapore,52854,56344,-3490
2011-06-01,JP Morgan,CitiBank Singapore,55446,59893,-4447
2011-07-01,JP Morgan,CitiBank Singapore,55616,54848,768
2011-08-01,JP Morgan,CitiBank Singapore,57581,52675,4906
2011-09-01,JP Morgan,CitiBank Singapore,63762,63256,506
2011-10-01,JP Morgan,CitiBank Singapore,69995,64199,5796
2011-11-01,JP Morgan,CitiBank Singapore,67455,63133,4322
2011-12-01,JP Morgan,CitiBank Singapore,65595,66458,-863
2012-01-01,JP Morgan,CitiBank Singapore,64218,69635,-5417
2012-02-01,JP Morgan,CitiBank Singapore,67817,63742,4075
2012-03-01,JP Morgan,CitiBank Singapore,67447,69926,-2479
2012-04-01,JP Morgan,CitiBank Singapore,69551,61897,7654
2012-05-01,JP Morgan,CitiBank Singapore,61937,68325,-6388
2012-06-01,JP Morgan,CitiBank Singapore,69899,68441,1458
2012-07-01,JP Morgan,CitiBank Singapore,65326,69263,-3937
2012-08-01,JP Morgan,CitiBank Singapore,64733,67694,-2961
2012-09-01,JP Morgan,CitiBank Singapore,64448,66272,-1824
2012-10-01,JP Morgan,CitiBank Singapore,67791,62367,5424
2012-11-01,JP Morgan,CitiBank Singapore,61586,62159,-573
2012-12-01,JP Morgan,CitiBank Singapore,65618,62627,2991
2013-01-01,JP Morgan,CitiBank Singapore,67853,69678,-1825
2013-02-01,JP Morgan,CitiBank Singapore,63774,67373,-3599
2013-03-01,JP Morgan,CitiBank Singapore,68736,63738,4998
2013-04-01,JP Morgan,CitiBank Singapore,67196,63126,4070
2013-05-01,JP Morgan,CitiBank Singapore,73394,73413,-19
2013-06-01,JP Morgan,CitiBank Singapore,77298,73567,3731
2013-07-01,JP Morgan,CitiBank Singapore,76621,73493,3128
2013-08-01,JP Morgan,CitiBank Singapore,71881,78253,-6372
2013-09-01,JP Morgan,CitiBank Singapore,74552,77742,-3190
2013-10-01,JP Morgan,CitiBank Singapore,79536,73168,6368
2013-11-01,JP Morgan,CitiBank Singapore,72922,75111,-2189
2013-12-01,JP Morgan,CitiBank Singapore,71929,72797,-868
2014-01-01,JP Morgan,CitiBank Singapore,71885,76827,-4942
2014-02-01,JP Morgan,CitiBank Singapore,72914,71333,1581
2014-03-01,JP Morgan,CitiBank Singapore,74945,75415,-470
2014-04-01,JP Morgan,CitiBank Singapore,78517,77968,549
2014-05-01,JP Morgan,CitiBank Singapore,77679,79111,-1432
2014-06-01,JP Morgan,CitiBank Singapore,73516,76528,-3012
2014-07-01,JP Morgan,CitiBank Singapore,75988,74242,1746
2014-08-01,JP Morgan,CitiBank Singapore,76614,74242,2372
2014-09-01,JP Morgan,CitiBank Singapore,72537,75144,-2607
2014-10-01,JP Morgan,CitiBank Singapore,78211,77622,589
2014-11-01,JP Morgan,CitiBank Singapore,75787,73454,2333
2014-12-01,JP Morgan,CitiBank Singapore,77934,76929,1005
2015-01-01,JP Morgan,CitiBank Singapore,89668,81656,8012
2015-02-01,JP Morgan,CitiBank Singapore,84269,82621,1648
2015-03-01,JP Morgan,CitiBank Singapore,82285,84818,-2533
2015-04-01,JP Morgan,CitiBank Singapore,85441,84938,503
2015-05-01,JP Morgan,CitiBank Singapore,84633,81193,3440
2015-06-01,JP Morgan,CitiBank Singapore,85778,86749,-971
2015-07-01,JP Morgan,CitiBank Singapore,89546,83256,6290
2015-08-01,JP Morgan,CitiBank Singapore,89589,82843,6746
2015-09-01,JP Morgan,CitiBank Singapore,85394,83227,2167
2015-10-01,JP Morgan,CitiBank Singapore,88695,89859,-1164
2015-11-01,JP Morgan,CitiBank Singapore,82149,81359,790
2015-12-01,JP Morgan,CitiBank Singapore,89483,84579,4904
2016-01-01,JP Morgan,CitiBank Singapore,86312,81875,4437
2016-02-01,JP Morgan,CitiBank Singapore,84563,87396,-2833
2016-03-01,JP Morgan,CitiBank Singapore,88968,82794,6174
2016-04-01,JP Morgan,CitiBank Singapore,81395,88234,-6839
2016-05-01,JP Morgan,CitiBank Singapore,88273,89711,-1438
2016-06-01,JP Morgan,CitiBank Singapore,85232,86926,-1694
2016-07-01,JP Morgan,CitiBank Singapore,87973,89825,-1852
2016-08-01,JP Morgan,CitiBank Singapore,83738,89651,-5913
2016-09-01,JP Morgan,CitiBank Singapore,92287,96119,-3832
2016-10-01,JP Morgan,CitiBank Singapore,97349,98654,-1305
2016-11-01,JP Morgan,CitiBank Singapore,97833,97441,392
2016-12-01,JP Morgan,CitiBank Singapore,92862,91159,1703
2017-01-01,JP Morgan,CitiBank Singapore,92848,93679,-831
2017-02-01,JP Morgan,CitiBank Singapore,91357,96142,-4785
2017-03-01,JP Morgan,CitiBank Singapore,95783,91665,4118
2017-04-01,JP Morgan,CitiBank Singapore,96558,98413,-1855
2017-05-01,JP Morgan,CitiBank Singapore,98427,93328,5099
2017-06-01,JP Morgan,CitiBank Singapore,97282,97524,-242
2017-07-01,JP Morgan,CitiBank Singapore,94332,95871,-1539
2017-08-01,JP Morgan,CitiBank Singapore,99125,91982,7143
2017-09-01,JP Morgan,CitiBank Singapore,94414,97853,-3439
2017-10-01,JP Morgan,CitiBank Singapore,96229,99239,-3010
2017-11-01,JP Morgan,CitiBank Singapore,95479,91621,3858
2017-12-01,JP Morgan,CitiBank Singapore,99962,97961,2001
2018-01-01,JP Morgan,CitiBank Singapore,96714,91896,4818
2018-02-01,JP Morgan,CitiBank Singapore,94385,91238,3147
2018-03-01,JP Morgan,CitiBank Singapore,96682,92995,3687
2018-04-01,JP Morgan,CitiBank Singapore,98352,92518,5834
2010-01-01,JP Morgan,CitiBank HongKong,52951,57243,-4292
2010-02-01,JP Morgan,CitiBank HongKong,52691,53617,-926
2010-03-01,JP Morgan,CitiBank HongKong,51475,57247,-5772
2010-04-01,JP Morgan,CitiBank HongKong,51386,58864,-7478
2010-05-01,JP Morgan,CitiBank HongKong,52751,55181,-2430
2010-06-01,JP Morgan,CitiBank HongKong,52452,53836,-1384
2010-07-01,JP Morgan,CitiBank HongKong,54473,58334,-3861
2010-08-01,JP Morgan,CitiBank HongKong,59911,53647,6264
2010-09-01,JP Morgan,CitiBank HongKong,51355,56983,-5628
2010-10-01,JP Morgan,CitiBank HongKong,51576,56128,-4552
2010-11-01,JP Morgan,CitiBank HongKong,57942,53774,4168
2010-12-01,JP Morgan,CitiBank HongKong,52226,53289,-1063
2011-01-01,JP Morgan,CitiBank HongKong,51745,55183,-3438
2011-02-01,JP Morgan,CitiBank HongKong,58831,53764,5067
2011-03-01,JP Morgan,CitiBank HongKong,59242,52634,6608
2011-04-01,JP Morgan,CitiBank HongKong,59152,55537,3615
2011-05-01,JP Morgan,CitiBank HongKong,51553,55635,-4082
2011-06-01,JP Morgan,CitiBank HongKong,56231,58817,-2586
2011-07-01,JP Morgan,CitiBank HongKong,56958,58424,-1466
2011-08-01,JP Morgan,CitiBank HongKong,54923,51278,3645
2011-09-01,JP Morgan,CitiBank HongKong,68524,64215,4309
2011-10-01,JP Morgan,CitiBank HongKong,61862,65945,-4083
2011-11-01,JP Morgan,CitiBank HongKong,65412,65918,-506
2011-12-01,JP Morgan,CitiBank HongKong,67252,67693,-441
2012-01-01,JP Morgan,CitiBank HongKong,66732,68495,-1763
2012-02-01,JP Morgan,CitiBank HongKong,63288,64995,-1707
2012-03-01,JP Morgan,CitiBank HongKong,65618,64559,1059
2012-04-01,JP Morgan,CitiBank HongKong,64563,66953,-2390
2012-05-01,JP Morgan,CitiBank HongKong,62217,69256,-7039
2012-06-01,JP Morgan,CitiBank HongKong,67124,63997,3127
2012-07-01,JP Morgan,CitiBank HongKong,62357,62997,-640
2012-08-01,JP Morgan,CitiBank HongKong,67384,66681,703
2012-09-01,JP Morgan,CitiBank HongKong,64686,61943,2743
2012-10-01,JP Morgan,CitiBank HongKong,67558,63283,4275
2012-11-01,JP Morgan,CitiBank HongKong,65295,62836,2459
2012-12-01,JP Morgan,CitiBank HongKong,64663,61587,3076
2013-01-01,JP Morgan,CitiBank HongKong,66385,61697,4688
2013-02-01,JP Morgan,CitiBank HongKong,62614,67221,-4607
2013-03-01,JP Morgan,CitiBank HongKong,61529,67574,-6045
2013-04-01,JP Morgan,CitiBank HongKong,63971,62293,1678
2013-05-01,JP Morgan,CitiBank HongKong,71673,76495,-4822
2013-06-01,JP Morgan,CitiBank HongKong,78311,73969,4342
2013-07-01,JP Morgan,CitiBank HongKong,76147,75517,630
2013-08-01,JP Morgan,CitiBank HongKong,76682,74365,2317
2013-09-01,JP Morgan,CitiBank HongKong,73785,79159,-5374
2013-10-01,JP Morgan,CitiBank HongKong,75161,73379,1782
2013-11-01,JP Morgan,CitiBank HongKong,78966,76923,2043
2013-12-01,JP Morgan,CitiBank HongKong,79455,74519,4936
2014-01-01,JP Morgan,CitiBank HongKong,75229,76473,-1244
2014-02-01,JP Morgan,CitiBank HongKong,78193,71571,6622
2014-03-01,JP Morgan,CitiBank HongKong,77229,78161,-932
2014-04-01,JP Morgan,CitiBank HongKong,71119,72897,-1778
2014-05-01,JP Morgan,CitiBank HongKong,74157,74459,-302
2014-06-01,JP Morgan,CitiBank HongKong,77161,79173,-2012
2014-07-01,JP Morgan,CitiBank HongKong,77437,77946,-509
2014-08-01,JP Morgan,CitiBank HongKong,76646,79591,-2945
2014-09-01,JP Morgan,CitiBank HongKong,73625,76298,-2673
2014-10-01,JP Morgan,CitiBank HongKong,74287,71417,2870
2014-11-01,JP Morgan,CitiBank HongKong,75117,72315,2802
2014-12-01,JP Morgan,CitiBank HongKong,71618,76419,-4801
2015-01-01,JP Morgan,CitiBank HongKong,85992,82633,3359
2015-02-01,JP Morgan,CitiBank HongKong,85734,86136,-402
2015-03-01,JP Morgan,CitiBank HongKong,88994,84626,4368
2015-04-01,JP Morgan,CitiBank HongKong,82914,88542,-5628
2015-05-01,JP Morgan,CitiBank HongKong,85852,89423,-3571
2015-06-01,JP Morgan,CitiBank HongKong,86992,85615,1377
2015-07-01,JP Morgan,CitiBank HongKong,87384,83874,3510
2015-08-01,JP Morgan,CitiBank HongKong,86176,85284,892
2015-09-01,JP Morgan,CitiBank HongKong,83475,88343,-4868
2015-10-01,JP Morgan,CitiBank HongKong,81636,89721,-8085
2015-11-01,JP Morgan,CitiBank HongKong,83119,89551,-6432
2015-12-01,JP Morgan,CitiBank HongKong,82841,89634,-6793
2016-01-01,JP Morgan,CitiBank HongKong,87643,82913,4730
2016-02-01,JP Morgan,CitiBank HongKong,89975,83981,5994
2016-03-01,JP Morgan,CitiBank HongKong,88493,88517,-24
2016-04-01,JP Morgan,CitiBank HongKong,84612,82397,2215
2016-05-01,JP Morgan,CitiBank HongKong,83288,81361,1927
2016-06-01,JP Morgan,CitiBank HongKong,88888,84539,4349
2016-07-01,JP Morgan,CitiBank HongKong,84255,86769,-2514
2016-08-01,JP Morgan,CitiBank HongKong,83474,84923,-1449
2016-09-01,JP Morgan,CitiBank HongKong,99928,95685,4243
2016-10-01,JP Morgan,CitiBank HongKong,97575,99563,-1988
2016-11-01,JP Morgan,CitiBank HongKong,95238,96763,-1525
2016-12-01,JP Morgan,CitiBank HongKong,99651,91968,7683
2017-01-01,JP Morgan,CitiBank HongKong,92968,98542,-5574
2017-02-01,JP Morgan,CitiBank HongKong,99492,92145,7347
2017-03-01,JP Morgan,CitiBank HongKong,98292,99276,-984
2017-04-01,JP Morgan,CitiBank HongKong,95181,96863,-1682
2017-05-01,JP Morgan,CitiBank HongKong,98131,96661,1470
2017-06-01,JP Morgan,CitiBank HongKong,94946,99314,-4368
2017-07-01,JP Morgan,CitiBank HongKong,98818,92284,6534
2017-08-01,JP Morgan,CitiBank HongKong,94133,96748,-2615
2017-09-01,JP Morgan,CitiBank HongKong,95744,95982,-238
2017-10-01,JP Morgan,CitiBank HongKong,98296,98149,147
2017-11-01,JP Morgan,CitiBank HongKong,96246,98184,-1938
2017-12-01,JP Morgan,CitiBank HongKong,96793,93655,3138
2018-01-01,JP Morgan,CitiBank HongKong,92558,94241,-1683
2018-02-01,JP Morgan,CitiBank HongKong,91214,94691,-3477
2018-03-01,JP Morgan,CitiBank HongKong,96171,99577,-3406
2018-04-01,JP Morgan,CitiBank HongKong,91453,97756,-6303
2010-01-01,Bank of America,CitiBank New York,56924,53732,3192
2010-02-01,Bank of America,CitiBank New York,55963,55549,414
2010-03-01,Bank of America,CitiBank New York,55566,55922,-356
2010-04-01,Bank of America,CitiBank New York,53339,59251,-5912
2010-05-01,Bank of America,CitiBank New York,59269,54914,4355
2010-06-01,Bank of America,CitiBank New York,57214,58754,-1540
2010-07-01,Bank of America,CitiBank New York,54874,51649,3225
2010-08-01,Bank of America,CitiBank New York,55998,59835,-3837
2010-09-01,Bank of America,CitiBank New York,57613,52357,5256
2010-10-01,Bank of America,CitiBank New York,57833,59999,-2166
2010-11-01,Bank of America,CitiBank New York,56688,53582,3106
2010-12-01,Bank of America,CitiBank New York,54784,59687,-4903
2011-01-01,Bank of America,CitiBank New York,52917,57131,-4214
2011-02-01,Bank of America,CitiBank New York,55972,54115,1857
2011-03-01,Bank of America,CitiBank New York,52752,59794,-7042
2011-04-01,Bank of America,CitiBank New York,54583,54836,-253
2011-05-01,Bank of America,CitiBank New York,55451,51685,3766
2011-06-01,Bank of America,CitiBank New York,57454,57496,-42
2011-07-01,Bank of America,CitiBank New York,56429,53476,2953
2011-08-01,Bank of America,CitiBank New York,56246,53999,2247
2011-09-01,Bank of America,CitiBank New York,62161,62188,-27
2011-10-01,Bank of America,CitiBank New York,66867,64947,1920
2011-11-01,Bank of America,CitiBank New York,64985,62572,2413
2011-12-01,Bank of America,CitiBank New York,69576,64245,5331
2012-01-01,Bank of America,CitiBank New York,62724,68514,-5790
2012-02-01,Bank of America,CitiBank New York,63173,67156,-3983
2012-03-01,Bank of America,CitiBank New York,66121,66184,-63
2012-04-01,Bank of America,CitiBank New York,68867,66768,2099
2012-05-01,Bank of America,CitiBank New York,68661,64384,4277
2012-06-01,Bank of America,CitiBank New York,61732,65493,-3761
2012-07-01,Bank of America,CitiBank New York,69253,64353,4900
2012-08-01,Bank of America,CitiBank New York,67388,62716,4672
2012-09-01,Bank of America,CitiBank New York,69798,61395,8403
2012-10-01,Bank of America,CitiBank New York,64658,66857,-2199
2012-11-01,Bank of America,CitiBank New York,63336,66156,-2820
2012-12-01,Bank of America,CitiBank New York,65478,64671,807
2013-01-01,Bank of America,CitiBank New York,65869,67285,-1416
2013-02-01,Bank of America,CitiBank New York,69718,68614,1104
2013-03-01,Bank of America,CitiBank New York,65941,67918,-1977
2013-04-01,Bank of America,CitiBank New York,61895,67394,-5499
2013-05-01,Bank of America,CitiBank New York,78586,71714,6872
2013-06-01,Bank of America,CitiBank New York,78289,71769,6520
2013-07-01,Bank of America,CitiBank New York,74375,78795,-4420
2013-08-01,Bank of America,CitiBank New York,74825,77825,-3000
2013-09-01,Bank of America,CitiBank New York,79938,71329,8609
2013-10-01,Bank of America,CitiBank New York,77135,78382,-1247
2013-11-01,Bank of America,CitiBank New York,73181,74849,-1668
2013-12-01,Bank of America,CitiBank New York,77824,75141,2683
2014-01-01,Bank of America,CitiBank New York,77168,72638,4530
2014-02-01,Bank of America,CitiBank New York,75596,79479,-3883
2014-03-01,Bank of America,CitiBank New York,73991,78654,-4663
2014-04-01,Bank of America,CitiBank New York,77495,74978,2517
2014-05-01,Bank of America,CitiBank New York,73218,77245,-4027
2014-06-01,Bank of America,CitiBank New York,77247,71355,5892
2014-07-01,Bank of America,CitiBank New York,73988,76326,-2338
2014-08-01,Bank of America,CitiBank New York,73564,75871,-2307
2014-09-01,Bank of America,CitiBank New York,77523,73875,3648
2014-10-01,Bank of America,CitiBank New York,71816,72224,-408
2014-11-01,Bank of America,CitiBank New York,74823,79911,-5088
2014-12-01,Bank of America,CitiBank New York,74719,78649,-3930
2015-01-01,Bank of America,CitiBank New York,89367,89249,118
2015-02-01,Bank of America,CitiBank New York,89235,81847,7388
2015-03-01,Bank of America,CitiBank New York,87368,85476,1892
2015-04-01,Bank of America,CitiBank New York,84265,86531,-2266
2015-05-01,Bank of America,CitiBank New York,83342,88986,-5644
2015-06-01,Bank of America,CitiBank New York,83861,83681,180
2015-07-01,Bank of America,CitiBank New York,87252,82941,4311
2015-08-01,Bank of America,CitiBank New York,86339,83185,3154
2015-09-01,Bank of America,CitiBank New York,85287,87267,-1980
2015-10-01,Bank of America,CitiBank New York,87619,88389,-770
2015-11-01,Bank of America,CitiBank New York,81128,82748,-1620
2015-12-01,Bank of America,CitiBank New York,84711,86283,-1572
2016-01-01,Bank of America,CitiBank New York,89629,89636,-7
2016-02-01,Bank of America,CitiBank New York,83116,84483,-1367
2016-03-01,Bank of America,CitiBank New York,87648,81914,5734
2016-04-01,Bank of America,CitiBank New York,83449,83646,-197
2016-05-01,Bank of America,CitiBank New York,82995,82411,584
2016-06-01,Bank of America,CitiBank New York,81712,82433,-721
2016-07-01,Bank of America,CitiBank New York,86491,85962,529
2016-08-01,Bank of America,CitiBank New York,87995,81547,6448
2016-09-01,Bank of America,CitiBank New York,93934,92763,1171
2016-10-01,Bank of America,CitiBank New York,91725,94837,-3112
2016-11-01,Bank of America,CitiBank New York,96922,93237,3685
2016-12-01,Bank of America,CitiBank New York,92775,92651,124
2017-01-01,Bank of America,CitiBank New York,94776,92736,2040
2017-02-01,Bank of America,CitiBank New York,98599,93891,4708
2017-03-01,Bank of America,CitiBank New York,97669,96763,906
2017-04-01,Bank of America,CitiBank New York,93325,96616,-3291
2017-05-01,Bank of America,CitiBank New York,95229,98313,-3084
2017-06-01,Bank of America,CitiBank New York,99974,98587,1387
2017-07-01,Bank of America,CitiBank New York,97545,91424,6121
2017-08-01,Bank of America,CitiBank New York,96853,91227,5626
2017-09-01,Bank of America,CitiBank New York,97579,97856,-277
2017-10-01,Bank of America,CitiBank New York,98139,96995,1144
2017-11-01,Bank of America,CitiBank New York,93662,95115,-1453
2017-12-01,Bank of America,CitiBank New York,96513,92598,3915
2018-01-01,Bank of America,CitiBank New York,94638,92462,2176
2018-02-01,Bank of America,CitiBank New York,97713,91994,5719
2018-03-01,Bank of America,CitiBank New York,99615,93184,6431
2018-04-01,Bank of America,CitiBank New York,92752,94257,-1505
2010-01-01,Bank of America,CitiBank London,58843,56139,2704
2010-02-01,Bank of America,CitiBank London,51288,59887,-8599
2010-03-01,Bank of America,CitiBank London,55561,57885,-2324
2010-04-01,Bank of America,CitiBank London,52515,55666,-3151
2010-05-01,Bank of America,CitiBank London,52174,56145,-3971
2010-06-01,Bank of America,CitiBank London,55826,52958,2868
2010-07-01,Bank of America,CitiBank London,54192,54926,-734
2010-08-01,Bank of America,CitiBank London,51418,54374,-2956
2010-09-01,Bank of America,CitiBank London,55118,56425,-1307
2010-10-01,Bank of America,CitiBank London,57258,53493,3765
2010-11-01,Bank of America,CitiBank London,55973,53178,2795
2010-12-01,Bank of America,CitiBank London,54964,55425,-461
2011-01-01,Bank of America,CitiBank London,59518,56116,3402
2011-02-01,Bank of America,CitiBank London,57686,51153,6533
2011-03-01,Bank of America,CitiBank London,57157,52622,4535
2011-04-01,Bank of America,CitiBank London,51851,52985,-1134
2011-05-01,Bank of America,CitiBank London,57541,54937,2604
2011-06-01,Bank of America,CitiBank London,59951,51351,8600
2011-07-01,Bank of America,CitiBank London,54487,57173,-2686
2011-08-01,Bank of America,CitiBank London,55667,53757,1910
2011-09-01,Bank of America,CitiBank London,68633,63279,5354
2011-10-01,Bank of America,CitiBank London,61145,69542,-8397
2011-11-01,Bank of America,CitiBank London,68248,61773,6475
2011-12-01,Bank of America,CitiBank London,65426,69685,-4259
2012-01-01,Bank of America,CitiBank London,61541,66967,-5426
2012-02-01,Bank of America,CitiBank London,62785,63561,-776
2012-03-01,Bank of America,CitiBank London,64933,64155,778
2012-04-01,Bank of America,CitiBank London,66182,68787,-2605
2012-05-01,Bank of America,CitiBank London,63259,69534,-6275
2012-06-01,Bank of America,CitiBank London,67317,69751,-2434
2012-07-01,Bank of America,CitiBank London,68333,64428,3905
2012-08-01,Bank of America,CitiBank London,64674,67472,-2798
2012-09-01,Bank of America,CitiBank London,66361,63365,2996
2012-10-01,Bank of America,CitiBank London,65481,63297,2184
2012-11-01,Bank of America,CitiBank London,64949,62245,2704
2012-12-01,Bank of America,CitiBank London,61992,69833,-7841
2013-01-01,Bank of America,CitiBank London,69591,67936,1655
2013-02-01,Bank of America,CitiBank London,64221,67159,-2938
2013-03-01,Bank of America,CitiBank London,68497,65452,3045
2013-04-01,Bank of America,CitiBank London,68119,67255,864
2013-05-01,Bank of America,CitiBank London,75669,77885,-2216
2013-06-01,Bank of America,CitiBank London,76966,73179,3787
2013-07-01,Bank of America,CitiBank London,76145,77449,-1304
2013-08-01,Bank of America,CitiBank London,73283,73734,-451
2013-09-01,Bank of America,CitiBank London,75983,77187,-1204
2013-10-01,Bank of America,CitiBank London,72558,73942,-1384
2013-11-01,Bank of America,CitiBank London,74133,74623,-490
2013-12-01,Bank of America,CitiBank London,79978,72578,7400
2014-01-01,Bank of America,CitiBank London,71443,73511,-2068
2014-02-01,Bank of America,CitiBank London,77281,77999,-718
2014-03-01,Bank of America,CitiBank London,75822,79947,-4125
2014-04-01,Bank of America,CitiBank London,77569,72397,5172
2014-05-01,Bank of America,CitiBank London,72475,79581,-7106
2014-06-01,Bank of America,CitiBank London,77629,75391,2238
2014-07-01,Bank of America,CitiBank London,77843,77471,372
2014-08-01,Bank of America,CitiBank London,71539,79459,-7920
2014-09-01,Bank of America,CitiBank London,71658,79198,-7540
2014-10-01,Bank of America,CitiBank London,78741,78534,207
2014-11-01,Bank of America,CitiBank London,71372,76842,-5470
2014-12-01,Bank of America,CitiBank London,75163,74251,912
2015-01-01,Bank of America,CitiBank London,89582,88217,1365
2015-02-01,Bank of America,CitiBank London,89646,81835,7811
2015-03-01,Bank of America,CitiBank London,84784,84467,317
2015-04-01,Bank of America,CitiBank London,85464,87586,-2122
2015-05-01,Bank of America,CitiBank London,87834,84982,2852
2015-06-01,Bank of America,CitiBank London,85778,86551,-773
2015-07-01,Bank of America,CitiBank London,86573,81778,4795
2015-08-01,Bank of America,CitiBank London,88144,89435,-1291
2015-09-01,Bank of America,CitiBank London,85463,89661,-4198
2015-10-01,Bank of America,CitiBank London,86854,83232,3622
2015-11-01,Bank of America,CitiBank London,82564,89473,-6909
2015-12-01,Bank of America,CitiBank London,82734,81423,1311
2016-01-01,Bank of America,CitiBank London,86365,82198,4167
2016-02-01,Bank of America,CitiBank London,81669,82812,-1143
2016-03-01,Bank of America,CitiBank London,83188,82247,941
2016-04-01,Bank of America,CitiBank London,83494,88978,-5484
2016-05-01,Bank of America,CitiBank London,82269,81131,1138
2016-06-01,Bank of America,CitiBank London,87713,85142,2571
2016-07-01,Bank of America,CitiBank London,89139,81151,7988
2016-08-01,Bank of America,CitiBank London,86617,89214,-2597
2016-09-01,Bank of America,CitiBank London,93476,97495,-4019
2016-10-01,Bank of America,CitiBank London,93638,96486,-2848
2016-11-01,Bank of America,CitiBank London,96288,94128,2160
2016-12-01,Bank of America,CitiBank London,93759,92251,1508
2017-01-01,Bank of America,CitiBank London,91743,94332,-2589
2017-02-01,Bank of America,CitiBank London,95361,91466,3895
2017-03-01,Bank of America,CitiBank London,92534,97634,-5100
2017-04-01,Bank of America,CitiBank London,98166,92467,5699
2017-05-01,Bank of America,CitiBank London,96895,98623,-1728
2017-06-01,Bank of America,CitiBank London,99812,94254,5558
2017-07-01,Bank of America,CitiBank London,97421,93137,4284
2017-08-01,Bank of America,CitiBank London,93245,99451,-6206
2017-09-01,Bank of America,CitiBank London,95281,99122,-3841
2017-10-01,Bank of America,CitiBank London,94955,94595,360
2017-11-01,Bank of America,CitiBank London,97349,96365,984
2017-12-01,Bank of America,CitiBank London,99379,96175,3204
2018-01-01,Bank of America,CitiBank London,93342,97412,-4070
2018-02-01,Bank of America,CitiBank London,92463,91375,1088
2018-03-01,Bank of America,CitiBank London,94339,99665,-5326
2018-04-01,Bank of America,CitiBank London,95541,95646,-105
2010-01-01,Bank of America,CitiBank Pune,59819,52441,7378
2010-02-01,Bank of America,CitiBank Pune,51427,53331,-1904
2010-03-01,Bank of America,CitiBank Pune,53628,55117,-1489
2010-04-01,Bank of America,CitiBank Pune,54449,55992,-1543
2010-05-01,Bank of America,CitiBank Pune,55528,59492,-3964
2010-06-01,Bank of America,CitiBank Pune,51587,52132,-545
2010-07-01,Bank of America,CitiBank Pune,57143,58965,-1822
2010-08-01,Bank of America,CitiBank Pune,52193,55834,-3641
2010-09-01,Bank of America,CitiBank Pune,53615,58866,-5251
2010-10-01,Bank of America,CitiBank Pune,53647,55952,-2305
2010-11-01,Bank of America,CitiBank Pune,57655,57528,127
2010-12-01,Bank of America,CitiBank Pune,54895,58952,-4057
2011-01-01,Bank of America,CitiBank Pune,58244,56666,1578
2011-02-01,Bank of America,CitiBank Pune,59835,52776,7059
2011-03-01,Bank of America,CitiBank Pune,55253,53168,2085
2011-04-01,Bank of America,CitiBank Pune,54465,51525,2940
2011-05-01,Bank of America,CitiBank Pune,52159,55314,-3155
2011-06-01,Bank of America,CitiBank Pune,56823,59341,-2518
2011-07-01,Bank of America,CitiBank Pune,59917,59685,232
2011-08-01,Bank of America,CitiBank Pune,55134,51969,3165
2011-09-01,Bank of America,CitiBank Pune,66399,69399,-3000
2011-10-01,Bank of America,CitiBank Pune,62668,61991,677
2011-11-01,Bank of America,CitiBank Pune,69785,66822,2963
2011-12-01,Bank of America,CitiBank Pune,61733,68867,-7134
2012-01-01,Bank of America,CitiBank Pune,65619,67997,-2378
2012-02-01,Bank of America,CitiBank Pune,68122,62525,5597
2012-03-01,Bank of America,CitiBank Pune,61186,69563,-8377
2012-04-01,Bank of America,CitiBank Pune,66673,62961,3712
2012-05-01,Bank of America,CitiBank Pune,62958,67728,-4770
2012-06-01,Bank of America,CitiBank Pune,69546,67875,1671
2012-07-01,Bank of America,CitiBank Pune,65248,63152,2096
2012-08-01,Bank of America,CitiBank Pune,61828,67834,-6006
2012-09-01,Bank of America,CitiBank Pune,66687,67166,-479
2012-10-01,Bank of America,CitiBank Pune,69825,68464,1361
2012-11-01,Bank of America,CitiBank Pune,61781,65636,-3855
2012-12-01,Bank of America,CitiBank Pune,65294,64423,871
2013-01-01,Bank of America,CitiBank Pune,66558,66135,423
2013-02-01,Bank of America,CitiBank Pune,63317,65124,-1807
2013-03-01,Bank of America,CitiBank Pune,64915,69224,-4309
2013-04-01,Bank of America,CitiBank Pune,69432,69471,-39
2013-05-01,Bank of America,CitiBank Pune,74649,77747,-3098
2013-06-01,Bank of America,CitiBank Pune,79614,75297,4317
2013-07-01,Bank of America,CitiBank Pune,76293,77644,-1351
2013-08-01,Bank of America,CitiBank Pune,75486,75735,-249
2013-09-01,Bank of America,CitiBank Pune,76132,78822,-2690
2013-10-01,Bank of America,CitiBank Pune,71417,72427,-1010
2013-11-01,Bank of America,CitiBank Pune,72425,76116,-3691
2013-12-01,Bank of America,CitiBank Pune,75673,75939,-266
2014-01-01,Bank of America,CitiBank Pune,77735,71892,5843
2014-02-01,Bank of America,CitiBank Pune,72887,73481,-594
2014-03-01,Bank of America,CitiBank Pune,79736,73176,6560
2014-04-01,Bank of America,CitiBank Pune,74199,77667,-3468
2014-05-01,Bank of America,CitiBank Pune,79182,75145,4037
2014-06-01,Bank of America,CitiBank Pune,74169,78788,-4619
2014-07-01,Bank of America,CitiBank Pune,79565,74125,5440
2014-08-01,Bank of America,CitiBank Pune,73787,77138,-3351
2014-09-01,Bank of America,CitiBank Pune,73773,79691,-5918
2014-10-01,Bank of America,CitiBank Pune,74628,75495,-867
2014-11-01,Bank of America,CitiBank Pune,74385,71378,3007
2014-12-01,Bank of America,CitiBank Pune,79182,76773,2409
2015-01-01,Bank of America,CitiBank Pune,84179,81975,2204
2015-02-01,Bank of America,CitiBank Pune,86971,86941,30
2015-03-01,Bank of America,CitiBank Pune,83796,84651,-855
2015-04-01,Bank of America,CitiBank Pune,82451,86951,-4500
2015-05-01,Bank of America,CitiBank Pune,86413,86468,-55
2015-06-01,Bank of America,CitiBank Pune,83766,81392,2374
2015-07-01,Bank of America,CitiBank Pune,86556,84349,2207
2015-08-01,Bank of America,CitiBank Pune,88249,81511,6738
2015-09-01,Bank of America,CitiBank Pune,84625,83742,883
2015-10-01,Bank of America,CitiBank Pune,83655,88199,-4544
2015-11-01,Bank of America,CitiBank Pune,84966,88154,-3188
2015-12-01,Bank of America,CitiBank Pune,86327,82418,3909
2016-01-01,Bank of America,CitiBank Pune,87356,85138,2218
2016-02-01,Bank of America,CitiBank Pune,81713,88429,-6716
2016-03-01,Bank of America,CitiBank Pune,82756,82921,-165
2016-04-01,Bank of America,CitiBank Pune,87726,81373,6353
2016-05-01,Bank of America,CitiBank Pune,85785,84183,1602
2016-06-01,Bank of America,CitiBank Pune,88762,86686,2076
2016-07-01,Bank of America,CitiBank Pune,83551,84942,-1391
2016-08-01,Bank of America,CitiBank Pune,84836,84632,204
2016-09-01,Bank of America,CitiBank Pune,93163,94595,-1432
2016-10-01,Bank of America,CitiBank Pune,95453,92653,2800
2016-11-01,Bank of America,CitiBank Pune,98856,95673,3183
2016-12-01,Bank of America,CitiBank Pune,96522,92231,4291
2017-01-01,Bank of America,CitiBank Pune,99518,92699,6819
2017-02-01,Bank of America,CitiBank Pune,93225,91915,1310
2017-03-01,Bank of America,CitiBank Pune,98413,91636,6777
2017-04-01,Bank of America,CitiBank Pune,97446,96698,748
2017-05-01,Bank of America,CitiBank Pune,96728,91777,4951
2017-06-01,Bank of America,CitiBank Pune,95537,96579,-1042
2017-07-01,Bank of America,CitiBank Pune,92857,98479,-5622
2017-08-01,Bank of America,CitiBank Pune,93871,99686,-5815
2017-09-01,Bank of America,CitiBank Pune,92641,92177,464
2017-10-01,Bank of America,CitiBank Pune,94366,93627,739
2017-11-01,Bank of America,CitiBank Pune,98462,92499,5963
2017-12-01,Bank of America,CitiBank Pune,97792,97244,548
2018-01-01,Bank of America,CitiBank Pune,91959,95968,-4009
2018-02-01,Bank of America,CitiBank Pune,98179,94855,3324
2018-03-01,Bank of America,CitiBank Pune,97144,92168,4976
2018-04-01,Bank of America,CitiBank Pune,91387,98746,-7359
2010-01-01,Bank of America,CitiBank Singapore,51539,51342,197
2010-02-01,Bank of America,CitiBank Singapore,59641,58952,689
2010-03-01,Bank of America,CitiBank Singapore,54723,51363,3360
2010-04-01,Bank of America,CitiBank Singapore,58574,57996,578
2010-05-01,Bank of America,CitiBank Singapore,51713,58387,-6674
2010-06-01,Bank of America,CitiBank Singapore,51367,59493,-8126
2010-07-01,Bank of America,CitiBank Singapore,55136,58586,-3450
2010-08-01,Bank of America,CitiBank Singapore,55314,55736,-422
2010-09-01,Bank of America,CitiBank Singapore,57733,56686,1047
2010-10-01,Bank of America,CitiBank Singapore,56816,54771,2045
2010-11-01,Bank of America,CitiBank Singapore,58443,54663,3780
2010-12-01,Bank of America,CitiBank Singapore,55711,51632,4079
2011-01-01,Bank of America,CitiBank Singapore,57533,54676,2857
2011-02-01,Bank of America,CitiBank Singapore,53713,53859,-146
2011-03-01,Bank of America,CitiBank Singapore,51255,58318,-7063
2011-04-01,Bank of America,CitiBank Singapore,58572,58476,96
2011-05-01,Bank of America,CitiBank Singapore,51316,55376,-4060
2011-06-01,Bank of America,CitiBank Singapore,53516,59882,-6366
2011-07-01,Bank of America,CitiBank Singapore,59667,51253,8414
2011-08-01,Bank of America,CitiBank Singapore,53887,51577,2310
2011-09-01,Bank of America,CitiBank Singapore,62121,64335,-2214
2011-10-01,Bank of America,CitiBank Singapore,64419,63394,1025
2011-11-01,Bank of America,CitiBank Singapore,67266,63576,3690
2011-12-01,Bank of America,CitiBank Singapore,65987,63749,2238
2012-01-01,Bank of America,CitiBank Singapore,62369,61495,874
2012-02-01,Bank of America,CitiBank Singapore,63399,65355,-1956
2012-03-01,Bank of America,CitiBank Singapore,69445,64656,4789
2012-04-01,Bank of America,CitiBank Singapore,66879,68278,-1399
2012-05-01,Bank of America,CitiBank Singapore,61947,62154,-207
2012-06-01,Bank of America,CitiBank Singapore,62618,66458,-3840
2012-07-01,Bank of America,CitiBank Singapore,66574,65232,1342
2012-08-01,Bank of America,CitiBank Singapore,65285,66794,-1509
2012-09-01,Bank of America,CitiBank Singapore,65971,68978,-3007
2012-10-01,Bank of America,CitiBank Singapore,67611,64126,3485
2012-11-01,Bank of America,CitiBank Singapore,69962,68872,1090
2012-12-01,Bank of America,CitiBank Singapore,68196,67678,518
2013-01-01,Bank of America,CitiBank Singapore,65492,63338,2154
2013-02-01,Bank of America,CitiBank Singapore,64474,69589,-5115
2013-03-01,Bank of America,CitiBank Singapore,61298,62682,-1384
2013-04-01,Bank of America,CitiBank Singapore,67837,65158,2679
2013-05-01,Bank of America,CitiBank Singapore,78593,75757,2836
2013-06-01,Bank of America,CitiBank Singapore,74492,74669,-177
2013-07-01,Bank of America,CitiBank Singapore,73521,76477,-2956
2013-08-01,Bank of America,CitiBank Singapore,73118,77237,-4119
2013-09-01,Bank of America,CitiBank Singapore,79497,77481,2016
2013-10-01,Bank of America,CitiBank Singapore,71524,71144,380
2013-11-01,Bank of America,CitiBank Singapore,77282,76722,560
2013-12-01,Bank of America,CitiBank Singapore,74749,79552,-4803
2014-01-01,Bank of America,CitiBank Singapore,77443,78163,-720
2014-02-01,Bank of America,CitiBank Singapore,74684,73195,1489
2014-03-01,Bank of America,CitiBank Singapore,78662,78715,-53
2014-04-01,Bank of America,CitiBank Singapore,76566,73929,2637
2014-05-01,Bank of America,CitiBank Singapore,71929,79653,-7724
2014-06-01,Bank of America,CitiBank Singapore,71731,72974,-1243
2014-07-01,Bank of America,CitiBank Singapore,72455,73867,-1412
2014-08-01,Bank of America,CitiBank Singapore,74161,73792,369
2014-09-01,Bank of America,CitiBank Singapore,71898,71764,134
2014-10-01,Bank of America,CitiBank Singapore,77398,71458,5940
2014-11-01,Bank of America,CitiBank Singapore,75159,73761,1398
2014-12-01,Bank of America,CitiBank Singapore,73775,73273,502
2015-01-01,Bank of America,CitiBank Singapore,87239,83776,3463
2015-02-01,Bank of America,CitiBank Singapore,84315,86696,-2381
2015-03-01,Bank of America,CitiBank Singapore,84293,81976,2317
2015-04-01,Bank of America,CitiBank Singapore,86258,87851,-1593
2015-05-01,Bank of America,CitiBank Singapore,81659,88993,-7334
2015-06-01,Bank of America,CitiBank Singapore,86143,85235,908
2015-07-01,Bank of America,CitiBank Singapore,81685,88178,-6493
2015-08-01,Bank of America,CitiBank Singapore,81269,84186,-2917
2015-09-01,Bank of America,CitiBank Singapore,86669,82318,4351
2015-10-01,Bank of America,CitiBank Singapore,83267,83361,-94
2015-11-01,Bank of America,CitiBank Singapore,87897,85711,2186
2015-12-01,Bank of America,CitiBank Singapore,84643,87845,-3202
2016-01-01,Bank of America,CitiBank Singapore,82556,87279,-4723
2016-02-01,Bank of America,CitiBank Singapore,85398,86163,-765
2016-03-01,Bank of America,CitiBank Singapore,89514,83445,6069
2016-04-01,Bank of America,CitiBank Singapore,84713,86228,-1515
2016-05-01,Bank of America,CitiBank Singapore,87652,89411,-1759
2016-06-01,Bank of America,CitiBank Singapore,85765,89843,-4078
2016-07-01,Bank of America,CitiBank Singapore,84981,84896,85
2016-08-01,Bank of America,CitiBank Singapore,86332,81294,5038
2016-09-01,Bank of America,CitiBank Singapore,94256,97529,-3273
2016-10-01,Bank of America,CitiBank Singapore,94527,91847,2680
2016-11-01,Bank of America,CitiBank Singapore,95324,96588,-1264
2016-12-01,Bank of America,CitiBank Singapore,97327,96489,838
2017-01-01,Bank of America,CitiBank Singapore,98161,95946,2215
2017-02-01,Bank of America,CitiBank Singapore,92815,92942,-127
2017-03-01,Bank of America,CitiBank Singapore,97445,92324,5121
2017-04-01,Bank of America,CitiBank Singapore,97126,92283,4843
2017-05-01,Bank of America,CitiBank Singapore,94157,98319,-4162
2017-06-01,Bank of America,CitiBank Singapore,99667,97845,1822
2017-07-01,Bank of America,CitiBank Singapore,91219,92118,-899
2017-08-01,Bank of America,CitiBank Singapore,97631,99992,-2361
2017-09-01,Bank of America,CitiBank Singapore,96176,91365,4811
2017-10-01,Bank of America,CitiBank Singapore,94712,96695,-1983
2017-11-01,Bank of America,CitiBank Singapore,93656,97856,-4200
2017-12-01,Bank of America,CitiBank Singapore,99829,94425,5404
2018-01-01,Bank of America,CitiBank Singapore,96711,91836,4875
2018-02-01,Bank of America,CitiBank Singapore,91169,93793,-2624
2018-03-01,Bank of America,CitiBank Singapore,99311,99897,-586
2018-04-01,Bank of America,CitiBank Singapore,98196,93254,4942
2010-01-01,Bank of America,CitiBank HongKong,59568,51796,7772
2010-02-01,Bank of America,CitiBank HongKong,53696,56345,-2649
2010-03-01,Bank of America,CitiBank HongKong,57218,54697,2521
2010-04-01,Bank of America,CitiBank HongKong,58678,55293,3385
2010-05-01,Bank of America,CitiBank HongKong,54623,56168,-1545
2010-06-01,Bank of America,CitiBank HongKong,56775,57897,-1122
2010-07-01,Bank of America,CitiBank HongKong,58297,54794,3503
2010-08-01,Bank of America,CitiBank HongKong,52543,55164,-2621
2010-09-01,Bank of America,CitiBank HongKong,51754,58657,-6903
2010-10-01,Bank of America,CitiBank HongKong,51311,51847,-536
2010-11-01,Bank of America,CitiBank HongKong,57737,56478,1259
2010-12-01,Bank of America,CitiBank HongKong,51618,56789,-5171
2011-01-01,Bank of America,CitiBank HongKong,52875,57133,-4258
2011-02-01,Bank of America,CitiBank HongKong,55482,59421,-3939
2011-03-01,Bank of America,CitiBank HongKong,58737,57263,1474
2011-04-01,Bank of America,CitiBank HongKong,58129,54816,3313
2011-05-01,Bank of America,CitiBank HongKong,56413,58676,-2263
2011-06-01,Bank of America,CitiBank HongKong,55845,54751,1094
2011-07-01,Bank of America,CitiBank HongKong,54274,59977,-5703
2011-08-01,Bank of America,CitiBank HongKong,51713,53368,-1655
2011-09-01,Bank of America,CitiBank HongKong,62495,64125,-1630
2011-10-01,Bank of America,CitiBank HongKong,66228,65235,993
2011-11-01,Bank of America,CitiBank HongKong,64362,69632,-5270
2011-12-01,Bank of America,CitiBank HongKong,69185,62899,6286
2012-01-01,Bank of America,CitiBank HongKong,62664,67657,-4993
2012-02-01,Bank of America,CitiBank HongKong,67281,69275,-1994
2012-03-01,Bank of America,CitiBank HongKong,67457,68694,-1237
2012-04-01,Bank of America,CitiBank HongKong,65443,61668,3775
2012-05-01,Bank of America,CitiBank HongKong,66957,65643,1314
2012-06-01,Bank of America,CitiBank HongKong,61771,64976,-3205
2012-07-01,Bank of America,CitiBank HongKong,61143,61341,-198
2012-08-01,Bank of America,CitiBank HongKong,68855,63962,4893
2012-09-01,Bank of America,CitiBank HongKong,62741,65143,-2402
2012-10-01,Bank of America,CitiBank HongKong,62752,61939,813
2012-11-01,Bank of America,CitiBank HongKong,63446,69468,-6022
2012-12-01,Bank of America,CitiBank HongKong,61919,65726,-3807
2013-01-01,Bank of America,CitiBank HongKong,62353,62661,-308
2013-02-01,Bank of America,CitiBank HongKong,61824,62647,-823
2013-03-01,Bank of America,CitiBank HongKong,67672,63766,3906
2013-04-01,Bank of America,CitiBank HongKong,65324,62861,2463
2013-05-01,Bank of America,CitiBank HongKong,75784,77721,-1937
2013-06-01,Bank of America,CitiBank HongKong,71895,79932,-8037
2013-07-01,Bank of America,CitiBank HongKong,74654,74559,95
2013-08-01,Bank of America,CitiBank HongKong,71127,79387,-8260
2013-09-01,Bank of America,CitiBank HongKong,76444,79115,-2671
2013-10-01,Bank of America,CitiBank HongKong,77887,76459,1428
2013-11-01,Bank of America,CitiBank HongKong,79225,72552,6673
2013-12-01,Bank of America,CitiBank HongKong,73553,76538,-2985
2014-01-01,Bank of America,CitiBank HongKong,78563,77241,1322
2014-02-01,Bank of America,CitiBank HongKong,72622,79796,-7174
2014-03-01,Bank of America,CitiBank HongKong,72349,74898,-2549
2014-04-01,Bank of America,CitiBank HongKong,79879,77355,2524
2014-05-01,Bank of America,CitiBank HongKong,79661,79169,492
2014-06-01,Bank of America,CitiBank HongKong,75813,71688,4125
2014-07-01,Bank of America,CitiBank HongKong,77668,75817,1851
2014-08-01,Bank of America,CitiBank HongKong,72729,78327,-5598
2014-09-01,Bank of America,CitiBank HongKong,76757,77775,-1018
2014-10-01,Bank of America,CitiBank HongKong,71116,72189,-1073
2014-11-01,Bank of America,CitiBank HongKong,77717,77269,448
2014-12-01,Bank of America,CitiBank HongKong,73447,72793,654
2015-01-01,Bank of America,CitiBank HongKong,84688,86154,-1466
2015-02-01,Bank of America,CitiBank HongKong,81695,88664,-6969
2015-03-01,Bank of America,CitiBank HongKong,85489,83688,1801
2015-04-01,Bank of America,CitiBank HongKong,82259,84589,-2330
2015-05-01,Bank of America,CitiBank HongKong,85447,87542,-2095
2015-06-01,Bank of America,CitiBank HongKong,82267,83576,-1309
2015-07-01,Bank of America,CitiBank HongKong,84431,84184,247
2015-08-01,Bank of America,CitiBank HongKong,81523,85762,-4239
2015-09-01,Bank of America,CitiBank HongKong,89132,81842,7290
2015-10-01,Bank of America,CitiBank HongKong,82664,85145,-2481
2015-11-01,Bank of America,CitiBank HongKong,86223,83433,2790
2015-12-01,Bank of America,CitiBank HongKong,86473,82142,4331
2016-01-01,Bank of America,CitiBank HongKong,85281,88837,-3556
2016-02-01,Bank of America,CitiBank HongKong,87331,84826,2505
2016-03-01,Bank of America,CitiBank HongKong,89495,89258,237
2016-04-01,Bank of America,CitiBank HongKong,86393,81926,4467
2016-05-01,Bank of America,CitiBank HongKong,84925,89533,-4608
2016-06-01,Bank of America,CitiBank HongKong,86553,83929,2624
2016-07-01,Bank of America,CitiBank HongKong,82261,87459,-5198
2016-08-01,Bank of America,CitiBank HongKong,85726,86418,-692
2016-09-01,Bank of America,CitiBank HongKong,94778,91578,3200
2016-10-01,Bank of America,CitiBank HongKong,98879,91472,7407
2016-11-01,Bank of America,CitiBank HongKong,93952,97944,-3992
2016-12-01,Bank of America,CitiBank HongKong,98596,95271,3325
2017-01-01,Bank of America,CitiBank HongKong,99222,99414,-192
2017-02-01,Bank of America,CitiBank HongKong,94949,94452,497
2017-03-01,Bank of America,CitiBank HongKong,92447,96299,-3852
2017-04-01,Bank of America,CitiBank HongKong,98988,96592,2396
2017-05-01,Bank of America,CitiBank HongKong,96736,94667,2069
2017-06-01,Bank of America,CitiBank HongKong,95394,92415,2979
2017-07-01,Bank of America,CitiBank HongKong,91741,99556,-7815
2017-08-01,Bank of America,CitiBank HongKong,98149,91662,6487
2017-09-01,Bank of America,CitiBank HongKong,96273,93848,2425
2017-10-01,Bank of America,CitiBank HongKong,94618,98213,-3595
2017-11-01,Bank of America,CitiBank HongKong,91976,97849,-5873
2017-12-01,Bank of America,CitiBank HongKong,98885,99931,-1046
2018-01-01,Bank of America,CitiBank HongKong,93473,96686,-3213
2018-02-01,Bank of America,CitiBank HongKong,93155,91448,1707
2018-03-01,Bank of America,CitiBank HongKong,91316,93131,-1815
2018-04-01,Bank of America,CitiBank HongKong,92663,93328,-665
2010-01-01,Barclays,CitiBank New York,53967,53255,712
2010-02-01,Barclays,CitiBank New York,55865,53714,2151
2010-03-01,Barclays,CitiBank New York,51948,59398,-7450
2010-04-01,Barclays,CitiBank New York,54234,58837,-4603
2010-05-01,Barclays,CitiBank New York,57563,55732,1831
2010-06-01,Barclays,CitiBank New York,55464,55482,-18
2010-07-01,Barclays,CitiBank New York,58765,52157,6608
2010-08-01,Barclays,CitiBank New York,56861,58249,-1388
2010-09-01,Barclays,CitiBank New York,54714,57467,-2753
2010-10-01,Barclays,CitiBank New York,56154,54817,1337
2010-11-01,Barclays,CitiBank New York,57592,56211,1381
2010-12-01,Barclays,CitiBank New York,56779,51397,5382
2011-01-01,Barclays,CitiBank New York,58339,59918,-1579
2011-02-01,Barclays,CitiBank New York,57997,57883,114
2011-03-01,Barclays,CitiBank New York,56892,57126,-234
2011-04-01,Barclays,CitiBank New York,59396,56914,2482
2011-05-01,Barclays,CitiBank New York,55449,52259,3190
2011-06-01,Barclays,CitiBank New York,53588,51658,1930
2011-07-01,Barclays,CitiBank New York,55713,53841,1872
2011-08-01,Barclays,CitiBank New York,52691,58938,-6247
2011-09-01,Barclays,CitiBank New York,68772,67221,1551
2011-10-01,Barclays,CitiBank New York,63323,61486,1837
2011-11-01,Barclays,CitiBank New York,69192,64893,4299
2011-12-01,Barclays,CitiBank New York,69379,67513,1866
2012-01-01,Barclays,CitiBank New York,67157,65655,1502
2012-02-01,Barclays,CitiBank New York,66625,69946,-3321
2012-03-01,Barclays,CitiBank New York,65281,62749,2532
2012-04-01,Barclays,CitiBank New York,69132,63427,5705
2012-05-01,Barclays,CitiBank New York,67722,63655,4067
2012-06-01,Barclays,CitiBank New York,69467,66493,2974
2012-07-01,Barclays,CitiBank New York,64943,69881,-4938
2012-08-01,Barclays,CitiBank New York,65596,69347,-3751
2012-09-01,Barclays,CitiBank New York,68274,69439,-1165
2012-10-01,Barclays,CitiBank New York,68298,65497,2801
2012-11-01,Barclays,CitiBank New York,67498,68145,-647
2012-12-01,Barclays,CitiBank New York,64279,67355,-3076
2013-01-01,Barclays,CitiBank New York,66945,69187,-2242
2013-02-01,Barclays,CitiBank New York,62431,63963,-1532
2013-03-01,Barclays,CitiBank New York,61352,69818,-8466
2013-04-01,Barclays,CitiBank New York,68387,61728,6659
2013-05-01,Barclays,CitiBank New York,78112,79837,-1725
2013-06-01,Barclays,CitiBank New York,72665,71837,828
2013-07-01,Barclays,CitiBank New York,75199,79152,-3953
2013-08-01,Barclays,CitiBank New York,73369,72148,1221
2013-09-01,Barclays,CitiBank New York,74179,77457,-3278
2013-10-01,Barclays,CitiBank New York,78264,76635,1629
2013-11-01,Barclays,CitiBank New York,78475,77968,507
2013-12-01,Barclays,CitiBank New York,78231,77342,889
2014-01-01,Barclays,CitiBank New York,72428,72575,-147
2014-02-01,Barclays,CitiBank New York,74218,78282,-4064
2014-03-01,Barclays,CitiBank New York,73496,76841,-3345
2014-04-01,Barclays,CitiBank New York,75695,73233,2462
2014-05-01,Barclays,CitiBank New York,79691,79237,454
2014-06-01,Barclays,CitiBank New York,79627,77111,2516
2014-07-01,Barclays,CitiBank New York,78244,78459,-215
2014-08-01,Barclays,CitiBank New York,72816,79944,-7128
2014-09-01,Barclays,CitiBank New York,71945,75965,-4020
2014-10-01,Barclays,CitiBank New York,73934,72983,951
2014-11-01,Barclays,CitiBank New York,73113,72818,295
2014-12-01,Barclays,CitiBank New York,75243,72658,2585
2015-01-01,Barclays,CitiBank New York,89137,85557,3580
2015-02-01,Barclays,CitiBank New York,83693,81876,1817
2015-03-01,Barclays,CitiBank New York,82881,86368,-3487
2015-04-01,Barclays,CitiBank New York,83978,85774,-1796
2015-05-01,Barclays,CitiBank New York,83442,87592,-4150
2015-06-01,Barclays,CitiBank New York,82291,87915,-5624
2015-07-01,Barclays,CitiBank New York,81244,84772,-3528
2015-08-01,Barclays,CitiBank New York,86496,86889,-393
2015-09-01,Barclays,CitiBank New York,83519,88181,-4662
2015-10-01,Barclays,CitiBank New York,81118,89756,-8638
2015-11-01,Barclays,CitiBank New York,85225,87877,-2652
2015-12-01,Barclays,CitiBank New York,82479,87744,-5265
2016-01-01,Barclays,CitiBank New York,89122,84582,4540
2016-02-01,Barclays,CitiBank New York,83299,85818,-2519
2016-03-01,Barclays,CitiBank New York,89247,81543,7704
2016-04-01,Barclays,CitiBank New York,82667,86863,-4196
2016-05-01,Barclays,CitiBank New York,87837,82787,5050
2016-06-01,Barclays,CitiBank New York,84298,83828,470
2016-07-01,Barclays,CitiBank New York,88683,82381,6302
2016-08-01,Barclays,CitiBank New York,81358,82493,-1135
2016-09-01,Barclays,CitiBank New York,95491,96523,-1032
2016-10-01,Barclays,CitiBank New York,97231,95219,2012
2016-11-01,Barclays,CitiBank New York,96298,95287,1011
2016-12-01,Barclays,CitiBank New York,93946,91295,2651
2017-01-01,Barclays,CitiBank New York,94659,97669,-3010
2017-02-01,Barclays,CitiBank New York,91511,94683,-3172
2017-03-01,Barclays,CitiBank New York,99284,96243,3041
2017-04-01,Barclays,CitiBank New York,96314,92359,3955
2017-05-01,Barclays,CitiBank New York,93342,92768,574
2017-06-01,Barclays,CitiBank New York,95388,93271,2117
2017-07-01,Barclays,CitiBank New York,94481,94596,-115
2017-08-01,Barclays,CitiBank New York,97519,93763,3756
2017-09-01,Barclays,CitiBank New York,99748,91217,8531
2017-10-01,Barclays,CitiBank New York,95824,99549,-3725
2017-11-01,Barclays,CitiBank New York,99642,97461,2181
2017-12-01,Barclays,CitiBank New York,96141,93231,2910
2018-01-01,Barclays,CitiBank New York,92177,96545,-4368
2018-02-01,Barclays,CitiBank New York,93524,93156,368
2018-03-01,Barclays,CitiBank New York,91158,98968,-7810
2018-04-01,Barclays,CitiBank New York,95756,91428,4328
2010-01-01,Barclays,CitiBank London,59115,54971,4144
2010-02-01,Barclays,CitiBank London,51632,57734,-6102
2010-03-01,Barclays,CitiBank London,51845,58198,-6353
2010-04-01,Barclays,CitiBank London,59939,58313,1626
2010-05-01,Barclays,CitiBank London,52641,54576,-1935
2010-06-01,Barclays,CitiBank London,57683,55437,2246
2010-07-01,Barclays,CitiBank London,56783,57675,-892
2010-08-01,Barclays,CitiBank London,53444,52882,562
2010-09-01,Barclays,CitiBank London,55181,51593,3588
2010-10-01,Barclays,CitiBank London,57721,54424,3297
2010-11-01,Barclays,CitiBank London,54179,55569,-1390
2010-12-01,Barclays,CitiBank London,59665,54327,5338
2011-01-01,Barclays,CitiBank London,53789,59621,-5832
2011-02-01,Barclays,CitiBank London,56497,57535,-1038
2011-03-01,Barclays,CitiBank London,56157,51839,4318
2011-04-01,Barclays,CitiBank London,52427,57123,-4696
2011-05-01,Barclays,CitiBank London,52782,55244,-2462
2011-06-01,Barclays,CitiBank London,58966,53671,5295
2011-07-01,Barclays,CitiBank London,51762,52944,-1182
2011-08-01,Barclays,CitiBank London,55792,54717,1075
2011-09-01,Barclays,CitiBank London,67657,69158,-1501
2011-10-01,Barclays,CitiBank London,61728,65635,-3907
2011-11-01,Barclays,CitiBank London,67356,65272,2084
2011-12-01,Barclays,CitiBank London,63734,64638,-904
2012-01-01,Barclays,CitiBank London,69779,62467,7312
2012-02-01,Barclays,CitiBank London,62781,67717,-4936
2012-03-01,Barclays,CitiBank London,65631,68558,-2927
2012-04-01,Barclays,CitiBank London,65523,66684,-1161
2012-05-01,Barclays,CitiBank London,64972,63968,1004
2012-06-01,Barclays,CitiBank London,66597,68727,-2130
2012-07-01,Barclays,CitiBank London,61424,65637,-4213
2012-08-01,Barclays,CitiBank London,66435,65357,1078
2012-09-01,Barclays,CitiBank London,69494,61615,7879
2012-10-01,Barclays,CitiBank London,61258,67922,-6664
2012-11-01,Barclays,CitiBank London,65673,65183,490
2012-12-01,Barclays,CitiBank London,61778,61234,544
2013-01-01,Barclays,CitiBank London,66737,63432,3305
2013-02-01,Barclays,CitiBank London,69119,68282,837
2013-03-01,Barclays,CitiBank London,69385,61844,7541
2013-04-01,Barclays,CitiBank London,65327,69674,-4347
2013-05-01,Barclays,CitiBank London,76861,75687,1174
2013-06-01,Barclays,CitiBank London,74833,77924,-3091
2013-07-01,Barclays,CitiBank London,76455,77794,-1339
2013-08-01,Barclays,CitiBank London,72633,73235,-602
2013-09-01,Barclays,CitiBank London,79411,73475,5936
2013-10-01,Barclays,CitiBank London,71423,74281,-2858
2013-11-01,Barclays,CitiBank London,76275,75867,408
2013-12-01,Barclays,CitiBank London,72246,78498,-6252
2014-01-01,Barclays,CitiBank London,76766,77699,-933
2014-02-01,Barclays,CitiBank London,76821,71914,4907
2014-03-01,Barclays,CitiBank London,73748,75654,-1906
2014-04-01,Barclays,CitiBank London,76237,74938,1299
2014-05-01,Barclays,CitiBank London,77496,78278,-782
2014-06-01,Barclays,CitiBank London,79887,72116,7771
2014-07-01,Barclays,CitiBank London,78875,72273,6602
2014-08-01,Barclays,CitiBank London,74619,76694,-2075
2014-09-01,Barclays,CitiBank London,71866,75356,-3490
2014-10-01,Barclays,CitiBank London,78256,75932,2324
2014-11-01,Barclays,CitiBank London,79819,78811,1008
2014-12-01,Barclays,CitiBank London,76515,74753,1762
2015-01-01,Barclays,CitiBank London,87117,87534,-417
2015-02-01,Barclays,CitiBank London,85288,88586,-3298
2015-03-01,Barclays,CitiBank London,87624,88335,-711
2015-04-01,Barclays,CitiBank London,84332,86422,-2090
2015-05-01,Barclays,CitiBank London,85172,83377,1795
2015-06-01,Barclays,CitiBank London,82493,83255,-762
2015-07-01,Barclays,CitiBank London,88784,86563,2221
2015-08-01,Barclays,CitiBank London,85459,86511,-1052
2015-09-01,Barclays,CitiBank London,81113,87543,-6430
2015-10-01,Barclays,CitiBank London,87277,82726,4551
2015-11-01,Barclays,CitiBank London,84451,85371,-920
2015-12-01,Barclays,CitiBank London,84815,81292,3523
2016-01-01,Barclays,CitiBank London,86962,87213,-251
2016-02-01,Barclays,CitiBank London,84566,82228,2338
2016-03-01,Barclays,CitiBank London,82271,87755,-5484
2016-04-01,Barclays,CitiBank London,85615,87898,-2283
2016-05-01,Barclays,CitiBank London,89718,83386,6332
2016-06-01,Barclays,CitiBank London,89252,89368,-116
2016-07-01,Barclays,CitiBank London,88785,82794,5991
2016-08-01,Barclays,CitiBank London,85127,82421,2706
2016-09-01,Barclays,CitiBank London,98486,95584,2902
2016-10-01,Barclays,CitiBank London,92924,95298,-2374
2016-11-01,Barclays,CitiBank London,98579,94311,4268
2016-12-01,Barclays,CitiBank London,93888,99858,-5970
2017-01-01,Barclays,CitiBank London,98187,94836,3351
2017-02-01,Barclays,CitiBank London,96524,93213,3311
2017-03-01,Barclays,CitiBank London,94756,95833,-1077
2017-04-01,Barclays,CitiBank London,99578,91918,7660
2017-05-01,Barclays,CitiBank London,93457,99192,-5735
2017-06-01,Barclays,CitiBank London,91822,99842,-8020
2017-07-01,Barclays,CitiBank London,94933,95789,-856
2017-08-01,Barclays,CitiBank London,99356,99316,40
2017-09-01,Barclays,CitiBank London,97271,94416,2855
2017-10-01,Barclays,CitiBank London,93548,91259,2289
2017-11-01,Barclays,CitiBank London,99216,95829,3387
2017-12-01,Barclays,CitiBank London,91614,95629,-4015
2018-01-01,Barclays,CitiBank London,98871,95348,3523
2018-02-01,Barclays,CitiBank London,96878,91589,5289
2018-03-01,Barclays,CitiBank London,93873,96989,-3116
2018-04-01,Barclays,CitiBank London,91635,98727,-7092
2010-01-01,Barclays,CitiBank Pune,57637,51678,5959
2010-02-01,Barclays,CitiBank Pune,58488,54185,4303
2010-03-01,Barclays,CitiBank Pune,56275,52967,3308
2010-04-01,Barclays,CitiBank Pune,53213,54362,-1149
2010-05-01,Barclays,CitiBank Pune,51982,55993,-4011
2010-06-01,Barclays,CitiBank Pune,54582,55733,-1151
2010-07-01,Barclays,CitiBank Pune,54751,58976,-4225
2010-08-01,Barclays,CitiBank Pune,59818,56122,3696
2010-09-01,Barclays,CitiBank Pune,54942,57125,-2183
2010-10-01,Barclays,CitiBank Pune,56315,59565,-3250
2010-11-01,Barclays,CitiBank Pune,58296,51673,6623
2010-12-01,Barclays,CitiBank Pune,58767,52816,5951
2011-01-01,Barclays,CitiBank Pune,57687,52834,4853
2011-02-01,Barclays,CitiBank Pune,56636,54943,1693
2011-03-01,Barclays,CitiBank Pune,58981,53948,5033
2011-04-01,Barclays,CitiBank Pune,59622,51148,8474
2011-05-01,Barclays,CitiBank Pune,51969,51988,-19
2011-06-01,Barclays,CitiBank Pune,55631,59285,-3654
2011-07-01,Barclays,CitiBank Pune,59447,55938,3509
2011-08-01,Barclays,CitiBank Pune,56882,51113,5769
2011-09-01,Barclays,CitiBank Pune,64595,61963,2632
2011-10-01,Barclays,CitiBank Pune,65944,67214,-1270
2011-11-01,Barclays,CitiBank Pune,61987,64229,-2242
2011-12-01,Barclays,CitiBank Pune,69822,68487,1335
2012-01-01,Barclays,CitiBank Pune,62351,69194,-6843
2012-02-01,Barclays,CitiBank Pune,66234,67872,-1638
2012-03-01,Barclays,CitiBank Pune,68896,69749,-853
2012-04-01,Barclays,CitiBank Pune,69626,61422,8204
2012-05-01,Barclays,CitiBank Pune,66294,67533,-1239
2012-06-01,Barclays,CitiBank Pune,63971,62322,1649
2012-07-01,Barclays,CitiBank Pune,64347,61182,3165
2012-08-01,Barclays,CitiBank Pune,66743,66487,256
2012-09-01,Barclays,CitiBank Pune,64932,68626,-3694
2012-10-01,Barclays,CitiBank Pune,68582,66353,2229
2012-11-01,Barclays,CitiBank Pune,68666,68132,534
2012-12-01,Barclays,CitiBank Pune,61895,63547,-1652
2013-01-01,Barclays,CitiBank Pune,61224,63556,-2332
2013-02-01,Barclays,CitiBank Pune,61614,67658,-6044
2013-03-01,Barclays,CitiBank Pune,63764,66288,-2524
2013-04-01,Barclays,CitiBank Pune,69996,64962,5034
2013-05-01,Barclays,CitiBank Pune,79185,72177,7008
2013-06-01,Barclays,CitiBank Pune,76429,73965,2464
2013-07-01,Barclays,CitiBank Pune,75141,76928,-1787
2013-08-01,Barclays,CitiBank Pune,79576,77462,2114
2013-09-01,Barclays,CitiBank Pune,74695,71265,3430
2013-10-01,Barclays,CitiBank Pune,76543,77528,-985
2013-11-01,Barclays,CitiBank Pune,79478,77513,1965
2013-12-01,Barclays,CitiBank Pune,77975,76181,1794
2014-01-01,Barclays,CitiBank Pune,79223,73536,5687
2014-02-01,Barclays,CitiBank Pune,73475,78642,-5167
2014-03-01,Barclays,CitiBank Pune,74271,71531,2740
2014-04-01,Barclays,CitiBank Pune,76839,76541,298
2014-05-01,Barclays,CitiBank Pune,72456,75927,-3471
2014-06-01,Barclays,CitiBank Pune,75837,76965,-1128
2014-07-01,Barclays,CitiBank Pune,78627,73271,5356
2014-08-01,Barclays,CitiBank Pune,78564,74852,3712
2014-09-01,Barclays,CitiBank Pune,73361,76256,-2895
2014-10-01,Barclays,CitiBank Pune,77132,76234,898
2014-11-01,Barclays,CitiBank Pune,77541,79825,-2284
2014-12-01,Barclays,CitiBank Pune,75192,73981,1211
2015-01-01,Barclays,CitiBank Pune,81394,86799,-5405
2015-02-01,Barclays,CitiBank Pune,87989,82395,5594
2015-03-01,Barclays,CitiBank Pune,85314,87886,-2572
2015-04-01,Barclays,CitiBank Pune,88642,85271,3371
2015-05-01,Barclays,CitiBank Pune,84843,84824,19
2015-06-01,Barclays,CitiBank Pune,85428,85576,-148
2015-07-01,Barclays,CitiBank Pune,89738,85484,4254
2015-08-01,Barclays,CitiBank Pune,88869,87479,1390
2015-09-01,Barclays,CitiBank Pune,82157,89123,-6966
2015-10-01,Barclays,CitiBank Pune,82245,84489,-2244
2015-11-01,Barclays,CitiBank Pune,85448,88129,-2681
2015-12-01,Barclays,CitiBank Pune,81638,86862,-5224
2016-01-01,Barclays,CitiBank Pune,85773,88584,-2811
2016-02-01,Barclays,CitiBank Pune,88989,84178,4811
2016-03-01,Barclays,CitiBank Pune,86118,81871,4247
2016-04-01,Barclays,CitiBank Pune,82758,82213,545
2016-05-01,Barclays,CitiBank Pune,88496,85263,3233
2016-06-01,Barclays,CitiBank Pune,81293,83223,-1930
2016-07-01,Barclays,CitiBank Pune,85744,83455,2289
2016-08-01,Barclays,CitiBank Pune,89487,86319,3168
2016-09-01,Barclays,CitiBank Pune,96458,93826,2632
2016-10-01,Barclays,CitiBank Pune,93138,98161,-5023
2016-11-01,Barclays,CitiBank Pune,93712,96188,-2476
2016-12-01,Barclays,CitiBank Pune,96511,96151,360
2017-01-01,Barclays,CitiBank Pune,91611,96879,-5268
2017-02-01,Barclays,CitiBank Pune,93722,94351,-629
2017-03-01,Barclays,CitiBank Pune,99883,95255,4628
2017-04-01,Barclays,CitiBank Pune,92679,95753,-3074
2017-05-01,Barclays,CitiBank Pune,97699,91658,6041
2017-06-01,Barclays,CitiBank Pune,99339,91427,7912
2017-07-01,Barclays,CitiBank Pune,92121,92273,-152
2017-08-01,Barclays,CitiBank Pune,92392,98998,-6606
2017-09-01,Barclays,CitiBank Pune,93383,97415,-4032
2017-10-01,Barclays,CitiBank Pune,97418,91241,6177
2017-11-01,Barclays,CitiBank Pune,99525,91561,7964
2017-12-01,Barclays,CitiBank Pune,93637,96711,-3074
2018-01-01,Barclays,CitiBank Pune,93286,98343,-5057
2018-02-01,Barclays,CitiBank Pune,95718,97371,-1653
2018-03-01,Barclays,CitiBank Pune,96668,97436,-768
2018-04-01,Barclays,CitiBank Pune,94832,94994,-162
2010-01-01,Barclays,CitiBank Singapore,53312,52249,1063
2010-02-01,Barclays,CitiBank Singapore,59227,52444,6783
2010-03-01,Barclays,CitiBank Singapore,52744,52385,359
2010-04-01,Barclays,CitiBank Singapore,55412,54759,653
2010-05-01,Barclays,CitiBank Singapore,56895,57418,-523
2010-06-01,Barclays,CitiBank Singapore,53666,59221,-5555
2010-07-01,Barclays,CitiBank Singapore,51355,51963,-608
2010-08-01,Barclays,CitiBank Singapore,59262,59885,-623
2010-09-01,Barclays,CitiBank Singapore,51433,59826,-8393
2010-10-01,Barclays,CitiBank Singapore,55851,54279,1572
2010-11-01,Barclays,CitiBank Singapore,59367,56443,2924
2010-12-01,Barclays,CitiBank Singapore,57755,51464,6291
2011-01-01,Barclays,CitiBank Singapore,59123,59852,-729
2011-02-01,Barclays,CitiBank Singapore,55985,58618,-2633
2011-03-01,Barclays,CitiBank Singapore,56641,54627,2014
2011-04-01,Barclays,CitiBank Singapore,52323,51264,1059
2011-05-01,Barclays,CitiBank Singapore,56463,52163,4300
2011-06-01,Barclays,CitiBank Singapore,51924,55519,-3595
2011-07-01,Barclays,CitiBank Singapore,56743,51254,5489
2011-08-01,Barclays,CitiBank Singapore,53441,56192,-2751
2011-09-01,Barclays,CitiBank Singapore,63166,67678,-4512
2011-10-01,Barclays,CitiBank Singapore,68774,61972,6802
2011-11-01,Barclays,CitiBank Singapore,69928,64219,5709
2011-12-01,Barclays,CitiBank Singapore,69873,63544,6329
2012-01-01,Barclays,CitiBank Singapore,63361,66241,-2880
2012-02-01,Barclays,CitiBank Singapore,68624,68873,-249
2012-03-01,Barclays,CitiBank Singapore,65796,66446,-650
2012-04-01,Barclays,CitiBank Singapore,65748,62653,3095
2012-05-01,Barclays,CitiBank Singapore,64637,67369,-2732
2012-06-01,Barclays,CitiBank Singapore,63681,61585,2096
2012-07-01,Barclays,CitiBank Singapore,64639,64432,207
2012-08-01,Barclays,CitiBank Singapore,65865,61654,4211
2012-09-01,Barclays,CitiBank Singapore,63141,63189,-48
2012-10-01,Barclays,CitiBank Singapore,61639,69991,-8352
2012-11-01,Barclays,CitiBank Singapore,61523,63596,-2073
2012-12-01,Barclays,CitiBank Singapore,67493,63672,3821
2013-01-01,Barclays,CitiBank Singapore,65887,64225,1662
2013-02-01,Barclays,CitiBank Singapore,65571,67952,-2381
2013-03-01,Barclays,CitiBank Singapore,68442,67438,1004
2013-04-01,Barclays,CitiBank Singapore,69561,68111,1450
2013-05-01,Barclays,CitiBank Singapore,77867,77661,206
2013-06-01,Barclays,CitiBank Singapore,74228,74546,-318
2013-07-01,Barclays,CitiBank Singapore,79212,72978,6234
2013-08-01,Barclays,CitiBank Singapore,77266,76429,837
2013-09-01,Barclays,CitiBank Singapore,79562,74658,4904
2013-10-01,Barclays,CitiBank Singapore,77838,79432,-1594
2013-11-01,Barclays,CitiBank Singapore,75551,76262,-711
2013-12-01,Barclays,CitiBank Singapore,74988,73774,1214
2014-01-01,Barclays,CitiBank Singapore,73563,78144,-4581
2014-02-01,Barclays,CitiBank Singapore,72628,74912,-2284
2014-03-01,Barclays,CitiBank Singapore,77523,74629,2894
2014-04-01,Barclays,CitiBank Singapore,73694,73835,-141
2014-05-01,Barclays,CitiBank Singapore,71431,77742,-6311
2014-06-01,Barclays,CitiBank Singapore,77477,77918,-441
2014-07-01,Barclays,CitiBank Singapore,76159,77432,-1273
2014-08-01,Barclays,CitiBank Singapore,72369,77191,-4822
2014-09-01,Barclays,CitiBank Singapore,78866,74751,4115
2014-10-01,Barclays,CitiBank Singapore,72451,78451,-6000
2014-11-01,Barclays,CitiBank Singapore,78526,79687,-1161
2014-12-01,Barclays,CitiBank Singapore,76952,79223,-2271
2015-01-01,Barclays,CitiBank Singapore,84614,86197,-1583
2015-02-01,Barclays,CitiBank Singapore,85514,82335,3179
2015-03-01,Barclays,CitiBank Singapore,82857,85932,-3075
2015-04-01,Barclays,CitiBank Singapore,88414,84394,4020
2015-05-01,Barclays,CitiBank Singapore,87719,81627,6092
2015-06-01,Barclays,CitiBank Singapore,89461,81825,7636
2015-07-01,Barclays,CitiBank Singapore,82573,81125,1448
2015-08-01,Barclays,CitiBank Singapore,86989,81866,5123
2015-09-01,Barclays,CitiBank Singapore,89326,84331,4995
2015-10-01,Barclays,CitiBank Singapore,84691,88765,-4074
2015-11-01,Barclays,CitiBank Singapore,89258,83388,5870
2015-12-01,Barclays,CitiBank Singapore,88675,82853,5822
2016-01-01,Barclays,CitiBank Singapore,85881,88177,-2296
2016-02-01,Barclays,CitiBank Singapore,82129,82592,-463
2016-03-01,Barclays,CitiBank Singapore,84934,88314,-3380
2016-04-01,Barclays,CitiBank Singapore,87938,89235,-1297
2016-05-01,Barclays,CitiBank Singapore,85614,81839,3775
2016-06-01,Barclays,CitiBank Singapore,83187,84623,-1436
2016-07-01,Barclays,CitiBank Singapore,84744,86385,-1641
2016-08-01,Barclays,CitiBank Singapore,85427,89595,-4168
2016-09-01,Barclays,CitiBank Singapore,98882,91535,7347
2016-10-01,Barclays,CitiBank Singapore,99967,96561,3406
2016-11-01,Barclays,CitiBank Singapore,95455,94122,1333
2016-12-01,Barclays,CitiBank Singapore,95449,93195,2254
2017-01-01,Barclays,CitiBank Singapore,95884,92391,3493
2017-02-01,Barclays,CitiBank Singapore,94813,93326,1487
2017-03-01,Barclays,CitiBank Singapore,99238,91354,7884
2017-04-01,Barclays,CitiBank Singapore,94546,93461,1085
2017-05-01,Barclays,CitiBank Singapore,92334,98381,-6047
2017-06-01,Barclays,CitiBank Singapore,93861,95127,-1266
2017-07-01,Barclays,CitiBank Singapore,94598,92825,1773
2017-08-01,Barclays,CitiBank Singapore,96799,91943,4856
2017-09-01,Barclays,CitiBank Singapore,94587,96191,-1604
2017-10-01,Barclays,CitiBank Singapore,98356,98851,-495
2017-11-01,Barclays,CitiBank Singapore,99694,96325,3369
2017-12-01,Barclays,CitiBank Singapore,91987,94944,-2957
2018-01-01,Barclays,CitiBank Singapore,98577,98433,144
2018-02-01,Barclays,CitiBank Singapore,95298,94761,537
2018-03-01,Barclays,CitiBank Singapore,93474,93417,57
2018-04-01,Barclays,CitiBank Singapore,99656,91749,7907
2010-01-01,Barclays,CitiBank HongKong,52844,56445,-3601
2010-02-01,Barclays,CitiBank HongKong,57585,54133,3452
2010-03-01,Barclays,CitiBank HongKong,56978,51313,5665
2010-04-01,Barclays,CitiBank HongKong,55457,59276,-3819
2010-05-01,Barclays,CitiBank HongKong,57918,58815,-897
2010-06-01,Barclays,CitiBank HongKong,57283,56754,529
2010-07-01,Barclays,CitiBank HongKong,52221,54917,-2696
2010-08-01,Barclays,CitiBank HongKong,56661,59364,-2703
2010-09-01,Barclays,CitiBank HongKong,58735,52485,6250
2010-10-01,Barclays,CitiBank HongKong,55369,56939,-1570
2010-11-01,Barclays,CitiBank HongKong,59731,57911,1820
2010-12-01,Barclays,CitiBank HongKong,54396,53171,1225
2011-01-01,Barclays,CitiBank HongKong,51389,54828,-3439
2011-02-01,Barclays,CitiBank HongKong,58459,55842,2617
2011-03-01,Barclays,CitiBank HongKong,55586,58833,-3247
2011-04-01,Barclays,CitiBank HongKong,54751,58415,-3664
2011-05-01,Barclays,CitiBank HongKong,55614,59282,-3668
2011-06-01,Barclays,CitiBank HongKong,52475,52476,-1
2011-07-01,Barclays,CitiBank HongKong,51181,57668,-6487
2011-08-01,Barclays,CitiBank HongKong,58735,58396,339
2011-09-01,Barclays,CitiBank HongKong,63628,65248,-1620
2011-10-01,Barclays,CitiBank HongKong,62643,65856,-3213
2011-11-01,Barclays,CitiBank HongKong,67478,69646,-2168
2011-12-01,Barclays,CitiBank HongKong,68856,63136,5720
2012-01-01,Barclays,CitiBank HongKong,69997,63314,6683
2012-02-01,Barclays,CitiBank HongKong,61271,61415,-144
2012-03-01,Barclays,CitiBank HongKong,64264,66814,-2550
2012-04-01,Barclays,CitiBank HongKong,68856,67727,1129
2012-05-01,Barclays,CitiBank HongKong,67241,61483,5758
2012-06-01,Barclays,CitiBank HongKong,61479,61714,-235
2012-07-01,Barclays,CitiBank HongKong,65137,66227,-1090
2012-08-01,Barclays,CitiBank HongKong,68997,63837,5160
2012-09-01,Barclays,CitiBank HongKong,65323,62549,2774
2012-10-01,Barclays,CitiBank HongKong,65314,61661,3653
2012-11-01,Barclays,CitiBank HongKong,65842,67859,-2017
2012-12-01,Barclays,CitiBank HongKong,65678,62827,2851
2013-01-01,Barclays,CitiBank HongKong,68339,68251,88
2013-02-01,Barclays,CitiBank HongKong,62445,66224,-3779
2013-03-01,Barclays,CitiBank HongKong,61939,69475,-7536
2013-04-01,Barclays,CitiBank HongKong,69513,66196,3317
2013-05-01,Barclays,CitiBank HongKong,77544,72991,4553
2013-06-01,Barclays,CitiBank HongKong,79435,76216,3219
2013-07-01,Barclays,CitiBank HongKong,79444,76575,2869
2013-08-01,Barclays,CitiBank HongKong,76541,75212,1329
2013-09-01,Barclays,CitiBank HongKong,76255,74139,2116
2013-10-01,Barclays,CitiBank HongKong,76965,77188,-223
2013-11-01,Barclays,CitiBank HongKong,73224,76614,-3390
2013-12-01,Barclays,CitiBank HongKong,79864,76817,3047
2014-01-01,Barclays,CitiBank HongKong,76415,78774,-2359
2014-02-01,Barclays,CitiBank HongKong,74669,73328,1341
2014-03-01,Barclays,CitiBank HongKong,73931,78138,-4207
2014-04-01,Barclays,CitiBank HongKong,72453,76381,-3928
2014-05-01,Barclays,CitiBank HongKong,77941,78153,-212
2014-06-01,Barclays,CitiBank HongKong,79881,71846,8035
2014-07-01,Barclays,CitiBank HongKong,72372,74153,-1781
2014-08-01,Barclays,CitiBank HongKong,71492,75659,-4167
2014-09-01,Barclays,CitiBank HongKong,75415,71759,3656
2014-10-01,Barclays,CitiBank HongKong,78731,71336,7395
2014-11-01,Barclays,CitiBank HongKong,76878,76852,26
2014-12-01,Barclays,CitiBank HongKong,75125,73638,1487
2015-01-01,Barclays,CitiBank HongKong,87195,87939,-744
2015-02-01,Barclays,CitiBank HongKong,87574,82349,5225
2015-03-01,Barclays,CitiBank HongKong,84834,87144,-2310
2015-04-01,Barclays,CitiBank HongKong,88259,84771,3488
2015-05-01,Barclays,CitiBank HongKong,84987,84957,30
2015-06-01,Barclays,CitiBank HongKong,83195,86492,-3297
2015-07-01,Barclays,CitiBank HongKong,81146,83399,-2253
2015-08-01,Barclays,CitiBank HongKong,85219,88732,-3513
2015-09-01,Barclays,CitiBank HongKong,81249,89879,-8630
2015-10-01,Barclays,CitiBank HongKong,83942,89325,-5383
2015-11-01,Barclays,CitiBank HongKong,88642,86743,1899
2015-12-01,Barclays,CitiBank HongKong,87835,89334,-1499
2016-01-01,Barclays,CitiBank HongKong,87539,83659,3880
2016-02-01,Barclays,CitiBank HongKong,86639,84134,2505
2016-03-01,Barclays,CitiBank HongKong,86553,89849,-3296
2016-04-01,Barclays,CitiBank HongKong,89115,83576,5539
2016-05-01,Barclays,CitiBank HongKong,81482,85912,-4430
2016-06-01,Barclays,CitiBank HongKong,84615,87449,-2834
2016-07-01,Barclays,CitiBank HongKong,84336,81775,2561
2016-08-01,Barclays,CitiBank HongKong,89876,81352,8524
2016-09-01,Barclays,CitiBank HongKong,92274,98888,-6614
2016-10-01,Barclays,CitiBank HongKong,92791,97215,-4424
2016-11-01,Barclays,CitiBank HongKong,96362,96525,-163
2016-12-01,Barclays,CitiBank HongKong,94636,96659,-2023
2017-01-01,Barclays,CitiBank HongKong,92434,97353,-4919
2017-02-01,Barclays,CitiBank HongKong,99223,99368,-145
2017-03-01,Barclays,CitiBank HongKong,91512,91216,296
2017-04-01,Barclays,CitiBank HongKong,91376,94198,-2822
2017-05-01,Barclays,CitiBank HongKong,96789,92839,3950
2017-06-01,Barclays,CitiBank HongKong,98441,91488,6953
2017-07-01,Barclays,CitiBank HongKong,95753,97225,-1472
2017-08-01,Barclays,CitiBank HongKong,98291,98728,-437
2017-09-01,Barclays,CitiBank HongKong,98366,91794,6572
2017-10-01,Barclays,CitiBank HongKong,94835,92565,2270
2017-11-01,Barclays,CitiBank HongKong,99694,95497,4197
2017-12-01,Barclays,CitiBank HongKong,99165,97339,1826
2018-01-01,Barclays,CitiBank HongKong,91156,95823,-4667
2018-02-01,Barclays,CitiBank HongKong,94963,95234,-271
2018-03-01,Barclays,CitiBank HongKong,97235,93962,3273
2018-04-01,Barclays,CitiBank HongKong,97364,92118,5246
