Date,Client Name,Legal Entity,Received Amount,Delivered Amount,Net Amount
2010-01-01,HSBC,CitiBank New York,13998,92149,-78151
2010-02-01,HSBC,CitiBank New York,14149,96243,-82094
2010-03-01,HSBC,CitiBank New York,19256,97193,-77937
2010-04-01,HSBC,CitiBank New York,11625,93818,-82193
2010-05-01,HSBC,CitiBank New York,18239,99236,-80997
2010-06-01,HSBC,CitiBank New York,11853,96429,-84576
2010-07-01,HSBC,CitiBank New York,11294,98921,-87627
2010-08-01,HSBC,CitiBank New York,18366,91523,-73157
2010-09-01,HSBC,CitiBank New York,11677,92377,-80700
2010-10-01,HSBC,CitiBank New York,18954,96912,-77958
2010-11-01,HSBC,CitiBank New York,29926,92429,-62503
2010-12-01,HSBC,CitiBank New York,23319,96858,-73539
2011-01-01,HSBC,CitiBank New York,24398,97955,-73557
2011-02-01,HSBC,CitiBank New York,24876,96394,-71518
2011-03-01,HSBC,CitiBank New York,22635,99299,-76664
2011-04-01,HSBC,CitiBank New York,25661,95483,-69822
2011-05-01,HSBC,CitiBank New York,22778,94591,-71813
2011-06-01,HSBC,CitiBank New York,25915,92631,-66716
2011-07-01,HSBC,CitiBank New York,22561,92991,-70430
2011-08-01,HSBC,CitiBank New York,21819,96534,-74715
2011-09-01,HSBC,CitiBank New York,34636,86767,-52131
2011-10-01,HSBC,CitiBank New York,31912,83523,-51611
2011-11-01,HSBC,CitiBank New York,35434,84546,-49112
2011-12-01,HSBC,CitiBank New York,33184,83231,-50047
2012-01-01,HSBC,CitiBank New York,32418,86994,-54576
2012-02-01,HSBC,CitiBank New York,33886,89565,-55679
2012-03-01,HSBC,CitiBank New York,34426,82275,-47849
2012-04-01,HSBC,CitiBank New York,36489,84317,-47828
2012-05-01,HSBC,CitiBank New York,36889,87597,-50708
2012-06-01,HSBC,CitiBank New York,31967,86825,-54858
2012-07-01,HSBC,CitiBank New York,43996,83995,-39999
2012-08-01,HSBC,CitiBank New York,45445,87976,-42531
2012-09-01,HSBC,CitiBank New York,48923,89163,-40240
2012-10-01,HSBC,CitiBank New York,49545,86879,-37334
2012-11-01,HSBC,CitiBank New York,47351,85633,-38282
2012-12-01,HSBC,CitiBank New York,45512,84621,-39109
2013-01-01,HSBC,CitiBank New York,48775,88263,-39488
2013-02-01,HSBC,CitiBank New York,46422,83172,-36750
2013-03-01,HSBC,CitiBank New York,46848,85632,-38784
2013-04-01,HSBC,CitiBank New York,42663,84112,-41449
2013-05-01,HSBC,CitiBank New York,55276,72837,-17561
2013-06-01,HSBC,CitiBank New York,57892,71536,-13644
2013-07-01,HSBC,CitiBank New York,56637,72474,-15837
2013-08-01,HSBC,CitiBank New York,58394,77918,-19524
2013-09-01,HSBC,CitiBank New York,57781,77738,-19957
2013-10-01,HSBC,CitiBank New York,56526,73592,-17066
2013-11-01,HSBC,CitiBank New York,52817,78437,-25620
2013-12-01,HSBC,CitiBank New York,55967,73491,-17524
2014-01-01,HSBC,CitiBank New York,53381,75913,-22532
2014-02-01,HSBC,CitiBank New York,51563,77333,-25770
2014-03-01,HSBC,CitiBank New York,61587,71928,-10341
2014-04-01,HSBC,CitiBank New York,69921,76515,-6594
2014-05-01,HSBC,CitiBank New York,67261,77768,-10507
2014-06-01,HSBC,CitiBank New York,62146,71418,-9272
2014-07-01,HSBC,CitiBank New York,64638,75734,-11096
2014-08-01,HSBC,CitiBank New York,65966,74958,-8992
2014-09-01,HSBC,CitiBank New York,63158,75629,-12471
2014-10-01,HSBC,CitiBank New York,64726,78199,-13473
2014-11-01,HSBC,CitiBank New York,67733,72175,-4442
2014-12-01,HSBC,CitiBank New York,65269,78713,-13444
2015-01-01,HSBC,CitiBank New York,73277,67817,5460
2015-02-01,HSBC,CitiBank New York,73358,67876,5482
2015-03-01,HSBC,CitiBank New York,71974,66231,5743
2015-04-01,HSBC,CitiBank New York,76538,65581,10957
2015-05-01,HSBC,CitiBank New York,72115,66715,5400
2015-06-01,HSBC,CitiBank New York,76499,61335,15164
2015-07-01,HSBC,CitiBank New York,78729,64738,13991
2015-08-01,HSBC,CitiBank New York,78283,67843,10440
2015-09-01,HSBC,CitiBank New York,71257,69125,2132
2015-10-01,HSBC,CitiBank New York,71987,63396,8591
2015-11-01,HSBC,CitiBank New York,85586,63267,22319
2015-12-01,HSBC,CitiBank New York,82811,62713,20098
2016-01-01,HSBC,CitiBank New York,86912,67271,19641
2016-02-01,HSBC,CitiBank New York,83581,63217,20364
2016-03-01,HSBC,CitiBank New York,84173,66127,18046
2016-04-01,HSBC,CitiBank New York,88424,66261,22163
2016-05-01,HSBC,CitiBank New York,85435,65888,19547
2016-06-01,HSBC,CitiBank New York,84598,68293,16305
2016-07-01,HSBC,CitiBank New York,84921,66663,18258
2016-08-01,HSBC,CitiBank New York,84231,68872,15359
2016-09-01,HSBC,CitiBank New York,94739,57981,36758
2016-10-01,HSBC,CitiBank New York,93786,57927,35859
2016-11-01,HSBC,CitiBank New York,98196,59245,38951
2016-12-01,HSBC,CitiBank New York,92714,58817,33897
2017-01-01,HSBC,CitiBank New York,99915,52764,47151
2017-02-01,HSBC,CitiBank New York,92295,52193,40102
2017-03-01,HSBC,CitiBank New York,96415,52851,43564
2017-04-01,HSBC,CitiBank New York,94298,55544,38754
2017-05-01,HSBC,CitiBank New York,91991,56451,35540
2017-06-01,HSBC,CitiBank New York,91832,56791,35041
2017-07-01,HSBC,CitiBank New York,104155,52376,51779
2017-08-01,HSBC,CitiBank New York,109137,59564,49573
2017-09-01,HSBC,CitiBank New York,106628,56841,49787
2017-10-01,HSBC,CitiBank New York,108471,54916,53555
2017-11-01,HSBC,CitiBank New York,104624,59365,45259
2017-12-01,HSBC,CitiBank New York,105651,51985,53666
2018-01-01,HSBC,CitiBank New York,101962,53541,48421
2018-02-01,HSBC,CitiBank New York,101266,55265,46001
2018-03-01,HSBC,CitiBank New York,108548,56259,52289
2018-04-01,HSBC,CitiBank New York,103818,54176,49642
2010-01-01,HSBC,CitiBank London,17639,94556,-76917
2010-02-01,HSBC,CitiBank London,11366,93171,-81805
2010-03-01,HSBC,CitiBank London,18431,98115,-79684
2010-04-01,HSBC,CitiBank London,14611,92315,-77704
2010-05-01,HSBC,CitiBank London,15647,93371,-77724
2010-06-01,HSBC,CitiBank London,17869,91215,-73346
2010-07-01,HSBC,CitiBank London,15314,95933,-80619
2010-08-01,HSBC,CitiBank London,16426,93162,-76736
2010-09-01,HSBC,CitiBank London,16967,91719,-74752
2010-10-01,HSBC,CitiBank London,16676,91718,-75042
2010-11-01,HSBC,CitiBank London,26627,99878,-73251
2010-12-01,HSBC,CitiBank London,28613,93547,-64934
2011-01-01,HSBC,CitiBank London,24641,96959,-72318
2011-02-01,HSBC,CitiBank London,21191,99669,-78478
2011-03-01,HSBC,CitiBank London,25397,94416,-69019
2011-04-01,HSBC,CitiBank London,23915,97496,-73581
2011-05-01,HSBC,CitiBank London,29659,96578,-66919
2011-06-01,HSBC,CitiBank London,26827,98844,-72017
2011-07-01,HSBC,CitiBank London,21942,98871,-76929
2011-08-01,HSBC,CitiBank London,22269,91424,-69155
2011-09-01,HSBC,CitiBank London,32682,89381,-56699
2011-10-01,HSBC,CitiBank London,33635,88196,-54561
2011-11-01,HSBC,CitiBank London,35761,86371,-50610
2011-12-01,HSBC,CitiBank London,37294,88947,-51653
2012-01-01,HSBC,CitiBank London,31686,88846,-57160
2012-02-01,HSBC,CitiBank London,33636,87745,-54109
2012-03-01,HSBC,CitiBank London,32956,88348,-55392
2012-04-01,HSBC,CitiBank London,38536,81726,-43190
2012-05-01,HSBC,CitiBank London,35653,88832,-53179
2012-06-01,HSBC,CitiBank London,32778,84529,-51751
2012-07-01,HSBC,CitiBank London,47439,86495,-39056
2012-08-01,HSBC,CitiBank London,45978,87314,-41336
2012-09-01,HSBC,CitiBank London,44183,88422,-44239
2012-10-01,HSBC,CitiBank London,44613,88919,-44306
2012-11-01,HSBC,CitiBank London,45444,81317,-35873
2012-12-01,HSBC,CitiBank London,42533,88914,-46381
2013-01-01,HSBC,CitiBank London,45717,83256,-37539
2013-02-01,HSBC,CitiBank London,45119,82732,-37613
2013-03-01,HSBC,CitiBank London,45327,84527,-39200
2013-04-01,HSBC,CitiBank London,47215,84797,-37582
2013-05-01,HSBC,CitiBank London,55368,73344,-17976
2013-06-01,HSBC,CitiBank London,51395,76645,-25250
2013-07-01,HSBC,CitiBank London,55953,79161,-23208
2013-08-01,HSBC,CitiBank London,52246,79838,-27592
2013-09-01,HSBC,CitiBank London,59693,75333,-15640
2013-10-01,HSBC,CitiBank London,55649,75454,-19805
2013-11-01,HSBC,CitiBank London,52788,71225,-18437
2013-12-01,HSBC,CitiBank London,57242,76984,-19742
2014-01-01,HSBC,CitiBank London,59385,71143,-11758
2014-02-01,HSBC,CitiBank London,55425,77641,-22216
2014-03-01,HSBC,CitiBank London,68432,79795,-11363
2014-04-01,HSBC,CitiBank London,66629,73776,-7147
2014-05-01,HSBC,CitiBank London,63142,78222,-15080
2014-06-01,HSBC,CitiBank London,68342,72149,-3807
2014-07-01,HSBC,CitiBank London,63387,77348,-13961
2014-08-01,HSBC,CitiBank London,66783,79292,-12509
2014-09-01,HSBC,CitiBank London,67118,75272,-8154
2014-10-01,HSBC,CitiBank London,64273,75536,-11263
2014-11-01,HSBC,CitiBank London,68628,71246,-2618
2014-12-01,HSBC,CitiBank London,61122,77737,-16615
2015-01-01,HSBC,CitiBank London,78777,64511,14266
2015-02-01,HSBC,CitiBank London,73662,64495,9167
2015-03-01,HSBC,CitiBank London,75481,66116,9365
2015-04-01,HSBC,CitiBank London,71938,63125,8813
2015-05-01,HSBC,CitiBank London,73873,65996,7877
2015-06-01,HSBC,CitiBank London,78159,68566,9593
2015-07-01,HSBC,CitiBank London,72964,61746,11218
2015-08-01,HSBC,CitiBank London,73369,67596,5773
2015-09-01,HSBC,CitiBank London,77338,67686,9652
2015-10-01,HSBC,CitiBank London,75282,67325,7957
2015-11-01,HSBC,CitiBank London,84314,62862,21452
2015-12-01,HSBC,CitiBank London,82113,67757,14356
2016-01-01,HSBC,CitiBank London,87974,66725,21249
2016-02-01,HSBC,CitiBank London,89823,63321,26502
2016-03-01,HSBC,CitiBank London,89198,66519,22679
2016-04-01,HSBC,CitiBank London,82353,67825,14528
2016-05-01,HSBC,CitiBank London,83877,64249,19628
2016-06-01,HSBC,CitiBank London,85658,65492,20166
2016-07-01,HSBC,CitiBank London,85235,65388,19847
2016-08-01,HSBC,CitiBank London,84734,65647,19087
2016-09-01,HSBC,CitiBank London,98184,54232,43952
2016-10-01,HSBC,CitiBank London,91426,56635,34791
2016-11-01,HSBC,CitiBank London,95954,52752,43202
2016-12-01,HSBC,CitiBank London,98514,59546,38968
2017-01-01,HSBC,CitiBank London,97722,55628,42094
2017-02-01,HSBC,CitiBank London,96894,53137,43757
2017-03-01,HSBC,CitiBank London,91196,52529,38667
2017-04-01,HSBC,CitiBank London,98927,58677,40250
2017-05-01,HSBC,CitiBank London,96344,57869,38475
2017-06-01,HSBC,CitiBank London,99467,57295,42172
2017-07-01,HSBC,CitiBank London,101579,56996,44583
2017-08-01,HSBC,CitiBank London,107917,53458,54459
2017-09-01,HSBC,CitiBank London,105358,51153,54205
2017-10-01,HSBC,CitiBank London,102321,55814,46507
2017-11-01,HSBC,CitiBank London,106774,59417,47357
2017-12-01,HSBC,CitiBank London,102886,56199,46687
2018-01-01,HSBC,CitiBank London,102443,59312,43131
2018-02-01,HSBC,CitiBank London,106982,55334,51648
2018-03-01,HSBC,CitiBank London,106738,59514,47224
2018-04-01,HSBC,CitiBank London,107558,51616,55942
2010-01-01,HSBC,CitiBank Pune,18163,94137,-75974
2010-02-01,HSBC,CitiBank Pune,13828,96115,-82287
2010-03-01,HSBC,CitiBank Pune,11991,91861,-79870
2010-04-01,HSBC,CitiBank Pune,13596,95953,-82357
2010-05-01,HSBC,CitiBank Pune,12875,99879,-87004
2010-06-01,HSBC,CitiBank Pune,15473,92762,-77289
2010-07-01,HSBC,CitiBank Pune,12119,97854,-85735
2010-08-01,HSBC,CitiBank Pune,11455,95789,-84334
2010-09-01,HSBC,CitiBank Pune,13832,93684,-79852
2010-10-01,HSBC,CitiBank Pune,19355,99755,-80400
2010-11-01,HSBC,CitiBank Pune,21141,93912,-72771
2010-12-01,HSBC,CitiBank Pune,26659,97862,-71203
2011-01-01,HSBC,CitiBank Pune,28488,93887,-65399
2011-02-01,HSBC,CitiBank Pune,24343,91468,-67125
2011-03-01,HSBC,CitiBank Pune,24667,97635,-72968
2011-04-01,HSBC,CitiBank Pune,27423,98984,-71561
2011-05-01,HSBC,CitiBank Pune,28567,93485,-64918
2011-06-01,HSBC,CitiBank Pune,28296,93396,-65100
2011-07-01,HSBC,CitiBank Pune,26975,99494,-72519
2011-08-01,HSBC,CitiBank Pune,25749,91411,-65662
2011-09-01,HSBC,CitiBank Pune,32753,88999,-56246
2011-10-01,HSBC,CitiBank Pune,33589,83841,-50252
2011-11-01,HSBC,CitiBank Pune,38277,87783,-49506
2011-12-01,HSBC,CitiBank Pune,33535,81813,-48278
2012-01-01,HSBC,CitiBank Pune,31291,87147,-55856
2012-02-01,HSBC,CitiBank Pune,31458,85877,-54419
2012-03-01,HSBC,CitiBank Pune,34752,89749,-54997
2012-04-01,HSBC,CitiBank Pune,37639,88195,-50556
2012-05-01,HSBC,CitiBank Pune,35725,89872,-54147
2012-06-01,HSBC,CitiBank Pune,33852,89231,-55379
2012-07-01,HSBC,CitiBank Pune,46249,87937,-41688
2012-08-01,HSBC,CitiBank Pune,49843,86149,-36306
2012-09-01,HSBC,CitiBank Pune,42936,84425,-41489
2012-10-01,HSBC,CitiBank Pune,46876,87213,-40337
2012-11-01,HSBC,CitiBank Pune,42969,87766,-44797
2012-12-01,HSBC,CitiBank Pune,49134,85182,-36048
2013-01-01,HSBC,CitiBank Pune,41463,87981,-46518
2013-02-01,HSBC,CitiBank Pune,45353,85551,-40198
2013-03-01,HSBC,CitiBank Pune,42951,89673,-46722
2013-04-01,HSBC,CitiBank Pune,41617,87187,-45570
2013-05-01,HSBC,CitiBank Pune,58692,77742,-19050
2013-06-01,HSBC,CitiBank Pune,51927,79481,-27554
2013-07-01,HSBC,CitiBank Pune,57165,73997,-16832
2013-08-01,HSBC,CitiBank Pune,59929,76233,-16304
2013-09-01,HSBC,CitiBank Pune,51242,74562,-23320
2013-10-01,HSBC,CitiBank Pune,52684,73656,-20972
2013-11-01,HSBC,CitiBank Pune,58769,72232,-13463
2013-12-01,HSBC,CitiBank Pune,53115,79455,-26340
2014-01-01,HSBC,CitiBank Pune,53231,79833,-26602
2014-02-01,HSBC,CitiBank Pune,55356,75187,-19831
2014-03-01,HSBC,CitiBank Pune,62366,72684,-10318
2014-04-01,HSBC,CitiBank Pune,65698,74391,-8693
2014-05-01,HSBC,CitiBank Pune,66393,77148,-10755
2014-06-01,HSBC,CitiBank Pune,63259,79868,-16609
2014-07-01,HSBC,CitiBank Pune,63295,74468,-11173
2014-08-01,HSBC,CitiBank Pune,62113,77219,-15106
2014-09-01,HSBC,CitiBank Pune,64236,76994,-12758
2014-10-01,HSBC,CitiBank Pune,64876,73685,-8809
2014-11-01,HSBC,CitiBank Pune,68848,77998,-9150
2014-12-01,HSBC,CitiBank Pune,67487,75799,-8312
2015-01-01,HSBC,CitiBank Pune,76682,69148,7534
2015-02-01,HSBC,CitiBank Pune,75557,61387,14170
2015-03-01,HSBC,CitiBank Pune,78186,65269,12917
2015-04-01,HSBC,CitiBank Pune,74595,65612,8983
2015-05-01,HSBC,CitiBank Pune,73648,68938,4710
2015-06-01,HSBC,CitiBank Pune,76734,64214,12520
2015-07-01,HSBC,CitiBank Pune,78169,63229,14940
2015-08-01,HSBC,CitiBank Pune,79174,64395,14779
2015-09-01,HSBC,CitiBank Pune,75256,63415,11841
2015-10-01,HSBC,CitiBank Pune,78929,69743,9186
2015-11-01,HSBC,CitiBank Pune,82914,64226,18688
2015-12-01,HSBC,CitiBank Pune,87777,65762,22015
2016-01-01,HSBC,CitiBank Pune,89285,61283,28002
2016-02-01,HSBC,CitiBank Pune,84636,64858,19778
2016-03-01,HSBC,CitiBank Pune,88178,65645,22533
2016-04-01,HSBC,CitiBank Pune,86661,63213,23448
2016-05-01,HSBC,CitiBank Pune,84614,64279,20335
2016-06-01,HSBC,CitiBank Pune,87749,69398,18351
2016-07-01,HSBC,CitiBank Pune,84459,63763,20696
2016-08-01,HSBC,CitiBank Pune,86249,62787,23462
2016-09-01,HSBC,CitiBank Pune,94961,55617,39344
2016-10-01,HSBC,CitiBank Pune,95156,56497,38659
2016-11-01,HSBC,CitiBank Pune,91681,53218,38463
2016-12-01,HSBC,CitiBank Pune,99485,51314,48171
2017-01-01,HSBC,CitiBank Pune,97518,58459,39059
2017-02-01,HSBC,CitiBank Pune,96219,52217,44002
2017-03-01,HSBC,CitiBank Pune,95765,53971,41794
2017-04-01,HSBC,CitiBank Pune,94196,57665,36531
2017-05-01,HSBC,CitiBank Pune,91923,57393,34530
2017-06-01,HSBC,CitiBank Pune,99447,56324,43123
2017-07-01,HSBC,CitiBank Pune,104477,56732,47745
2017-08-01,HSBC,CitiBank Pune,109888,58396,51492
2017-09-01,HSBC,CitiBank Pune,107316,53211,54105
2017-10-01,HSBC,CitiBank Pune,105159,54356,50803
2017-11-01,HSBC,CitiBank Pune,106677,52527,54150
2017-12-01,HSBC,CitiBank Pune,105332,52237,53095
2018-01-01,HSBC,CitiBank Pune,105366,54513,50853
2018-02-01,HSBC,CitiBank Pune,104276,56216,48060
2018-03-01,HSBC,CitiBank Pune,106818,52837,53981
2018-04-01,HSBC,CitiBank Pune,102798,52221,50577
2010-01-01,HSBC,CitiBank Singapore,12824,96348,-83524
2010-02-01,HSBC,CitiBank Singapore,14543,98646,-84103
2010-03-01,HSBC,CitiBank Singapore,18946,98679,-79733
2010-04-01,HSBC,CitiBank Singapore,16832,92286,-75454
2010-05-01,HSBC,CitiBank Singapore,13333,98916,-85583
2010-06-01,HSBC,CitiBank Singapore,11667,97723,-86056
2010-07-01,HSBC,CitiBank Singapore,14322,96832,-82510
2010-08-01,HSBC,CitiBank Singapore,19243,97837,-78594
2010-09-01,HSBC,CitiBank Singapore,18979,95749,-76770
2010-10-01,HSBC,CitiBank Singapore,12726,92127,-79401
2010-11-01,HSBC,CitiBank Singapore,24745,99584,-74839
2010-12-01,HSBC,CitiBank Singapore,25385,97173,-71788
2011-01-01,HSBC,CitiBank Singapore,25588,99231,-73643
2011-02-01,HSBC,CitiBank Singapore,29555,97288,-67733
2011-03-01,HSBC,CitiBank Singapore,29459,96668,-67209
2011-04-01,HSBC,CitiBank Singapore,21737,96826,-75089
2011-05-01,HSBC,CitiBank Singapore,21285,96644,-75359
2011-06-01,HSBC,CitiBank Singapore,28394,92958,-64564
2011-07-01,HSBC,CitiBank Singapore,27349,97455,-70106
2011-08-01,HSBC,CitiBank Singapore,23923,93961,-70038
2011-09-01,HSBC,CitiBank Singapore,34926,83888,-48962
2011-10-01,HSBC,CitiBank Singapore,31846,87235,-55389
2011-11-01,HSBC,CitiBank Singapore,33198,86324,-53126
2011-12-01,HSBC,CitiBank Singapore,32359,83785,-51426
2012-01-01,HSBC,CitiBank Singapore,31239,82585,-51346
2012-02-01,HSBC,CitiBank Singapore,34278,81857,-47579
2012-03-01,HSBC,CitiBank Singapore,37386,87175,-49789
2012-04-01,HSBC,CitiBank Singapore,37761,89123,-51362
2012-05-01,HSBC,CitiBank Singapore,31548,89799,-58251
2012-06-01,HSBC,CitiBank Singapore,37422,83751,-46329
2012-07-01,HSBC,CitiBank Singapore,47697,89795,-42098
2012-08-01,HSBC,CitiBank Singapore,43447,88795,-45348
2012-09-01,HSBC,CitiBank Singapore,41474,89349,-47875
2012-10-01,HSBC,CitiBank Singapore,44516,81373,-36857
2012-11-01,HSBC,CitiBank Singapore,44922,85954,-41032
2012-12-01,HSBC,CitiBank Singapore,42627,81691,-39064
2013-01-01,HSBC,CitiBank Singapore,43267,87856,-44589
2013-02-01,HSBC,CitiBank Singapore,42674,83239,-40565
2013-03-01,HSBC,CitiBank Singapore,48539,87998,-39459
2013-04-01,HSBC,CitiBank Singapore,41759,84884,-43125
2013-05-01,HSBC,CitiBank Singapore,57285,78271,-20986
2013-06-01,HSBC,CitiBank Singapore,59353,72934,-13581
2013-07-01,HSBC,CitiBank Singapore,53486,71862,-18376
2013-08-01,HSBC,CitiBank Singapore,59539,77844,-18305
2013-09-01,HSBC,CitiBank Singapore,56147,79978,-23831
2013-10-01,HSBC,CitiBank Singapore,55171,76554,-21383
2013-11-01,HSBC,CitiBank Singapore,56387,71482,-15095
2013-12-01,HSBC,CitiBank Singapore,54816,73397,-18581
2014-01-01,HSBC,CitiBank Singapore,59481,75784,-16303
2014-02-01,HSBC,CitiBank Singapore,56156,73222,-17066
2014-03-01,HSBC,CitiBank Singapore,66572,74811,-8239
2014-04-01,HSBC,CitiBank Singapore,61524,75313,-13789
2014-05-01,HSBC,CitiBank Singapore,62136,78581,-16445
2014-06-01,HSBC,CitiBank Singapore,69321,74522,-5201
2014-07-01,HSBC,CitiBank Singapore,69822,71892,-2070
2014-08-01,HSBC,CitiBank Singapore,63779,73552,-9773
2014-09-01,HSBC,CitiBank Singapore,63988,71218,-7230
2014-10-01,HSBC,CitiBank Singapore,64521,77878,-13357
2014-11-01,HSBC,CitiBank Singapore,64193,78466,-14273
2014-12-01,HSBC,CitiBank Singapore,64585,74656,-10071
2015-01-01,HSBC,CitiBank Singapore,79549,66414,13135
2015-02-01,HSBC,CitiBank Singapore,75625,62861,12764
2015-03-01,HSBC,CitiBank Singapore,74861,66474,8387
2015-04-01,HSBC,CitiBank Singapore,72874,61178,11696
2015-05-01,HSBC,CitiBank Singapore,73923,62249,11674
2015-06-01,HSBC,CitiBank Singapore,74499,66165,8334
2015-07-01,HSBC,CitiBank Singapore,72596,64671,7925
2015-08-01,HSBC,CitiBank Singapore,73621,62261,11360
2015-09-01,HSBC,CitiBank Singapore,71557,62316,9241
2015-10-01,HSBC,CitiBank Singapore,79384,61576,17808
2015-11-01,HSBC,CitiBank Singapore,87252,69481,17771
2015-12-01,HSBC,CitiBank Singapore,81835,66244,15591
2016-01-01,HSBC,CitiBank Singapore,86411,65737,20674
2016-02-01,HSBC,CitiBank Singapore,85378,65245,20133
2016-03-01,HSBC,CitiBank Singapore,85419,62357,23062
2016-04-01,HSBC,CitiBank Singapore,89999,68428,21571
2016-05-01,HSBC,CitiBank Singapore,87811,69374,18437
2016-06-01,HSBC,CitiBank Singapore,86861,67573,19288
2016-07-01,HSBC,CitiBank Singapore,87824,62856,24968
2016-08-01,HSBC,CitiBank Singapore,89775,63731,26044
2016-09-01,HSBC,CitiBank Singapore,91367,52182,39185
2016-10-01,HSBC,CitiBank Singapore,99789,58518,41271
2016-11-01,HSBC,CitiBank Singapore,95285,57468,37817
2016-12-01,HSBC,CitiBank Singapore,93217,59989,33228
2017-01-01,HSBC,CitiBank Singapore,97384,58166,39218
2017-02-01,HSBC,CitiBank Singapore,95499,52515,42984
2017-03-01,HSBC,CitiBank Singapore,97556,55155,42401
2017-04-01,HSBC,CitiBank Singapore,91316,57422,33894
2017-05-01,HSBC,CitiBank Singapore,96164,52676,43488
2017-06-01,HSBC,CitiBank Singapore,92624,57899,34725
2017-07-01,HSBC,CitiBank Singapore,101711,58922,42789
2017-08-01,HSBC,CitiBank Singapore,109318,51499,57819
2017-09-01,HSBC,CitiBank Singapore,105145,58151,46994
2017-10-01,HSBC,CitiBank Singapore,107165,57562,49603
2017-11-01,HSBC,CitiBank Singapore,104978,58166,46812
2017-12-01,HSBC,CitiBank Singapore,105183,52818,52365
2018-01-01,HSBC,CitiBank Singapore,103296,54349,48947
2018-02-01,HSBC,CitiBank Singapore,102237,54276,47961
2018-03-01,HSBC,CitiBank Singapore,103248,53632,49616
2018-04-01,HSBC,CitiBank Singapore,101289,54793,46496
2010-01-01,HSBC,CitiBank HongKong,15455,96411,-80956
2010-02-01,HSBC,CitiBank HongKong,12698,94161,-81463
2010-03-01,HSBC,CitiBank HongKong,18222,98684,-80462
2010-04-01,HSBC,CitiBank HongKong,15348,91537,-76189
2010-05-01,HSBC,CitiBank HongKong,14591,98631,-84040
2010-06-01,HSBC,CitiBank HongKong,13151,98917,-85766
2010-07-01,HSBC,CitiBank HongKong,11782,99296,-87514
2010-08-01,HSBC,CitiBank HongKong,14598,94927,-80329
2010-09-01,HSBC,CitiBank HongKong,18222,91855,-73633
2010-10-01,HSBC,CitiBank HongKong,11824,93754,-81930
2010-11-01,HSBC,CitiBank HongKong,28328,92786,-64458
2010-12-01,HSBC,CitiBank HongKong,25871,91434,-65563
2011-01-01,HSBC,CitiBank HongKong,29757,91112,-61355
2011-02-01,HSBC,CitiBank HongKong,26855,98132,-71277
2011-03-01,HSBC,CitiBank HongKong,23277,92857,-69580
2011-04-01,HSBC,CitiBank HongKong,25814,97742,-71928
2011-05-01,HSBC,CitiBank HongKong,21457,95553,-74096
2011-06-01,HSBC,CitiBank HongKong,24994,92919,-67925
2011-07-01,HSBC,CitiBank HongKong,27645,96794,-69149
2011-08-01,HSBC,CitiBank HongKong,28436,94888,-66452
2011-09-01,HSBC,CitiBank HongKong,34254,82218,-47964
2011-10-01,HSBC,CitiBank HongKong,34453,86349,-51896
2011-11-01,HSBC,CitiBank HongKong,31795,82477,-50682
2011-12-01,HSBC,CitiBank HongKong,39824,82873,-43049
2012-01-01,HSBC,CitiBank HongKong,34257,87646,-53389
2012-02-01,HSBC,CitiBank HongKong,34671,81597,-46926
2012-03-01,HSBC,CitiBank HongKong,39895,82816,-42921
2012-04-01,HSBC,CitiBank HongKong,34634,83143,-48509
2012-05-01,HSBC,CitiBank HongKong,37393,88362,-50969
2012-06-01,HSBC,CitiBank HongKong,39399,86589,-47190
2012-07-01,HSBC,CitiBank HongKong,42661,81522,-38861
2012-08-01,HSBC,CitiBank HongKong,42614,82763,-40149
2012-09-01,HSBC,CitiBank HongKong,45413,88756,-43343
2012-10-01,HSBC,CitiBank HongKong,42126,85741,-43615
2012-11-01,HSBC,CitiBank HongKong,43929,81516,-37587
2012-12-01,HSBC,CitiBank HongKong,44315,84264,-39949
2013-01-01,HSBC,CitiBank HongKong,49864,87345,-37481
2013-02-01,HSBC,CitiBank HongKong,45491,81316,-35825
2013-03-01,HSBC,CitiBank HongKong,46374,89597,-43223
2013-04-01,HSBC,CitiBank HongKong,47745,87168,-39423
2013-05-01,HSBC,CitiBank HongKong,55392,78755,-23363
2013-06-01,HSBC,CitiBank HongKong,59569,77594,-18025
2013-07-01,HSBC,CitiBank HongKong,54118,71245,-17127
2013-08-01,HSBC,CitiBank HongKong,54966,75458,-20492
2013-09-01,HSBC,CitiBank HongKong,51337,71918,-20581
2013-10-01,HSBC,CitiBank HongKong,51717,76249,-24532
2013-11-01,HSBC,CitiBank HongKong,57172,75599,-18427
2013-12-01,HSBC,CitiBank HongKong,51556,78925,-27369
2014-01-01,HSBC,CitiBank HongKong,51326,78879,-27553
2014-02-01,HSBC,CitiBank HongKong,57687,78835,-21148
2014-03-01,HSBC,CitiBank HongKong,63363,73622,-10259
2014-04-01,HSBC,CitiBank HongKong,68629,72831,-4202
2014-05-01,HSBC,CitiBank HongKong,65854,76684,-10830
2014-06-01,HSBC,CitiBank HongKong,66618,71521,-4903
2014-07-01,HSBC,CitiBank HongKong,68566,75622,-7056
2014-08-01,HSBC,CitiBank HongKong,62391,73853,-11462
2014-09-01,HSBC,CitiBank HongKong,61541,76484,-14943
2014-10-01,HSBC,CitiBank HongKong,67568,73443,-5875
2014-11-01,HSBC,CitiBank HongKong,62745,75544,-12799
2014-12-01,HSBC,CitiBank HongKong,69357,79775,-10418
2015-01-01,HSBC,CitiBank HongKong,78458,62667,15791
2015-02-01,HSBC,CitiBank HongKong,78259,68447,9812
2015-03-01,HSBC,CitiBank HongKong,77344,64126,13218
2015-04-01,HSBC,CitiBank HongKong,75161,69245,5916
2015-05-01,HSBC,CitiBank HongKong,78964,68218,10746
2015-06-01,HSBC,CitiBank HongKong,75954,63875,12079
2015-07-01,HSBC,CitiBank HongKong,77488,67234,10254
2015-08-01,HSBC,CitiBank HongKong,77596,68313,9283
2015-09-01,HSBC,CitiBank HongKong,75126,65666,9460
2015-10-01,HSBC,CitiBank HongKong,77625,67935,9690
2015-11-01,HSBC,CitiBank HongKong,86427,67329,19098
2015-12-01,HSBC,CitiBank HongKong,88781,63674,25107
2016-01-01,HSBC,CitiBank HongKong,83979,69981,13998
2016-02-01,HSBC,CitiBank HongKong,87438,61195,26243
2016-03-01,HSBC,CitiBank HongKong,84567,65641,18926
2016-04-01,HSBC,CitiBank HongKong,85384,68869,16515
2016-05-01,HSBC,CitiBank HongKong,88688,67287,21401
2016-06-01,HSBC,CitiBank HongKong,85217,61114,24103
2016-07-01,HSBC,CitiBank HongKong,84832,64519,20313
2016-08-01,HSBC,CitiBank HongKong,83352,68936,14416
2016-09-01,HSBC,CitiBank HongKong,91583,53259,38324
2016-10-01,HSBC,CitiBank HongKong,99339,52738,46601
2016-11-01,HSBC,CitiBank HongKong,91569,57571,33998
2016-12-01,HSBC,CitiBank HongKong,97837,54453,43384
2017-01-01,HSBC,CitiBank HongKong,94193,56542,37651
2017-02-01,HSBC,CitiBank HongKong,93675,59286,34389
2017-03-01,HSBC,CitiBank HongKong,92694,55879,36815
2017-04-01,HSBC,CitiBank HongKong,98194,58381,39813
2017-05-01,HSBC,CitiBank HongKong,97326,56936,40390
2017-06-01,HSBC,CitiBank HongKong,92356,51865,40491
2017-07-01,HSBC,CitiBank HongKong,107249,58596,48653
2017-08-01,HSBC,CitiBank HongKong,106697,57832,48865
2017-09-01,HSBC,CitiBank HongKong,102863,53537,49326
2017-10-01,HSBC,CitiBank HongKong,109187,51998,57189
2017-11-01,HSBC,CitiBank HongKong,108772,58465,50307
2017-12-01,HSBC,CitiBank HongKong,109173,58282,50891
2018-01-01,HSBC,CitiBank HongKong,107989,51548,56441
2018-02-01,HSBC,CitiBank HongKong,108244,54432,53812
2018-03-01,HSBC,CitiBank HongKong,106388,56552,49836
2018-04-01,HSBC,CitiBank HongKong,101271,53333,47938
2010-01-01,BNY Mellon,CitiBank New York,16799,94389,-77590
2010-02-01,BNY Mellon,CitiBank New York,13711,95416,-81705
2010-03-01,BNY Mellon,CitiBank New York,15379,97137,-81758
2010-04-01,BNY Mellon,CitiBank New York,18597,95881,-77284
2010-05-01,BNY Mellon,CitiBank New York,17521,93438,-75917
2010-06-01,BNY Mellon,CitiBank New York,12525,96161,-83636
2010-07-01,BNY Mellon,CitiBank New York,16723,99276,-82553
2010-08-01,BNY Mellon,CitiBank New York,16448,94734,-78286
2010-09-01,BNY Mellon,CitiBank New York,12245,98295,-86050
2010-10-01,BNY Mellon,CitiBank New York,15932,91391,-75459
2010-11-01,BNY Mellon,CitiBank New York,22489,93521,-71032
2010-12-01,BNY Mellon,CitiBank New York,23764,95425,-71661
2011-01-01,BNY Mellon,CitiBank New York,22425,94553,-72128
2011-02-01,BNY Mellon,CitiBank New York,21666,92962,-71296
2011-03-01,BNY Mellon,CitiBank New York,25386,91821,-66435
2011-04-01,BNY Mellon,CitiBank New York,25822,97774,-71952
2011-05-01,BNY Mellon,CitiBank New York,23179,97695,-74516
2011-06-01,BNY Mellon,CitiBank New York,27436,94324,-66888
2011-07-01,BNY Mellon,CitiBank New York,25632,93619,-67987
2011-08-01,BNY Mellon,CitiBank New York,26218,91152,-64934
2011-09-01,BNY Mellon,CitiBank New York,39794,89934,-50140
2011-10-01,BNY Mellon,CitiBank New York,33749,84193,-50444
2011-11-01,BNY Mellon,CitiBank New York,37492,83488,-45996
2011-12-01,BNY Mellon,CitiBank New York,39967,83752,-43785
2012-01-01,BNY Mellon,CitiBank New York,39462,88298,-48836
2012-02-01,BNY Mellon,CitiBank New York,33779,84594,-50815
2012-03-01,BNY Mellon,CitiBank New York,31864,82369,-50505
2012-04-01,BNY Mellon,CitiBank New York,31765,84518,-52753
2012-05-01,BNY Mellon,CitiBank New York,36672,83735,-47063
2012-06-01,BNY Mellon,CitiBank New York,31288,86615,-55327
2012-07-01,BNY Mellon,CitiBank New York,47713,89286,-41573
2012-08-01,BNY Mellon,CitiBank New York,45315,82442,-37127
2012-09-01,BNY Mellon,CitiBank New York,43689,81989,-38300
2012-10-01,BNY Mellon,CitiBank New York,46131,88651,-42520
2012-11-01,BNY Mellon,CitiBank New York,47174,81557,-34383
2012-12-01,BNY Mellon,CitiBank New York,41982,85888,-43906
2013-01-01,BNY Mellon,CitiBank New York,44979,85374,-40395
2013-02-01,BNY Mellon,CitiBank New York,49196,86278,-37082
2013-03-01,BNY Mellon,CitiBank New York,44679,83613,-38934
2013-04-01,BNY Mellon,CitiBank New York,47973,83878,-35905
2013-05-01,BNY Mellon,CitiBank New York,55793,77335,-21542
2013-06-01,BNY Mellon,CitiBank New York,58959,78161,-19202
2013-07-01,BNY Mellon,CitiBank New York,59612,79191,-19579
2013-08-01,BNY Mellon,CitiBank New York,53968,74136,-20168
2013-09-01,BNY Mellon,CitiBank New York,54818,72492,-17674
2013-10-01,BNY Mellon,CitiBank New York,57693,79662,-21969
2013-11-01,BNY Mellon,CitiBank New York,52295,71274,-18979
2013-12-01,BNY Mellon,CitiBank New York,51527,75473,-23946
2014-01-01,BNY Mellon,CitiBank New York,53171,71737,-18566
2014-02-01,BNY Mellon,CitiBank New York,55877,79388,-23511
2014-03-01,BNY Mellon,CitiBank New York,63378,73476,-10098
2014-04-01,BNY Mellon,CitiBank New York,69318,71778,-2460
2014-05-01,BNY Mellon,CitiBank New York,61836,71218,-9382
2014-06-01,BNY Mellon,CitiBank New York,61522,78433,-16911
2014-07-01,BNY Mellon,CitiBank New York,63864,78312,-14448
2014-08-01,BNY Mellon,CitiBank New York,62651,73315,-10664
2014-09-01,BNY Mellon,CitiBank New York,63546,73842,-10296
2014-10-01,BNY Mellon,CitiBank New York,63567,75256,-11689
2014-11-01,BNY Mellon,CitiBank New York,62622,75929,-13307
2014-12-01,BNY Mellon,CitiBank New York,69124,79711,-10587
2015-01-01,BNY Mellon,CitiBank New York,78788,62523,16265
2015-02-01,BNY Mellon,CitiBank New York,79272,66445,12827
2015-03-01,BNY Mellon,CitiBank New York,76351,61478,14873
2015-04-01,BNY Mellon,CitiBank New York,74151,64811,9340
2015-05-01,BNY Mellon,CitiBank New York,71927,61749,10178
2015-06-01,BNY Mellon,CitiBank New York,76684,62759,13925
2015-07-01,BNY Mellon,CitiBank New York,71628,62757,8871
2015-08-01,BNY Mellon,CitiBank New York,77832,66745,11087
2015-09-01,BNY Mellon,CitiBank New York,78749,69853,8896
2015-10-01,BNY Mellon,CitiBank New York,75187,64662,10525
2015-11-01,BNY Mellon,CitiBank New York,89395,69387,20008
2015-12-01,BNY Mellon,CitiBank New York,84891,65743,19148
2016-01-01,BNY Mellon,CitiBank New York,86627,62267,24360
2016-02-01,BNY Mellon,CitiBank New York,88574,66848,21726
2016-03-01,BNY Mellon,CitiBank New York,89522,64313,25209
2016-04-01,BNY Mellon,CitiBank New York,84477,62256,22221
2016-05-01,BNY Mellon,CitiBank New York,85498,61316,24182
2016-06-01,BNY Mellon,CitiBank New York,82961,63971,18990
2016-07-01,BNY Mellon,CitiBank New York,86457,68796,17661
2016-08-01,BNY Mellon,CitiBank New York,82239,69763,12476
2016-09-01,BNY Mellon,CitiBank New York,94392,53814,40578
2016-10-01,BNY Mellon,CitiBank New York,94446,55917,38529
2016-11-01,BNY Mellon,CitiBank New York,92113,56464,35649
2016-12-01,BNY Mellon,CitiBank New York,93883,57862,36021
2017-01-01,BNY Mellon,CitiBank New York,92683,56278,36405
2017-02-01,BNY Mellon,CitiBank New York,94997,54972,40025
2017-03-01,BNY Mellon,CitiBank New York,93657,57677,35980
2017-04-01,BNY Mellon,CitiBank New York,97584,57977,39607
2017-05-01,BNY Mellon,CitiBank New York,91397,55811,35586
2017-06-01,BNY Mellon,CitiBank New York,98666,54722,43944
2017-07-01,BNY Mellon,CitiBank New York,107346,59611,47735
2017-08-01,BNY Mellon,CitiBank New York,101165,52647,48518
2017-09-01,BNY Mellon,CitiBank New York,102815,58838,43977
2017-10-01,BNY Mellon,CitiBank New York,107883,56613,51270
2017-11-01,BNY Mellon,CitiBank New York,102759,52823,49936
2017-12-01,BNY Mellon,CitiBank New York,104146,56293,47853
2018-01-01,BNY Mellon,CitiBank New York,101616,58755,42861
2018-02-01,BNY Mellon,CitiBank New York,107164,56474,50690
2018-03-01,BNY Mellon,CitiBank New York,109877,55737,54140
2018-04-01,BNY Mellon,CitiBank New York,108897,52949,55948
2010-01-01,BNY Mellon,CitiBank London,18579,99753,-81174
2010-02-01,BNY Mellon,CitiBank London,19721,93192,-73471
2010-03-01,BNY Mellon,CitiBank London,14264,91648,-77384
2010-04-01,BNY Mellon,CitiBank London,14427,95649,-81222
2010-05-01,BNY Mellon,CitiBank London,17732,96893,-79161
2010-06-01,BNY Mellon,CitiBank London,14731,95938,-81207
2010-07-01,BNY Mellon,CitiBank London,13649,91384,-77735
2010-08-01,BNY Mellon,CitiBank London,18692,96784,-78092
2010-09-01,BNY Mellon,CitiBank London,13557,99671,-86114
2010-10-01,BNY Mellon,CitiBank London,11669,94242,-82573
2010-11-01,BNY Mellon,CitiBank London,22774,92985,-70211
2010-12-01,BNY Mellon,CitiBank London,24296,96341,-72045
2011-01-01,BNY Mellon,CitiBank London,24777,94297,-69520
2011-02-01,BNY Mellon,CitiBank London,29395,99233,-69838
2011-03-01,BNY Mellon,CitiBank London,29231,96324,-67093
2011-04-01,BNY Mellon,CitiBank London,29863,93789,-63926
2011-05-01,BNY Mellon,CitiBank London,25914,91135,-65221
2011-06-01,BNY Mellon,CitiBank London,29542,91622,-62080
2011-07-01,BNY Mellon,CitiBank London,24579,99573,-74994
2011-08-01,BNY Mellon,CitiBank London,21865,95745,-73880
2011-09-01,BNY Mellon,CitiBank London,39755,86496,-46741
2011-10-01,BNY Mellon,CitiBank London,39438,83136,-43698
2011-11-01,BNY Mellon,CitiBank London,38122,85476,-47354
2011-12-01,BNY Mellon,CitiBank London,36725,89725,-53000
2012-01-01,BNY Mellon,CitiBank London,37294,82747,-45453
2012-02-01,BNY Mellon,CitiBank London,39293,86738,-47445
2012-03-01,BNY Mellon,CitiBank London,32724,87246,-54522
2012-04-01,BNY Mellon,CitiBank London,39869,86172,-46303
2012-05-01,BNY Mellon,CitiBank London,31582,87925,-56343
2012-06-01,BNY Mellon,CitiBank London,37778,86627,-48849
2012-07-01,BNY Mellon,CitiBank London,49281,86755,-37474
2012-08-01,BNY Mellon,CitiBank London,41385,86493,-45108
2012-09-01,BNY Mellon,CitiBank London,43236,87611,-44375
2012-10-01,BNY Mellon,CitiBank London,49779,88873,-39094
2012-11-01,BNY Mellon,CitiBank London,42917,84167,-41250
2012-12-01,BNY Mellon,CitiBank London,43172,85292,-42120
2013-01-01,BNY Mellon,CitiBank London,42769,84347,-41578
2013-02-01,BNY Mellon,CitiBank London,44293,82557,-38264
2013-03-01,BNY Mellon,CitiBank London,41783,85272,-43489
2013-04-01,BNY Mellon,CitiBank London,45884,82468,-36584
2013-05-01,BNY Mellon,CitiBank London,57555,72368,-14813
2013-06-01,BNY Mellon,CitiBank London,52492,72823,-20331
2013-07-01,BNY Mellon,CitiBank London,58787,77251,-18464
2013-08-01,BNY Mellon,CitiBank London,57245,77924,-20679
2013-09-01,BNY Mellon,CitiBank London,59199,74498,-15299
2013-10-01,BNY Mellon,CitiBank London,58519,77566,-19047
2013-11-01,BNY Mellon,CitiBank London,56665,75624,-18959
2013-12-01,BNY Mellon,CitiBank London,53191,78555,-25364
2014-01-01,BNY Mellon,CitiBank London,53443,75513,-22070
2014-02-01,BNY Mellon,CitiBank London,55462,71522,-16060
2014-03-01,BNY Mellon,CitiBank London,64216,74275,-10059
2014-04-01,BNY Mellon,CitiBank London,69134,79697,-10563
2014-05-01,BNY Mellon,CitiBank London,69392,76428,-7036
2014-06-01,BNY Mellon,CitiBank London,69185,74939,-5754
2014-07-01,BNY Mellon,CitiBank London,67855,73676,-5821
2014-08-01,BNY Mellon,CitiBank London,66557,73181,-6624
2014-09-01,BNY Mellon,CitiBank London,69861,79748,-9887
2014-10-01,BNY Mellon,CitiBank London,67466,73843,-6377
2014-11-01,BNY Mellon,CitiBank London,68719,77693,-8974
2014-12-01,BNY Mellon,CitiBank London,69757,79368,-9611
2015-01-01,BNY Mellon,CitiBank London,77825,61844,15981
2015-02-01,BNY Mellon,CitiBank London,75642,61988,13654
2015-03-01,BNY Mellon,CitiBank London,71748,64421,7327
2015-04-01,BNY Mellon,CitiBank London,78493,69336,9157
2015-05-01,BNY Mellon,CitiBank London,71133,69261,1872
2015-06-01,BNY Mellon,CitiBank London,72356,64524,7832
2015-07-01,BNY Mellon,CitiBank London,71156,63193,7963
2015-08-01,BNY Mellon,CitiBank London,77716,68846,8870
2015-09-01,BNY Mellon,CitiBank London,72965,68279,4686
2015-10-01,BNY Mellon,CitiBank London,72862,67518,5344
2015-11-01,BNY Mellon,CitiBank London,82116,66175,15941
2015-12-01,BNY Mellon,CitiBank London,88831,64345,24486
2016-01-01,BNY Mellon,CitiBank London,83654,65225,18429
2016-02-01,BNY Mellon,CitiBank London,82433,67441,14992
2016-03-01,BNY Mellon,CitiBank London,89459,62911,26548
2016-04-01,BNY Mellon,CitiBank London,87154,69347,17807
2016-05-01,BNY Mellon,CitiBank London,87233,69116,18117
2016-06-01,BNY Mellon,CitiBank London,86271,62197,24074
2016-07-01,BNY Mellon,CitiBank London,89797,62911,26886
2016-08-01,BNY Mellon,CitiBank London,88293,68841,19452
2016-09-01,BNY Mellon,CitiBank London,96938,54141,42797
2016-10-01,BNY Mellon,CitiBank London,92482,54653,37829
2016-11-01,BNY Mellon,CitiBank London,91966,57919,34047
2016-12-01,BNY Mellon,CitiBank London,94799,59395,35404
2017-01-01,BNY Mellon,CitiBank London,95658,59853,35805
2017-02-01,BNY Mellon,CitiBank London,94391,56629,37762
2017-03-01,BNY Mellon,CitiBank London,98566,54725,43841
2017-04-01,BNY Mellon,CitiBank London,96776,52816,43960
2017-05-01,BNY Mellon,CitiBank London,98436,54392,44044
2017-06-01,BNY Mellon,CitiBank London,95481,56447,39034
2017-07-01,BNY Mellon,CitiBank London,109475,58662,50813
2017-08-01,BNY Mellon,CitiBank London,108385,54713,53672
2017-09-01,BNY Mellon,CitiBank London,105768,54658,51110
2017-10-01,BNY Mellon,CitiBank London,105779,55282,50497
2017-11-01,BNY Mellon,CitiBank London,109384,53938,55446
2017-12-01,BNY Mellon,CitiBank London,109659,52979,56680
2018-01-01,BNY Mellon,CitiBank London,104197,52414,51783
2018-02-01,BNY Mellon,CitiBank London,107736,54245,53491
2018-03-01,BNY Mellon,CitiBank London,106142,53628,52514
2018-04-01,BNY Mellon,CitiBank London,102467,57168,45299
2010-01-01,BNY Mellon,CitiBank Pune,18696,98375,-79679
2010-02-01,BNY Mellon,CitiBank Pune,12496,99726,-87230
2010-03-01,BNY Mellon,CitiBank Pune,15517,91784,-76267
2010-04-01,BNY Mellon,CitiBank Pune,18383,96294,-77911
2010-05-01,BNY Mellon,CitiBank Pune,13453,92113,-78660
2010-06-01,BNY Mellon,CitiBank Pune,16395,94489,-78094
2010-07-01,BNY Mellon,CitiBank Pune,12146,93518,-81372
2010-08-01,BNY Mellon,CitiBank Pune,18444,97535,-79091
2010-09-01,BNY Mellon,CitiBank Pune,15689,98365,-82676
2010-10-01,BNY Mellon,CitiBank Pune,12156,91123,-78967
2010-11-01,BNY Mellon,CitiBank Pune,29555,99423,-69868
2010-12-01,BNY Mellon,CitiBank Pune,22728,98412,-75684
2011-01-01,BNY Mellon,CitiBank Pune,27932,94892,-66960
2011-02-01,BNY Mellon,CitiBank Pune,25462,96291,-70829
2011-03-01,BNY Mellon,CitiBank Pune,21125,96255,-75130
2011-04-01,BNY Mellon,CitiBank Pune,29629,93922,-64293
2011-05-01,BNY Mellon,CitiBank Pune,29551,92826,-63275
2011-06-01,BNY Mellon,CitiBank Pune,25638,98631,-72993
2011-07-01,BNY Mellon,CitiBank Pune,27639,98388,-70749
2011-08-01,BNY Mellon,CitiBank Pune,23146,93425,-70279
2011-09-01,BNY Mellon,CitiBank Pune,38112,86198,-48086
2011-10-01,BNY Mellon,CitiBank Pune,31951,85328,-53377
2011-11-01,BNY Mellon,CitiBank Pune,36664,89522,-52858
2011-12-01,BNY Mellon,CitiBank Pune,35988,82797,-46809
2012-01-01,BNY Mellon,CitiBank Pune,39476,89233,-49757
2012-02-01,BNY Mellon,CitiBank Pune,38684,88189,-49505
2012-03-01,BNY Mellon,CitiBank Pune,34252,85152,-50900
2012-04-01,BNY Mellon,CitiBank Pune,33667,83951,-50284
2012-05-01,BNY Mellon,CitiBank Pune,38149,85598,-47449
2012-06-01,BNY Mellon,CitiBank Pune,35136,89996,-54860
2012-07-01,BNY Mellon,CitiBank Pune,45384,87586,-42202
2012-08-01,BNY Mellon,CitiBank Pune,43121,83224,-40103
2012-09-01,BNY Mellon,CitiBank Pune,47617,89342,-41725
2012-10-01,BNY Mellon,CitiBank Pune,44958,85889,-40931
2012-11-01,BNY Mellon,CitiBank Pune,41718,83289,-41571
2012-12-01,BNY Mellon,CitiBank Pune,45517,83771,-38254
2013-01-01,BNY Mellon,CitiBank Pune,49413,86537,-37124
2013-02-01,BNY Mellon,CitiBank Pune,42699,86686,-43987
2013-03-01,BNY Mellon,CitiBank Pune,48843,81452,-32609
2013-04-01,BNY Mellon,CitiBank Pune,42478,82467,-39989
2013-05-01,BNY Mellon,CitiBank Pune,54635,72569,-17934
2013-06-01,BNY Mellon,CitiBank Pune,58223,72474,-14251
2013-07-01,BNY Mellon,CitiBank Pune,55613,71121,-15508
2013-08-01,BNY Mellon,CitiBank Pune,56142,78682,-22540
2013-09-01,BNY Mellon,CitiBank Pune,53617,75666,-22049
2013-10-01,BNY Mellon,CitiBank Pune,53271,79465,-26194
2013-11-01,BNY Mellon,CitiBank Pune,54854,73966,-19112
2013-12-01,BNY Mellon,CitiBank Pune,59469,71529,-12060
2014-01-01,BNY Mellon,CitiBank Pune,58513,79818,-21305
2014-02-01,BNY Mellon,CitiBank Pune,56561,79698,-23137
2014-03-01,BNY Mellon,CitiBank Pune,69142,76224,-7082
2014-04-01,BNY Mellon,CitiBank Pune,63776,75626,-11850
2014-05-01,BNY Mellon,CitiBank Pune,67584,79297,-11713
2014-06-01,BNY Mellon,CitiBank Pune,61572,78672,-17100
2014-07-01,BNY Mellon,CitiBank Pune,62926,73177,-10251
2014-08-01,BNY Mellon,CitiBank Pune,61986,78931,-16945
2014-09-01,BNY Mellon,CitiBank Pune,66135,79712,-13577
2014-10-01,BNY Mellon,CitiBank Pune,66524,71564,-5040
2014-11-01,BNY Mellon,CitiBank Pune,66927,79652,-12725
2014-12-01,BNY Mellon,CitiBank Pune,65182,73272,-8090
2015-01-01,BNY Mellon,CitiBank Pune,74621,61263,13358
2015-02-01,BNY Mellon,CitiBank Pune,71474,62494,8980
2015-03-01,BNY Mellon,CitiBank Pune,73517,65462,8055
2015-04-01,BNY Mellon,CitiBank Pune,79241,67346,11895
2015-05-01,BNY Mellon,CitiBank Pune,72421,69642,2779
2015-06-01,BNY Mellon,CitiBank Pune,72835,62564,10271
2015-07-01,BNY Mellon,CitiBank Pune,75692,62152,13540
2015-08-01,BNY Mellon,CitiBank Pune,72884,64653,8231
2015-09-01,BNY Mellon,CitiBank Pune,72294,67539,4755
2015-10-01,BNY Mellon,CitiBank Pune,73362,61934,11428
2015-11-01,BNY Mellon,CitiBank Pune,89537,65738,23799
2015-12-01,BNY Mellon,CitiBank Pune,84321,69719,14602
2016-01-01,BNY Mellon,CitiBank Pune,89178,67995,21183
2016-02-01,BNY Mellon,CitiBank Pune,81278,65953,15325
2016-03-01,BNY Mellon,CitiBank Pune,82115,65261,16854
2016-04-01,BNY Mellon,CitiBank Pune,86531,63443,23088
2016-05-01,BNY Mellon,CitiBank Pune,88816,67882,20934
2016-06-01,BNY Mellon,CitiBank Pune,89558,63732,25826
2016-07-01,BNY Mellon,CitiBank Pune,81957,68613,13344
2016-08-01,BNY Mellon,CitiBank Pune,86123,68536,17587
2016-09-01,BNY Mellon,CitiBank Pune,93293,54228,39065
2016-10-01,BNY Mellon,CitiBank Pune,99921,58128,41793
2016-11-01,BNY Mellon,CitiBank Pune,97752,58378,39374
2016-12-01,BNY Mellon,CitiBank Pune,92463,54838,37625
2017-01-01,BNY Mellon,CitiBank Pune,97267,56549,40718
2017-02-01,BNY Mellon,CitiBank Pune,92599,59753,32846
2017-03-01,BNY Mellon,CitiBank Pune,95383,55863,39520
2017-04-01,BNY Mellon,CitiBank Pune,99364,52346,47018
2017-05-01,BNY Mellon,CitiBank Pune,98192,53567,44625
2017-06-01,BNY Mellon,CitiBank Pune,93766,57377,36389
2017-07-01,BNY Mellon,CitiBank Pune,107842,57356,50486
2017-08-01,BNY Mellon,CitiBank Pune,101553,57117,44436
2017-09-01,BNY Mellon,CitiBank Pune,108397,57328,51069
2017-10-01,BNY Mellon,CitiBank Pune,108888,51458,57430
2017-11-01,BNY Mellon,CitiBank Pune,101247,53531,47716
2017-12-01,BNY Mellon,CitiBank Pune,108934,59251,49683
2018-01-01,BNY Mellon,CitiBank Pune,102244,53141,49103
2018-02-01,BNY Mellon,CitiBank Pune,104621,51917,52704
2018-03-01,BNY Mellon,CitiBank Pune,108351,52938,55413
2018-04-01,BNY Mellon,CitiBank Pune,103433,57939,45494
2010-01-01,BNY Mellon,CitiBank Singapore,15633,91672,-76039
2010-02-01,BNY Mellon,CitiBank Singapore,13542,95727,-82185
2010-03-01,BNY Mellon,CitiBank Singapore,18953,91562,-72609
2010-04-01,BNY Mellon,CitiBank Singapore,15584,94823,-79239
2010-05-01,BNY Mellon,CitiBank Singapore,12557,98692,-86135
2010-06-01,BNY Mellon,CitiBank Singapore,12578,94862,-82284
2010-07-01,BNY Mellon,CitiBank Singapore,14241,94167,-79926
2010-08-01,BNY Mellon,CitiBank Singapore,16553,95432,-78879
2010-09-01,BNY Mellon,CitiBank Singapore,15452,94424,-78972
2010-10-01,BNY Mellon,CitiBank Singapore,12443,96522,-84079
2010-11-01,BNY Mellon,CitiBank Singapore,21754,98181,-76427
2010-12-01,BNY Mellon,CitiBank Singapore,23915,97223,-73308
2011-01-01,BNY Mellon,CitiBank Singapore,25325,99989,-74664
2011-02-01,BNY Mellon,CitiBank Singapore,22996,93121,-70125
2011-03-01,BNY Mellon,CitiBank Singapore,23439,94569,-71130
2011-04-01,BNY Mellon,CitiBank Singapore,27781,92867,-65086
2011-05-01,BNY Mellon,CitiBank Singapore,26493,96944,-70451
2011-06-01,BNY Mellon,CitiBank Singapore,28151,94365,-66214
2011-07-01,BNY Mellon,CitiBank Singapore,23772,99974,-76202
2011-08-01,BNY Mellon,CitiBank Singapore,29243,97133,-67890
2011-09-01,BNY Mellon,CitiBank Singapore,36423,81939,-45516
2011-10-01,BNY Mellon,CitiBank Singapore,33453,87187,-53734
2011-11-01,BNY Mellon,CitiBank Singapore,34651,88177,-53526
2011-12-01,BNY Mellon,CitiBank Singapore,32237,88994,-56757
2012-01-01,BNY Mellon,CitiBank Singapore,32321,86737,-54416
2012-02-01,BNY Mellon,CitiBank Singapore,39843,89379,-49536
2012-03-01,BNY Mellon,CitiBank Singapore,33999,82687,-48688
2012-04-01,BNY Mellon,CitiBank Singapore,39212,82818,-43606
2012-05-01,BNY Mellon,CitiBank Singapore,33597,87777,-54180
2012-06-01,BNY Mellon,CitiBank Singapore,31438,87167,-55729
2012-07-01,BNY Mellon,CitiBank Singapore,42953,81751,-38798
2012-08-01,BNY Mellon,CitiBank Singapore,45239,86326,-41087
2012-09-01,BNY Mellon,CitiBank Singapore,41143,81115,-39972
2012-10-01,BNY Mellon,CitiBank Singapore,47799,86819,-39020
2012-11-01,BNY Mellon,CitiBank Singapore,47257,86357,-39100
2012-12-01,BNY Mellon,CitiBank Singapore,49671,87459,-37788
2013-01-01,BNY Mellon,CitiBank Singapore,47146,85162,-38016
2013-02-01,BNY Mellon,CitiBank Singapore,44942,86349,-41407
2013-03-01,BNY Mellon,CitiBank Singapore,41924,83538,-41614
2013-04-01,BNY Mellon,CitiBank Singapore,46344,85877,-39533
2013-05-01,BNY Mellon,CitiBank Singapore,52525,77975,-25450
2013-06-01,BNY Mellon,CitiBank Singapore,51539,75993,-24454
2013-07-01,BNY Mellon,CitiBank Singapore,51696,76832,-25136
2013-08-01,BNY Mellon,CitiBank Singapore,56233,79625,-23392
2013-09-01,BNY Mellon,CitiBank Singapore,51493,75187,-23694
2013-10-01,BNY Mellon,CitiBank Singapore,52878,77935,-25057
2013-11-01,BNY Mellon,CitiBank Singapore,57666,75171,-17505
2013-12-01,BNY Mellon,CitiBank Singapore,58629,76518,-17889
2014-01-01,BNY Mellon,CitiBank Singapore,54677,74943,-20266
2014-02-01,BNY Mellon,CitiBank Singapore,54557,74799,-20242
2014-03-01,BNY Mellon,CitiBank Singapore,64999,79672,-14673
2014-04-01,BNY Mellon,CitiBank Singapore,66133,72585,-6452
2014-05-01,BNY Mellon,CitiBank Singapore,63699,74141,-10442
2014-06-01,BNY Mellon,CitiBank Singapore,67141,71657,-4516
2014-07-01,BNY Mellon,CitiBank Singapore,67677,75666,-7989
2014-08-01,BNY Mellon,CitiBank Singapore,62194,71952,-9758
2014-09-01,BNY Mellon,CitiBank Singapore,67533,73457,-5924
2014-10-01,BNY Mellon,CitiBank Singapore,65113,77267,-12154
2014-11-01,BNY Mellon,CitiBank Singapore,62742,77392,-14650
2014-12-01,BNY Mellon,CitiBank Singapore,62612,78918,-16306
2015-01-01,BNY Mellon,CitiBank Singapore,72262,67167,5095
2015-02-01,BNY Mellon,CitiBank Singapore,79287,64748,14539
2015-03-01,BNY Mellon,CitiBank Singapore,72321,62284,10037
2015-04-01,BNY Mellon,CitiBank Singapore,77866,62427,15439
2015-05-01,BNY Mellon,CitiBank Singapore,77795,69988,7807
2015-06-01,BNY Mellon,CitiBank Singapore,72133,62996,9137
2015-07-01,BNY Mellon,CitiBank Singapore,71581,64213,7368
2015-08-01,BNY Mellon,CitiBank Singapore,75887,64633,11254
2015-09-01,BNY Mellon,CitiBank Singapore,78792,67214,11578
2015-10-01,BNY Mellon,CitiBank Singapore,78769,61322,17447
2015-11-01,BNY Mellon,CitiBank Singapore,83863,66586,17277
2015-12-01,BNY Mellon,CitiBank Singapore,85741,68389,17352
2016-01-01,BNY Mellon,CitiBank Singapore,83273,67337,15936
2016-02-01,BNY Mellon,CitiBank Singapore,82237,63886,18351
2016-03-01,BNY Mellon,CitiBank Singapore,85873,62243,23630
2016-04-01,BNY Mellon,CitiBank Singapore,84879,61844,23035
2016-05-01,BNY Mellon,CitiBank Singapore,89245,68766,20479
2016-06-01,BNY Mellon,CitiBank Singapore,84647,65636,19011
2016-07-01,BNY Mellon,CitiBank Singapore,82837,61526,21311
2016-08-01,BNY Mellon,CitiBank Singapore,87838,63434,24404
2016-09-01,BNY Mellon,CitiBank Singapore,98915,58916,39999
2016-10-01,BNY Mellon,CitiBank Singapore,95172,53227,41945
2016-11-01,BNY Mellon,CitiBank Singapore,93188,54262,38926
2016-12-01,BNY Mellon,CitiBank Singapore,96237,55284,40953
2017-01-01,BNY Mellon,CitiBank Singapore,92758,51935,40823
2017-02-01,BNY Mellon,CitiBank Singapore,96625,51975,44650
2017-03-01,BNY Mellon,CitiBank Singapore,92167,59743,32424
2017-04-01,BNY Mellon,CitiBank Singapore,99433,53852,45581
2017-05-01,BNY Mellon,CitiBank Singapore,99788,52885,46903
2017-06-01,BNY Mellon,CitiBank Singapore,97466,52876,44590
2017-07-01,BNY Mellon,CitiBank Singapore,109814,51188,58626
2017-08-01,BNY Mellon,CitiBank Singapore,109168,57887,51281
2017-09-01,BNY Mellon,CitiBank Singapore,105227,55794,49433
2017-10-01,BNY Mellon,CitiBank Singapore,108485,52613,55872
2017-11-01,BNY Mellon,CitiBank Singapore,104754,51632,53122
2017-12-01,BNY Mellon,CitiBank Singapore,107143,55882,51261
2018-01-01,BNY Mellon,CitiBank Singapore,108259,56327,51932
2018-02-01,BNY Mellon,CitiBank Singapore,105156,51984,53172
2018-03-01,BNY Mellon,CitiBank Singapore,105845,56321,49524
2018-04-01,BNY Mellon,CitiBank Singapore,105377,55445,49932
2010-01-01,BNY Mellon,CitiBank HongKong,12361,93554,-81193
2010-02-01,BNY Mellon,CitiBank HongKong,16685,93722,-77037
2010-03-01,BNY Mellon,CitiBank HongKong,18528,93312,-74784
2010-04-01,BNY Mellon,CitiBank HongKong,11629,94616,-82987
2010-05-01,BNY Mellon,CitiBank HongKong,18771,94282,-75511
2010-06-01,BNY Mellon,CitiBank HongKong,13961,99832,-85871
2010-07-01,BNY Mellon,CitiBank HongKong,15138,91277,-76139
2010-08-01,BNY Mellon,CitiBank HongKong,17574,99597,-82023
2010-09-01,BNY Mellon,CitiBank HongKong,14267,95492,-81225
2010-10-01,BNY Mellon,CitiBank HongKong,13898,93699,-79801
2010-11-01,BNY Mellon,CitiBank HongKong,24137,97414,-73277
2010-12-01,BNY Mellon,CitiBank HongKong,23932,94569,-70637
2011-01-01,BNY Mellon,CitiBank HongKong,25941,92479,-66538
2011-02-01,BNY Mellon,CitiBank HongKong,29197,98963,-69766
2011-03-01,BNY Mellon,CitiBank HongKong,29587,95123,-65536
2011-04-01,BNY Mellon,CitiBank HongKong,22615,94736,-72121
2011-05-01,BNY Mellon,CitiBank HongKong,28966,92484,-63518
2011-06-01,BNY Mellon,CitiBank HongKong,22761,98676,-75915
2011-07-01,BNY Mellon,CitiBank HongKong,23379,99543,-76164
2011-08-01,BNY Mellon,CitiBank HongKong,23981,92847,-68866
2011-09-01,BNY Mellon,CitiBank HongKong,35251,87619,-52368
2011-10-01,BNY Mellon,CitiBank HongKong,34889,89861,-54972
2011-11-01,BNY Mellon,CitiBank HongKong,39153,81734,-42581
2011-12-01,BNY Mellon,CitiBank HongKong,37849,86735,-48886
2012-01-01,BNY Mellon,CitiBank HongKong,39618,86712,-47094
2012-02-01,BNY Mellon,CitiBank HongKong,34157,86842,-52685
2012-03-01,BNY Mellon,CitiBank HongKong,36784,82464,-45680
2012-04-01,BNY Mellon,CitiBank HongKong,36418,84614,-48196
2012-05-01,BNY Mellon,CitiBank HongKong,32872,81463,-48591
2012-06-01,BNY Mellon,CitiBank HongKong,37546,88294,-50748
2012-07-01,BNY Mellon,CitiBank HongKong,41587,89669,-48082
2012-08-01,BNY Mellon,CitiBank HongKong,49474,84557,-35083
2012-09-01,BNY Mellon,CitiBank HongKong,42441,83464,-41023
2012-10-01,BNY Mellon,CitiBank HongKong,49258,82365,-33107
2012-11-01,BNY Mellon,CitiBank HongKong,42728,87566,-44838
2012-12-01,BNY Mellon,CitiBank HongKong,42842,85789,-42947
2013-01-01,BNY Mellon,CitiBank HongKong,44256,82463,-38207
2013-02-01,BNY Mellon,CitiBank HongKong,45227,83413,-38186
2013-03-01,BNY Mellon,CitiBank HongKong,45464,89267,-43803
2013-04-01,BNY Mellon,CitiBank HongKong,45368,87572,-42204
2013-05-01,BNY Mellon,CitiBank HongKong,54595,75292,-20697
2013-06-01,BNY Mellon,CitiBank HongKong,53837,77771,-23934
2013-07-01,BNY Mellon,CitiBank HongKong,57327,71952,-14625
2013-08-01,BNY Mellon,CitiBank HongKong,59415,71336,-11921
2013-09-01,BNY Mellon,CitiBank HongKong,58458,79628,-21170
2013-10-01,BNY Mellon,CitiBank HongKong,51745,74737,-22992
2013-11-01,BNY Mellon,CitiBank HongKong,57291,78612,-21321
2013-12-01,BNY Mellon,CitiBank HongKong,58732,74711,-15979
2014-01-01,BNY Mellon,CitiBank HongKong,51597,76458,-24861
2014-02-01,BNY Mellon,CitiBank HongKong,55213,71176,-15963
2014-03-01,BNY Mellon,CitiBank HongKong,62861,72547,-9686
2014-04-01,BNY Mellon,CitiBank HongKong,65815,72216,-6401
2014-05-01,BNY Mellon,CitiBank HongKong,61253,78268,-17015
2014-06-01,BNY Mellon,CitiBank HongKong,63365,77778,-14413
2014-07-01,BNY Mellon,CitiBank HongKong,66218,77359,-11141
2014-08-01,BNY Mellon,CitiBank HongKong,66994,78444,-11450
2014-09-01,BNY Mellon,CitiBank HongKong,68235,78133,-9898
2014-10-01,BNY Mellon,CitiBank HongKong,63685,77318,-13633
2014-11-01,BNY Mellon,CitiBank HongKong,68588,72668,-4080
2014-12-01,BNY Mellon,CitiBank HongKong,68548,71556,-3008
2015-01-01,BNY Mellon,CitiBank HongKong,71489,61183,10306
2015-02-01,BNY Mellon,CitiBank HongKong,77893,65127,12766
2015-03-01,BNY Mellon,CitiBank HongKong,77445,65919,11526
2015-04-01,BNY Mellon,CitiBank HongKong,72544,65828,6716
2015-05-01,BNY Mellon,CitiBank HongKong,74338,65836,8502
2015-06-01,BNY Mellon,CitiBank HongKong,73249,64852,8397
2015-07-01,BNY Mellon,CitiBank HongKong,76923,61386,15537
2015-08-01,BNY Mellon,CitiBank HongKong,75921,63237,12684
2015-09-01,BNY Mellon,CitiBank HongKong,73916,65821,8095
2015-10-01,BNY Mellon,CitiBank HongKong,77192,62615,14577
2015-11-01,BNY Mellon,CitiBank HongKong,83914,64567,19347
2015-12-01,BNY Mellon,CitiBank HongKong,82893,65936,16957
2016-01-01,BNY Mellon,CitiBank HongKong,82852,67272,15580
2016-02-01,BNY Mellon,CitiBank HongKong,85919,65269,20650
2016-03-01,BNY Mellon,CitiBank HongKong,89697,62431,27266
2016-04-01,BNY Mellon,CitiBank HongKong,88548,68449,20099
2016-05-01,BNY Mellon,CitiBank HongKong,86125,63415,22710
2016-06-01,BNY Mellon,CitiBank HongKong,84845,66252,18593
2016-07-01,BNY Mellon,CitiBank HongKong,87193,69431,17762
2016-08-01,BNY Mellon,CitiBank HongKong,86457,62779,23678
2016-09-01,BNY Mellon,CitiBank HongKong,94787,57269,37518
2016-10-01,BNY Mellon,CitiBank HongKong,98525,56745,41780
2016-11-01,BNY Mellon,CitiBank HongKong,91617,51154,40463
2016-12-01,BNY Mellon,CitiBank HongKong,94322,54995,39327
2017-01-01,BNY Mellon,CitiBank HongKong,96199,55918,40281
2017-02-01,BNY Mellon,CitiBank HongKong,96611,55487,41124
2017-03-01,BNY Mellon,CitiBank HongKong,94532,54679,39853
2017-04-01,BNY Mellon,CitiBank HongKong,97345,52597,44748
2017-05-01,BNY Mellon,CitiBank HongKong,92599,54276,38323
2017-06-01,BNY Mellon,CitiBank HongKong,93712,58978,34734
2017-07-01,BNY Mellon,CitiBank HongKong,103631,54825,48806
2017-08-01,BNY Mellon,CitiBank HongKong,102177,57777,44400
2017-09-01,BNY Mellon,CitiBank HongKong,109765,59631,50134
2017-10-01,BNY Mellon,CitiBank HongKong,104473,55533,48940
2017-11-01,BNY Mellon,CitiBank HongKong,109133,57235,51898
2017-12-01,BNY Mellon,CitiBank HongKong,104259,54426,49833
2018-01-01,BNY Mellon,CitiBank HongKong,108978,56578,52400
2018-02-01,BNY Mellon,CitiBank HongKong,106446,51466,54980
2018-03-01,BNY Mellon,CitiBank HongKong,106898,58118,48780
2018-04-01,BNY Mellon,CitiBank HongKong,106936,53247,53689
2010-01-01,Goldman Sachs,CitiBank New York,15299,91578,-76279
2010-02-01,Goldman Sachs,CitiBank New York,16386,93959,-77573
2010-03-01,Goldman Sachs,CitiBank New York,15573,98896,-83323
2010-04-01,Goldman Sachs,CitiBank New York,13875,97249,-83374
2010-05-01,Goldman Sachs,CitiBank New York,16514,95955,-79441
2010-06-01,Goldman Sachs,CitiBank New York,16319,99621,-83302
2010-07-01,Goldman Sachs,CitiBank New York,16532,99845,-83313
2010-08-01,Goldman Sachs,CitiBank New York,16385,92911,-76526
2010-09-01,Goldman Sachs,CitiBank New York,11144,94796,-83652
2010-10-01,Goldman Sachs,CitiBank New York,13524,97968,-84444
2010-11-01,Goldman Sachs,CitiBank New York,27414,98245,-70831
2010-12-01,Goldman Sachs,CitiBank New York,26217,99615,-73398
2011-01-01,Goldman Sachs,CitiBank New York,24493,98949,-74456
2011-02-01,Goldman Sachs,CitiBank New York,24275,94751,-70476
2011-03-01,Goldman Sachs,CitiBank New York,27289,91671,-64382
2011-04-01,Goldman Sachs,CitiBank New York,23784,98599,-74815
2011-05-01,Goldman Sachs,CitiBank New York,22583,99781,-77198
2011-06-01,Goldman Sachs,CitiBank New York,25889,99881,-73992
2011-07-01,Goldman Sachs,CitiBank New York,26838,98547,-71709
2011-08-01,Goldman Sachs,CitiBank New York,22592,96316,-73724
2011-09-01,Goldman Sachs,CitiBank New York,31993,87646,-55653
2011-10-01,Goldman Sachs,CitiBank New York,34439,83429,-48990
2011-11-01,Goldman Sachs,CitiBank New York,35529,82961,-47432
2011-12-01,Goldman Sachs,CitiBank New York,34278,85649,-51371
2012-01-01,Goldman Sachs,CitiBank New York,34116,81652,-47536
2012-02-01,Goldman Sachs,CitiBank New York,35738,84138,-48400
2012-03-01,Goldman Sachs,CitiBank New York,34961,89369,-54408
2012-04-01,Goldman Sachs,CitiBank New York,31658,87144,-55486
2012-05-01,Goldman Sachs,CitiBank New York,36669,82327,-45658
2012-06-01,Goldman Sachs,CitiBank New York,38673,86748,-48075
2012-07-01,Goldman Sachs,CitiBank New York,45139,82261,-37122
2012-08-01,Goldman Sachs,CitiBank New York,43551,86778,-43227
2012-09-01,Goldman Sachs,CitiBank New York,41721,85333,-43612
2012-10-01,Goldman Sachs,CitiBank New York,47765,83926,-36161
2012-11-01,Goldman Sachs,CitiBank New York,43935,89652,-45717
2012-12-01,Goldman Sachs,CitiBank New York,44965,87531,-42566
2013-01-01,Goldman Sachs,CitiBank New York,44346,87193,-42847
2013-02-01,Goldman Sachs,CitiBank New York,44287,85173,-40886
2013-03-01,Goldman Sachs,CitiBank New York,48262,86366,-38104
2013-04-01,Goldman Sachs,CitiBank New York,41911,82248,-40337
2013-05-01,Goldman Sachs,CitiBank New York,59329,77736,-18407
2013-06-01,Goldman Sachs,CitiBank New York,51969,76769,-24800
2013-07-01,Goldman Sachs,CitiBank New York,57892,75637,-17745
2013-08-01,Goldman Sachs,CitiBank New York,58185,77656,-19471
2013-09-01,Goldman Sachs,CitiBank New York,56515,74329,-17814
2013-10-01,Goldman Sachs,CitiBank New York,53284,75737,-22453
2013-11-01,Goldman Sachs,CitiBank New York,53429,72199,-18770
2013-12-01,Goldman Sachs,CitiBank New York,57253,79423,-22170
2014-01-01,Goldman Sachs,CitiBank New York,57386,72442,-15056
2014-02-01,Goldman Sachs,CitiBank New York,55519,76924,-21405
2014-03-01,Goldman Sachs,CitiBank New York,63814,78561,-14747
2014-04-01,Goldman Sachs,CitiBank New York,64168,73879,-9711
2014-05-01,Goldman Sachs,CitiBank New York,68844,76433,-7589
2014-06-01,Goldman Sachs,CitiBank New York,69199,75851,-6652
2014-07-01,Goldman Sachs,CitiBank New York,64547,72812,-8265
2014-08-01,Goldman Sachs,CitiBank New York,67265,74188,-6923
2014-09-01,Goldman Sachs,CitiBank New York,61284,71291,-10007
2014-10-01,Goldman Sachs,CitiBank New York,65789,78245,-12456
2014-11-01,Goldman Sachs,CitiBank New York,63253,74829,-11576
2014-12-01,Goldman Sachs,CitiBank New York,67635,72211,-4576
2015-01-01,Goldman Sachs,CitiBank New York,72922,63672,9250
2015-02-01,Goldman Sachs,CitiBank New York,79966,61681,18285
2015-03-01,Goldman Sachs,CitiBank New York,77252,65471,11781
2015-04-01,Goldman Sachs,CitiBank New York,79183,64417,14766
2015-05-01,Goldman Sachs,CitiBank New York,79745,65971,13774
2015-06-01,Goldman Sachs,CitiBank New York,71622,63635,7987
2015-07-01,Goldman Sachs,CitiBank New York,72427,61662,10765
2015-08-01,Goldman Sachs,CitiBank New York,79419,68143,11276
2015-09-01,Goldman Sachs,CitiBank New York,79899,69281,10618
2015-10-01,Goldman Sachs,CitiBank New York,79182,62842,16340
2015-11-01,Goldman Sachs,CitiBank New York,88458,66281,22177
2015-12-01,Goldman Sachs,CitiBank New York,88754,69653,19101
2016-01-01,Goldman Sachs,CitiBank New York,82851,64922,17929
2016-02-01,Goldman Sachs,CitiBank New York,81684,64784,16900
2016-03-01,Goldman Sachs,CitiBank New York,84263,68411,15852
2016-04-01,Goldman Sachs,CitiBank New York,87948,61614,26334
2016-05-01,Goldman Sachs,CitiBank New York,83167,66349,16818
2016-06-01,Goldman Sachs,CitiBank New York,88849,65621,23228
2016-07-01,Goldman Sachs,CitiBank New York,82289,68962,13327
2016-08-01,Goldman Sachs,CitiBank New York,83964,64511,19453
2016-09-01,Goldman Sachs,CitiBank New York,94539,55127,39412
2016-10-01,Goldman Sachs,CitiBank New York,97681,55711,41970
2016-11-01,Goldman Sachs,CitiBank New York,94582,57633,36949
2016-12-01,Goldman Sachs,CitiBank New York,94922,54682,40240
2017-01-01,Goldman Sachs,CitiBank New York,99344,51394,47950
2017-02-01,Goldman Sachs,CitiBank New York,93989,59853,34136
2017-03-01,Goldman Sachs,CitiBank New York,97379,55479,41900
2017-04-01,Goldman Sachs,CitiBank New York,93374,52371,41003
2017-05-01,Goldman Sachs,CitiBank New York,93551,53344,40207
2017-06-01,Goldman Sachs,CitiBank New York,92398,58849,33549
2017-07-01,Goldman Sachs,CitiBank New York,105381,51824,53557
2017-08-01,Goldman Sachs,CitiBank New York,108678,53126,55552
2017-09-01,Goldman Sachs,CitiBank New York,101496,52975,48521
2017-10-01,Goldman Sachs,CitiBank New York,103518,53686,49832
2017-11-01,Goldman Sachs,CitiBank New York,101578,54276,47302
2017-12-01,Goldman Sachs,CitiBank New York,102992,52516,50476
2018-01-01,Goldman Sachs,CitiBank New York,105816,53834,51982
2018-02-01,Goldman Sachs,CitiBank New York,106333,52338,53995
2018-03-01,Goldman Sachs,CitiBank New York,104483,55435,49048
2018-04-01,Goldman Sachs,CitiBank New York,103194,59841,43353
2010-01-01,Goldman Sachs,CitiBank London,15397,92522,-77125
2010-02-01,Goldman Sachs,CitiBank London,18279,96741,-78462
2010-03-01,Goldman Sachs,CitiBank London,18786,97213,-78427
2010-04-01,Goldman Sachs,CitiBank London,15213,95863,-80650
2010-05-01,Goldman Sachs,CitiBank London,14225,94125,-79900
2010-06-01,Goldman Sachs,CitiBank London,13388,96548,-83160
2010-07-01,Goldman Sachs,CitiBank London,14827,97687,-82860
2010-08-01,Goldman Sachs,CitiBank London,13822,93963,-80141
2010-09-01,Goldman Sachs,CitiBank London,13461,97489,-84028
2010-10-01,Goldman Sachs,CitiBank London,16725,91222,-74497
2010-11-01,Goldman Sachs,CitiBank London,25316,93993,-68677
2010-12-01,Goldman Sachs,CitiBank London,28796,97855,-69059
2011-01-01,Goldman Sachs,CitiBank London,22362,97678,-75316
2011-02-01,Goldman Sachs,CitiBank London,25273,93539,-68266
2011-03-01,Goldman Sachs,CitiBank London,29492,91364,-61872
2011-04-01,Goldman Sachs,CitiBank London,21632,98979,-77347
2011-05-01,Goldman Sachs,CitiBank London,21963,99337,-77374
2011-06-01,Goldman Sachs,CitiBank London,23281,95789,-72508
2011-07-01,Goldman Sachs,CitiBank London,29758,99276,-69518
2011-08-01,Goldman Sachs,CitiBank London,28611,92358,-63747
2011-09-01,Goldman Sachs,CitiBank London,33452,86959,-53507
2011-10-01,Goldman Sachs,CitiBank London,37632,85257,-47625
2011-11-01,Goldman Sachs,CitiBank London,34199,85451,-51252
2011-12-01,Goldman Sachs,CitiBank London,37614,89431,-51817
2012-01-01,Goldman Sachs,CitiBank London,37443,88142,-50699
2012-02-01,Goldman Sachs,CitiBank London,37689,83264,-45575
2012-03-01,Goldman Sachs,CitiBank London,37911,88182,-50271
2012-04-01,Goldman Sachs,CitiBank London,39985,83273,-43288
2012-05-01,Goldman Sachs,CitiBank London,36229,81336,-45107
2012-06-01,Goldman Sachs,CitiBank London,39477,88397,-48920
2012-07-01,Goldman Sachs,CitiBank London,46313,87521,-41208
2012-08-01,Goldman Sachs,CitiBank London,43871,81514,-37643
2012-09-01,Goldman Sachs,CitiBank London,44318,81224,-36906
2012-10-01,Goldman Sachs,CitiBank London,47357,85175,-37818
2012-11-01,Goldman Sachs,CitiBank London,43188,85946,-42758
2012-12-01,Goldman Sachs,CitiBank London,41986,85444,-43458
2013-01-01,Goldman Sachs,CitiBank London,44579,87527,-42948
2013-02-01,Goldman Sachs,CitiBank London,43637,88595,-44958
2013-03-01,Goldman Sachs,CitiBank London,47642,83636,-35994
2013-04-01,Goldman Sachs,CitiBank London,47631,86919,-39288
2013-05-01,Goldman Sachs,CitiBank London,52235,73384,-21149
2013-06-01,Goldman Sachs,CitiBank London,51687,79412,-27725
2013-07-01,Goldman Sachs,CitiBank London,54476,72716,-18240
2013-08-01,Goldman Sachs,CitiBank London,59327,75385,-16058
2013-09-01,Goldman Sachs,CitiBank London,56533,76438,-19905
2013-10-01,Goldman Sachs,CitiBank London,53239,73499,-20260
2013-11-01,Goldman Sachs,CitiBank London,54593,77131,-22538
2013-12-01,Goldman Sachs,CitiBank London,59943,77628,-17685
2014-01-01,Goldman Sachs,CitiBank London,56686,78224,-21538
2014-02-01,Goldman Sachs,CitiBank London,51358,75477,-24119
2014-03-01,Goldman Sachs,CitiBank London,65465,77885,-12420
2014-04-01,Goldman Sachs,CitiBank London,62489,71896,-9407
2014-05-01,Goldman Sachs,CitiBank London,65854,72396,-6542
2014-06-01,Goldman Sachs,CitiBank London,62521,75594,-13073
2014-07-01,Goldman Sachs,CitiBank London,67149,77197,-10048
2014-08-01,Goldman Sachs,CitiBank London,67249,74235,-6986
2014-09-01,Goldman Sachs,CitiBank London,68386,73386,-5000
2014-10-01,Goldman Sachs,CitiBank London,68864,78931,-10067
2014-11-01,Goldman Sachs,CitiBank London,62155,77311,-15156
2014-12-01,Goldman Sachs,CitiBank London,66147,71116,-4969
2015-01-01,Goldman Sachs,CitiBank London,78815,61973,16842
2015-02-01,Goldman Sachs,CitiBank London,72619,66198,6421
2015-03-01,Goldman Sachs,CitiBank London,71961,62975,8986
2015-04-01,Goldman Sachs,CitiBank London,74245,66762,7483
2015-05-01,Goldman Sachs,CitiBank London,71642,64182,7460
2015-06-01,Goldman Sachs,CitiBank London,77448,68859,8589
2015-07-01,Goldman Sachs,CitiBank London,78147,69881,8266
2015-08-01,Goldman Sachs,CitiBank London,71348,69585,1763
2015-09-01,Goldman Sachs,CitiBank London,75887,62443,13444
2015-10-01,Goldman Sachs,CitiBank London,71549,63241,8308
2015-11-01,Goldman Sachs,CitiBank London,88162,68265,19897
2015-12-01,Goldman Sachs,CitiBank London,85113,63582,21531
2016-01-01,Goldman Sachs,CitiBank London,81714,68514,13200
2016-02-01,Goldman Sachs,CitiBank London,82148,68613,13535
2016-03-01,Goldman Sachs,CitiBank London,85649,67627,18022
2016-04-01,Goldman Sachs,CitiBank London,89843,69665,20178
2016-05-01,Goldman Sachs,CitiBank London,84984,64764,20220
2016-06-01,Goldman Sachs,CitiBank London,82347,69133,13214
2016-07-01,Goldman Sachs,CitiBank London,89554,67966,21588
2016-08-01,Goldman Sachs,CitiBank London,89535,65228,24307
2016-09-01,Goldman Sachs,CitiBank London,98386,55928,42458
2016-10-01,Goldman Sachs,CitiBank London,92921,53217,39704
2016-11-01,Goldman Sachs,CitiBank London,98381,55891,42490
2016-12-01,Goldman Sachs,CitiBank London,96267,56938,39329
2017-01-01,Goldman Sachs,CitiBank London,99595,55894,43701
2017-02-01,Goldman Sachs,CitiBank London,93393,58953,34440
2017-03-01,Goldman Sachs,CitiBank London,93664,52126,41538
2017-04-01,Goldman Sachs,CitiBank London,94624,53631,40993
2017-05-01,Goldman Sachs,CitiBank London,94685,51516,43169
2017-06-01,Goldman Sachs,CitiBank London,99315,55882,43433
2017-07-01,Goldman Sachs,CitiBank London,101884,52482,49402
2017-08-01,Goldman Sachs,CitiBank London,102622,55384,47238
2017-09-01,Goldman Sachs,CitiBank London,103352,58777,44575
2017-10-01,Goldman Sachs,CitiBank London,105429,58774,46655
2017-11-01,Goldman Sachs,CitiBank London,105868,57378,48490
2017-12-01,Goldman Sachs,CitiBank London,104129,53977,50152
2018-01-01,Goldman Sachs,CitiBank London,109388,59489,49899
2018-02-01,Goldman Sachs,CitiBank London,106691,56589,50102
2018-03-01,Goldman Sachs,CitiBank London,105553,56422,49131
2018-04-01,Goldman Sachs,CitiBank London,108868,55677,53191
2010-01-01,Goldman Sachs,CitiBank Pune,16323,99267,-82944
2010-02-01,Goldman Sachs,CitiBank Pune,11879,91652,-79773
2010-03-01,Goldman Sachs,CitiBank Pune,12124,92662,-80538
2010-04-01,Goldman Sachs,CitiBank Pune,16445,93146,-76701
2010-05-01,Goldman Sachs,CitiBank Pune,11748,91653,-79905
2010-06-01,Goldman Sachs,CitiBank Pune,17128,95376,-78248
2010-07-01,Goldman Sachs,CitiBank Pune,18763,96791,-78028
2010-08-01,Goldman Sachs,CitiBank Pune,12348,91966,-79618
2010-09-01,Goldman Sachs,CitiBank Pune,15451,98577,-83126
2010-10-01,Goldman Sachs,CitiBank Pune,14469,99244,-84775
2010-11-01,Goldman Sachs,CitiBank Pune,21464,94384,-72920
2010-12-01,Goldman Sachs,CitiBank Pune,21782,91875,-70093
2011-01-01,Goldman Sachs,CitiBank Pune,29278,92341,-63063
2011-02-01,Goldman Sachs,CitiBank Pune,26134,92411,-66277
2011-03-01,Goldman Sachs,CitiBank Pune,21747,99853,-78106
2011-04-01,Goldman Sachs,CitiBank Pune,25217,95591,-70374
2011-05-01,Goldman Sachs,CitiBank Pune,25119,94553,-69434
2011-06-01,Goldman Sachs,CitiBank Pune,27611,91896,-64285
2011-07-01,Goldman Sachs,CitiBank Pune,22896,93787,-70891
2011-08-01,Goldman Sachs,CitiBank Pune,24893,98844,-73951
2011-09-01,Goldman Sachs,CitiBank Pune,37642,82671,-45029
2011-10-01,Goldman Sachs,CitiBank Pune,32691,84349,-51658
2011-11-01,Goldman Sachs,CitiBank Pune,31453,86244,-54791
2011-12-01,Goldman Sachs,CitiBank Pune,35356,89585,-54229
2012-01-01,Goldman Sachs,CitiBank Pune,31881,86212,-54331
2012-02-01,Goldman Sachs,CitiBank Pune,33868,87963,-54095
2012-03-01,Goldman Sachs,CitiBank Pune,37293,89285,-51992
2012-04-01,Goldman Sachs,CitiBank Pune,35521,88714,-53193
2012-05-01,Goldman Sachs,CitiBank Pune,32248,85914,-53666
2012-06-01,Goldman Sachs,CitiBank Pune,34424,83626,-49202
2012-07-01,Goldman Sachs,CitiBank Pune,44783,83337,-38554
2012-08-01,Goldman Sachs,CitiBank Pune,46759,86781,-40022
2012-09-01,Goldman Sachs,CitiBank Pune,43999,88565,-44566
2012-10-01,Goldman Sachs,CitiBank Pune,44347,85237,-40890
2012-11-01,Goldman Sachs,CitiBank Pune,47964,85314,-37350
2012-12-01,Goldman Sachs,CitiBank Pune,47129,85657,-38528
2013-01-01,Goldman Sachs,CitiBank Pune,47365,81247,-33882
2013-02-01,Goldman Sachs,CitiBank Pune,49617,86667,-37050
2013-03-01,Goldman Sachs,CitiBank Pune,41857,87887,-46030
2013-04-01,Goldman Sachs,CitiBank Pune,45724,85131,-39407
2013-05-01,Goldman Sachs,CitiBank Pune,51897,76253,-24356
2013-06-01,Goldman Sachs,CitiBank Pune,57577,71525,-13948
2013-07-01,Goldman Sachs,CitiBank Pune,52119,73211,-21092
2013-08-01,Goldman Sachs,CitiBank Pune,57958,75378,-17420
2013-09-01,Goldman Sachs,CitiBank Pune,57897,75782,-17885
2013-10-01,Goldman Sachs,CitiBank Pune,59485,71435,-11950
2013-11-01,Goldman Sachs,CitiBank Pune,52654,75858,-23204
2013-12-01,Goldman Sachs,CitiBank Pune,59783,74259,-14476
2014-01-01,Goldman Sachs,CitiBank Pune,51245,79761,-28516
2014-02-01,Goldman Sachs,CitiBank Pune,59355,74869,-15514
2014-03-01,Goldman Sachs,CitiBank Pune,62845,78167,-15322
2014-04-01,Goldman Sachs,CitiBank Pune,65791,78178,-12387
2014-05-01,Goldman Sachs,CitiBank Pune,64642,74722,-10080
2014-06-01,Goldman Sachs,CitiBank Pune,67965,72155,-4190
2014-07-01,Goldman Sachs,CitiBank Pune,69847,76715,-6868
2014-08-01,Goldman Sachs,CitiBank Pune,63545,73745,-10200
2014-09-01,Goldman Sachs,CitiBank Pune,62159,74625,-12466
2014-10-01,Goldman Sachs,CitiBank Pune,62895,77946,-15051
2014-11-01,Goldman Sachs,CitiBank Pune,65611,78236,-12625
2014-12-01,Goldman Sachs,CitiBank Pune,65787,77383,-11596
2015-01-01,Goldman Sachs,CitiBank Pune,76463,61361,15102
2015-02-01,Goldman Sachs,CitiBank Pune,73396,64542,8854
2015-03-01,Goldman Sachs,CitiBank Pune,73167,69483,3684
2015-04-01,Goldman Sachs,CitiBank Pune,77341,61558,15783
2015-05-01,Goldman Sachs,CitiBank Pune,72924,68191,4733
2015-06-01,Goldman Sachs,CitiBank Pune,72846,63961,8885
2015-07-01,Goldman Sachs,CitiBank Pune,78489,69886,8603
2015-08-01,Goldman Sachs,CitiBank Pune,73813,64371,9442
2015-09-01,Goldman Sachs,CitiBank Pune,74734,63822,10912
2015-10-01,Goldman Sachs,CitiBank Pune,73276,65243,8033
2015-11-01,Goldman Sachs,CitiBank Pune,84981,65223,19758
2015-12-01,Goldman Sachs,CitiBank Pune,87535,63687,23848
2016-01-01,Goldman Sachs,CitiBank Pune,86657,65247,21410
2016-02-01,Goldman Sachs,CitiBank Pune,89529,62587,26942
2016-03-01,Goldman Sachs,CitiBank Pune,85479,69184,16295
2016-04-01,Goldman Sachs,CitiBank Pune,82985,65323,17662
2016-05-01,Goldman Sachs,CitiBank Pune,84625,61921,22704
2016-06-01,Goldman Sachs,CitiBank Pune,82955,63929,19026
2016-07-01,Goldman Sachs,CitiBank Pune,82863,63887,18976
2016-08-01,Goldman Sachs,CitiBank Pune,81128,66946,14182
2016-09-01,Goldman Sachs,CitiBank Pune,99249,58397,40852
2016-10-01,Goldman Sachs,CitiBank Pune,91949,52557,39392
2016-11-01,Goldman Sachs,CitiBank Pune,93268,58938,34330
2016-12-01,Goldman Sachs,CitiBank Pune,92569,55733,36836
2017-01-01,Goldman Sachs,CitiBank Pune,91577,52139,39438
2017-02-01,Goldman Sachs,CitiBank Pune,94977,58381,36596
2017-03-01,Goldman Sachs,CitiBank Pune,93774,54856,38918
2017-04-01,Goldman Sachs,CitiBank Pune,98469,52624,45845
2017-05-01,Goldman Sachs,CitiBank Pune,92318,56264,36054
2017-06-01,Goldman Sachs,CitiBank Pune,99566,51331,48235
2017-07-01,Goldman Sachs,CitiBank Pune,102563,52852,49711
2017-08-01,Goldman Sachs,CitiBank Pune,104243,53578,50665
2017-09-01,Goldman Sachs,CitiBank Pune,102191,52437,49754
2017-10-01,Goldman Sachs,CitiBank Pune,105491,52341,53150
2017-11-01,Goldman Sachs,CitiBank Pune,104274,53136,51138
2017-12-01,Goldman Sachs,CitiBank Pune,103598,54934,48664
2018-01-01,Goldman Sachs,CitiBank Pune,104694,55243,49451
2018-02-01,Goldman Sachs,CitiBank Pune,106186,51125,55061
2018-03-01,Goldman Sachs,CitiBank Pune,108824,55959,52865
2018-04-01,Goldman Sachs,CitiBank Pune,103643,52983,50660
2010-01-01,Goldman Sachs,CitiBank Singapore,17715,99215,-81500
2010-02-01,Goldman Sachs,CitiBank Singapore,19182,95937,-76755
2010-03-01,Goldman Sachs,CitiBank Singapore,18917,99888,-80971
2010-04-01,Goldman Sachs,CitiBank Singapore,14375,99177,-84802
2010-05-01,Goldman Sachs,CitiBank Singapore,15294,97235,-81941
2010-06-01,Goldman Sachs,CitiBank Singapore,18215,97252,-79037
2010-07-01,Goldman Sachs,CitiBank Singapore,17595,94661,-77066
2010-08-01,Goldman Sachs,CitiBank Singapore,15969,94542,-78573
2010-09-01,Goldman Sachs,CitiBank Singapore,19866,98821,-78955
2010-10-01,Goldman Sachs,CitiBank Singapore,12459,96351,-83892
2010-11-01,Goldman Sachs,CitiBank Singapore,28493,92465,-63972
2010-12-01,Goldman Sachs,CitiBank Singapore,21483,95524,-74041
2011-01-01,Goldman Sachs,CitiBank Singapore,21275,96945,-75670
2011-02-01,Goldman Sachs,CitiBank Singapore,28842,98993,-70151
2011-03-01,Goldman Sachs,CitiBank Singapore,21829,98581,-76752
2011-04-01,Goldman Sachs,CitiBank Singapore,29459,91873,-62414
2011-05-01,Goldman Sachs,CitiBank Singapore,27967,98858,-70891
2011-06-01,Goldman Sachs,CitiBank Singapore,23282,93737,-70455
2011-07-01,Goldman Sachs,CitiBank Singapore,28238,98925,-70687
2011-08-01,Goldman Sachs,CitiBank Singapore,28449,93922,-65473
2011-09-01,Goldman Sachs,CitiBank Singapore,38351,87735,-49384
2011-10-01,Goldman Sachs,CitiBank Singapore,35437,81743,-46306
2011-11-01,Goldman Sachs,CitiBank Singapore,33671,87944,-54273
2011-12-01,Goldman Sachs,CitiBank Singapore,35847,89744,-53897
2012-01-01,Goldman Sachs,CitiBank Singapore,32572,84283,-51711
2012-02-01,Goldman Sachs,CitiBank Singapore,32236,85499,-53263
2012-03-01,Goldman Sachs,CitiBank Singapore,39526,82371,-42845
2012-04-01,Goldman Sachs,CitiBank Singapore,31474,81666,-50192
2012-05-01,Goldman Sachs,CitiBank Singapore,32739,89679,-56940
2012-06-01,Goldman Sachs,CitiBank Singapore,33883,82111,-48228
2012-07-01,Goldman Sachs,CitiBank Singapore,49457,89746,-40289
2012-08-01,Goldman Sachs,CitiBank Singapore,46854,87522,-40668
2012-09-01,Goldman Sachs,CitiBank Singapore,47728,82164,-34436
2012-10-01,Goldman Sachs,CitiBank Singapore,46731,81324,-34593
2012-11-01,Goldman Sachs,CitiBank Singapore,47242,86887,-39645
2012-12-01,Goldman Sachs,CitiBank Singapore,43356,81615,-38259
2013-01-01,Goldman Sachs,CitiBank Singapore,49521,82744,-33223
2013-02-01,Goldman Sachs,CitiBank Singapore,41713,87845,-46132
2013-03-01,Goldman Sachs,CitiBank Singapore,49265,89315,-40050
2013-04-01,Goldman Sachs,CitiBank Singapore,49596,88917,-39321
2013-05-01,Goldman Sachs,CitiBank Singapore,54162,73382,-19220
2013-06-01,Goldman Sachs,CitiBank Singapore,55477,76572,-21095
2013-07-01,Goldman Sachs,CitiBank Singapore,59868,74818,-14950
2013-08-01,Goldman Sachs,CitiBank Singapore,51859,76136,-24277
2013-09-01,Goldman Sachs,CitiBank Singapore,57959,75828,-17869
2013-10-01,Goldman Sachs,CitiBank Singapore,53134,79279,-26145
2013-11-01,Goldman Sachs,CitiBank Singapore,59424,73849,-14425
2013-12-01,Goldman Sachs,CitiBank Singapore,59584,73441,-13857
2014-01-01,Goldman Sachs,CitiBank Singapore,57675,74838,-17163
2014-02-01,Goldman Sachs,CitiBank Singapore,57937,77542,-19605
2014-03-01,Goldman Sachs,CitiBank Singapore,63651,79876,-16225
2014-04-01,Goldman Sachs,CitiBank Singapore,66813,73373,-6560
2014-05-01,Goldman Sachs,CitiBank Singapore,63233,76542,-13309
2014-06-01,Goldman Sachs,CitiBank Singapore,63297,72792,-9495
2014-07-01,Goldman Sachs,CitiBank Singapore,63638,76322,-12684
2014-08-01,Goldman Sachs,CitiBank Singapore,67967,72888,-4921
2014-09-01,Goldman Sachs,CitiBank Singapore,69682,75363,-5681
2014-10-01,Goldman Sachs,CitiBank Singapore,68171,76283,-8112
2014-11-01,Goldman Sachs,CitiBank Singapore,68676,74438,-5762
2014-12-01,Goldman Sachs,CitiBank Singapore,66557,74399,-7842
2015-01-01,Goldman Sachs,CitiBank Singapore,78338,69862,8476
2015-02-01,Goldman Sachs,CitiBank Singapore,74422,68181,6241
2015-03-01,Goldman Sachs,CitiBank Singapore,79992,63183,16809
2015-04-01,Goldman Sachs,CitiBank Singapore,71342,67222,4120
2015-05-01,Goldman Sachs,CitiBank Singapore,78367,62462,15905
2015-06-01,Goldman Sachs,CitiBank Singapore,79423,65438,13985
2015-07-01,Goldman Sachs,CitiBank Singapore,79176,66979,12197
2015-08-01,Goldman Sachs,CitiBank Singapore,74268,63476,10792
2015-09-01,Goldman Sachs,CitiBank Singapore,76519,64669,11850
2015-10-01,Goldman Sachs,CitiBank Singapore,75774,67717,8057
2015-11-01,Goldman Sachs,CitiBank Singapore,89524,69281,20243
2015-12-01,Goldman Sachs,CitiBank Singapore,81122,69776,11346
2016-01-01,Goldman Sachs,CitiBank Singapore,81938,62568,19370
2016-02-01,Goldman Sachs,CitiBank Singapore,86792,68474,18318
2016-03-01,Goldman Sachs,CitiBank Singapore,89419,67289,22130
2016-04-01,Goldman Sachs,CitiBank Singapore,85551,65196,20355
2016-05-01,Goldman Sachs,CitiBank Singapore,86651,62328,24323
2016-06-01,Goldman Sachs,CitiBank Singapore,81194,64672,16522
2016-07-01,Goldman Sachs,CitiBank Singapore,88184,61312,26872
2016-08-01,Goldman Sachs,CitiBank Singapore,89575,61576,27999
2016-09-01,Goldman Sachs,CitiBank Singapore,92171,51264,40907
2016-10-01,Goldman Sachs,CitiBank Singapore,99498,58378,41120
2016-11-01,Goldman Sachs,CitiBank Singapore,95557,57441,38116
2016-12-01,Goldman Sachs,CitiBank Singapore,99957,51229,48728
2017-01-01,Goldman Sachs,CitiBank Singapore,96898,54969,41929
2017-02-01,Goldman Sachs,CitiBank Singapore,91967,53217,38750
2017-03-01,Goldman Sachs,CitiBank Singapore,92426,56446,35980
2017-04-01,Goldman Sachs,CitiBank Singapore,91517,59158,32359
2017-05-01,Goldman Sachs,CitiBank Singapore,96384,57366,39018
2017-06-01,Goldman Sachs,CitiBank Singapore,94849,54132,40717
2017-07-01,Goldman Sachs,CitiBank Singapore,109348,52783,56565
2017-08-01,Goldman Sachs,CitiBank Singapore,101326,55555,45771
2017-09-01,Goldman Sachs,CitiBank Singapore,105999,59443,46556
2017-10-01,Goldman Sachs,CitiBank Singapore,109286,54435,54851
2017-11-01,Goldman Sachs,CitiBank Singapore,107765,59123,48642
2017-12-01,Goldman Sachs,CitiBank Singapore,102665,58812,43853
2018-01-01,Goldman Sachs,CitiBank Singapore,101256,54867,46389
2018-02-01,Goldman Sachs,CitiBank Singapore,102575,54154,48421
2018-03-01,Goldman Sachs,CitiBank Singapore,105936,52177,53759
2018-04-01,Goldman Sachs,CitiBank Singapore,109619,58233,51386
2010-01-01,Goldman Sachs,CitiBank HongKong,18717,94457,-75740
2010-02-01,Goldman Sachs,CitiBank HongKong,19735,97951,-78216
2010-03-01,Goldman Sachs,CitiBank HongKong,14371,99814,-85443
2010-04-01,Goldman Sachs,CitiBank HongKong,15348,93511,-78163
2010-05-01,Goldman Sachs,CitiBank HongKong,18225,96314,-78089
2010-06-01,Goldman Sachs,CitiBank HongKong,13347,97348,-84001
2010-07-01,Goldman Sachs,CitiBank HongKong,16735,94676,-77941
2010-08-01,Goldman Sachs,CitiBank HongKong,15221,96235,-81014
2010-09-01,Goldman Sachs,CitiBank HongKong,16988,94378,-77390
2010-10-01,Goldman Sachs,CitiBank HongKong,14682,96916,-82234
2010-11-01,Goldman Sachs,CitiBank HongKong,22785,98879,-76094
2010-12-01,Goldman Sachs,CitiBank HongKong,23665,91995,-68330
2011-01-01,Goldman Sachs,CitiBank HongKong,26375,98114,-71739
2011-02-01,Goldman Sachs,CitiBank HongKong,28291,98775,-70484
2011-03-01,Goldman Sachs,CitiBank HongKong,25835,98686,-72851
2011-04-01,Goldman Sachs,CitiBank HongKong,24616,97333,-72717
2011-05-01,Goldman Sachs,CitiBank HongKong,23655,93632,-69977
2011-06-01,Goldman Sachs,CitiBank HongKong,23432,99742,-76310
2011-07-01,Goldman Sachs,CitiBank HongKong,22183,95628,-73445
2011-08-01,Goldman Sachs,CitiBank HongKong,21321,92642,-71321
2011-09-01,Goldman Sachs,CitiBank HongKong,32729,84393,-51664
2011-10-01,Goldman Sachs,CitiBank HongKong,38145,87281,-49136
2011-11-01,Goldman Sachs,CitiBank HongKong,34631,89996,-55365
2011-12-01,Goldman Sachs,CitiBank HongKong,31865,82435,-50570
2012-01-01,Goldman Sachs,CitiBank HongKong,39151,87235,-48084
2012-02-01,Goldman Sachs,CitiBank HongKong,33524,88975,-55451
2012-03-01,Goldman Sachs,CitiBank HongKong,35249,84973,-49724
2012-04-01,Goldman Sachs,CitiBank HongKong,37459,85771,-48312
2012-05-01,Goldman Sachs,CitiBank HongKong,35559,88698,-53139
2012-06-01,Goldman Sachs,CitiBank HongKong,33455,89577,-56122
2012-07-01,Goldman Sachs,CitiBank HongKong,47866,88278,-40412
2012-08-01,Goldman Sachs,CitiBank HongKong,45774,82462,-36688
2012-09-01,Goldman Sachs,CitiBank HongKong,44898,84634,-39736
2012-10-01,Goldman Sachs,CitiBank HongKong,41652,83989,-42337
2012-11-01,Goldman Sachs,CitiBank HongKong,47694,81165,-33471
2012-12-01,Goldman Sachs,CitiBank HongKong,49457,88711,-39254
2013-01-01,Goldman Sachs,CitiBank HongKong,44865,88411,-43546
2013-02-01,Goldman Sachs,CitiBank HongKong,46368,89972,-43604
2013-03-01,Goldman Sachs,CitiBank HongKong,45487,84898,-39411
2013-04-01,Goldman Sachs,CitiBank HongKong,44764,83786,-39022
2013-05-01,Goldman Sachs,CitiBank HongKong,56727,76853,-20126
2013-06-01,Goldman Sachs,CitiBank HongKong,58489,73827,-15338
2013-07-01,Goldman Sachs,CitiBank HongKong,58118,77285,-19167
2013-08-01,Goldman Sachs,CitiBank HongKong,58949,75162,-16213
2013-09-01,Goldman Sachs,CitiBank HongKong,51797,76355,-24558
2013-10-01,Goldman Sachs,CitiBank HongKong,56287,73551,-17264
2013-11-01,Goldman Sachs,CitiBank HongKong,59956,72284,-12328
2013-12-01,Goldman Sachs,CitiBank HongKong,57548,78261,-20713
2014-01-01,Goldman Sachs,CitiBank HongKong,57155,72918,-15763
2014-02-01,Goldman Sachs,CitiBank HongKong,55868,74598,-18730
2014-03-01,Goldman Sachs,CitiBank HongKong,64196,72687,-8491
2014-04-01,Goldman Sachs,CitiBank HongKong,67886,75167,-7281
2014-05-01,Goldman Sachs,CitiBank HongKong,63337,72231,-8894
2014-06-01,Goldman Sachs,CitiBank HongKong,68838,78412,-9574
2014-07-01,Goldman Sachs,CitiBank HongKong,64477,73829,-9352
2014-08-01,Goldman Sachs,CitiBank HongKong,65664,79735,-14071
2014-09-01,Goldman Sachs,CitiBank HongKong,65414,77628,-12214
2014-10-01,Goldman Sachs,CitiBank HongKong,63244,73458,-10214
2014-11-01,Goldman Sachs,CitiBank HongKong,66246,73677,-7431
2014-12-01,Goldman Sachs,CitiBank HongKong,66615,71717,-5102
2015-01-01,Goldman Sachs,CitiBank HongKong,74914,63176,11738
2015-02-01,Goldman Sachs,CitiBank HongKong,79515,66719,12796
2015-03-01,Goldman Sachs,CitiBank HongKong,73963,63616,10347
2015-04-01,Goldman Sachs,CitiBank HongKong,76876,63366,13510
2015-05-01,Goldman Sachs,CitiBank HongKong,79952,68895,11057
2015-06-01,Goldman Sachs,CitiBank HongKong,78349,64545,13804
2015-07-01,Goldman Sachs,CitiBank HongKong,72381,61511,10870
2015-08-01,Goldman Sachs,CitiBank HongKong,75948,68864,7084
2015-09-01,Goldman Sachs,CitiBank HongKong,77158,67146,10012
2015-10-01,Goldman Sachs,CitiBank HongKong,74364,66997,7367
2015-11-01,Goldman Sachs,CitiBank HongKong,85844,62537,23307
2015-12-01,Goldman Sachs,CitiBank HongKong,83721,66125,17596
2016-01-01,Goldman Sachs,CitiBank HongKong,85173,64384,20789
2016-02-01,Goldman Sachs,CitiBank HongKong,85786,62994,22792
2016-03-01,Goldman Sachs,CitiBank HongKong,84997,64323,20674
2016-04-01,Goldman Sachs,CitiBank HongKong,89949,65478,24471
2016-05-01,Goldman Sachs,CitiBank HongKong,81464,65285,16179
2016-06-01,Goldman Sachs,CitiBank HongKong,88995,62478,26517
2016-07-01,Goldman Sachs,CitiBank HongKong,88341,67386,20955
2016-08-01,Goldman Sachs,CitiBank HongKong,85891,62767,23124
2016-09-01,Goldman Sachs,CitiBank HongKong,96279,54242,42037
2016-10-01,Goldman Sachs,CitiBank HongKong,97321,54336,42985
2016-11-01,Goldman Sachs,CitiBank HongKong,91783,51439,40344
2016-12-01,Goldman Sachs,CitiBank HongKong,96457,57375,39082
2017-01-01,Goldman Sachs,CitiBank HongKong,95922,54159,41763
2017-02-01,Goldman Sachs,CitiBank HongKong,98626,58897,39729
2017-03-01,Goldman Sachs,CitiBank HongKong,92145,56943,35202
2017-04-01,Goldman Sachs,CitiBank HongKong,91277,51629,39648
2017-05-01,Goldman Sachs,CitiBank HongKong,92136,57185,34951
2017-06-01,Goldman Sachs,CitiBank HongKong,98469,54784,43685
2017-07-01,Goldman Sachs,CitiBank HongKong,107146,59673,47473
2017-08-01,Goldman Sachs,CitiBank HongKong,105243,51432,53811
2017-09-01,Goldman Sachs,CitiBank HongKong,103741,58288,45453
2017-10-01,Goldman Sachs,CitiBank HongKong,102317,56435,45882
2017-11-01,Goldman Sachs,CitiBank HongKong,107823,56563,51260
2017-12-01,Goldman Sachs,CitiBank HongKong,105747,57697,48050
2018-01-01,Goldman Sachs,CitiBank HongKong,102295,52824,49471
2018-02-01,Goldman Sachs,CitiBank HongKong,104464,51265,53199
2018-03-01,Goldman Sachs,CitiBank HongKong,101261,51673,49588
2018-04-01,Goldman Sachs,CitiBank HongKong,108926,55159,53767
2010-01-01,Deutsche Bank,CitiBank New York,19648,97738,-78090
2010-02-01,Deutsche Bank,CitiBank New York,18922,95153,-76231
2010-03-01,Deutsche Bank,CitiBank New York,11168,96396,-85228
2010-04-01,Deutsche Bank,CitiBank New York,18535,96936,-78401
2010-05-01,Deutsche Bank,CitiBank New York,15665,97968,-82303
2010-06-01,Deutsche Bank,CitiBank New York,16727,92811,-76084
2010-07-01,Deutsche Bank,CitiBank New York,16715,94498,-77783
2010-08-01,Deutsche Bank,CitiBank New York,12687,94518,-81831
2010-09-01,Deutsche Bank,CitiBank New York,18832,91297,-72465
2010-10-01,Deutsche Bank,CitiBank New York,11221,97133,-85912
2010-11-01,Deutsche Bank,CitiBank New York,29763,91858,-62095
2010-12-01,Deutsche Bank,CitiBank New York,28534,98222,-69688
2011-01-01,Deutsche Bank,CitiBank New York,29364,92135,-62771
2011-02-01,Deutsche Bank,CitiBank New York,29319,95114,-65795
2011-03-01,Deutsche Bank,CitiBank New York,23622,91139,-67517
2011-04-01,Deutsche Bank,CitiBank New York,22713,92333,-69620
2011-05-01,Deutsche Bank,CitiBank New York,29978,99385,-69407
2011-06-01,Deutsche Bank,CitiBank New York,24825,95614,-70789
2011-07-01,Deutsche Bank,CitiBank New York,23952,98435,-74483
2011-08-01,Deutsche Bank,CitiBank New York,21548,96165,-74617
2011-09-01,Deutsche Bank,CitiBank New York,34532,84454,-49922
2011-10-01,Deutsche Bank,CitiBank New York,37671,85497,-47826
2011-11-01,Deutsche Bank,CitiBank New York,36569,83553,-46984
2011-12-01,Deutsche Bank,CitiBank New York,31128,87555,-56427
2012-01-01,Deutsche Bank,CitiBank New York,34289,86597,-52308
2012-02-01,Deutsche Bank,CitiBank New York,38221,83251,-45030
2012-03-01,Deutsche Bank,CitiBank New York,33228,82912,-49684
2012-04-01,Deutsche Bank,CitiBank New York,35477,85691,-50214
2012-05-01,Deutsche Bank,CitiBank New York,33429,81139,-47710
2012-06-01,Deutsche Bank,CitiBank New York,38254,89184,-50930
2012-07-01,Deutsche Bank,CitiBank New York,45499,81618,-36119
2012-08-01,Deutsche Bank,CitiBank New York,47798,82167,-34369
2012-09-01,Deutsche Bank,CitiBank New York,42454,87443,-44989
2012-10-01,Deutsche Bank,CitiBank New York,42817,81648,-38831
2012-11-01,Deutsche Bank,CitiBank New York,43726,89942,-46216
2012-12-01,Deutsche Bank,CitiBank New York,47142,82423,-35281
2013-01-01,Deutsche Bank,CitiBank New York,42398,81226,-38828
2013-02-01,Deutsche Bank,CitiBank New York,45642,85219,-39577
2013-03-01,Deutsche Bank,CitiBank New York,43919,85892,-41973
2013-04-01,Deutsche Bank,CitiBank New York,47838,83461,-35623
2013-05-01,Deutsche Bank,CitiBank New York,51114,79166,-28052
2013-06-01,Deutsche Bank,CitiBank New York,56226,76485,-20259
2013-07-01,Deutsche Bank,CitiBank New York,52296,74882,-22586
2013-08-01,Deutsche Bank,CitiBank New York,58981,75989,-17008
2013-09-01,Deutsche Bank,CitiBank New York,57388,75245,-17857
2013-10-01,Deutsche Bank,CitiBank New York,55192,78775,-23583
2013-11-01,Deutsche Bank,CitiBank New York,51473,76685,-25212
2013-12-01,Deutsche Bank,CitiBank New York,58732,79183,-20451
2014-01-01,Deutsche Bank,CitiBank New York,51284,72813,-21529
2014-02-01,Deutsche Bank,CitiBank New York,53758,71256,-17498
2014-03-01,Deutsche Bank,CitiBank New York,65334,71275,-5941
2014-04-01,Deutsche Bank,CitiBank New York,67329,77171,-9842
2014-05-01,Deutsche Bank,CitiBank New York,62175,72957,-10782
2014-06-01,Deutsche Bank,CitiBank New York,64148,71464,-7316
2014-07-01,Deutsche Bank,CitiBank New York,67515,78131,-10616
2014-08-01,Deutsche Bank,CitiBank New York,64614,75517,-10903
2014-09-01,Deutsche Bank,CitiBank New York,67982,71955,-3973
2014-10-01,Deutsche Bank,CitiBank New York,67397,73272,-5875
2014-11-01,Deutsche Bank,CitiBank New York,64782,72974,-8192
2014-12-01,Deutsche Bank,CitiBank New York,67627,78126,-10499
2015-01-01,Deutsche Bank,CitiBank New York,79881,64582,15299
2015-02-01,Deutsche Bank,CitiBank New York,73551,68953,4598
2015-03-01,Deutsche Bank,CitiBank New York,71731,66346,5385
2015-04-01,Deutsche Bank,CitiBank New York,75881,64818,11063
2015-05-01,Deutsche Bank,CitiBank New York,76437,68387,8050
2015-06-01,Deutsche Bank,CitiBank New York,77132,62165,14967
2015-07-01,Deutsche Bank,CitiBank New York,74564,65658,8906
2015-08-01,Deutsche Bank,CitiBank New York,76197,65856,10341
2015-09-01,Deutsche Bank,CitiBank New York,75893,62548,13345
2015-10-01,Deutsche Bank,CitiBank New York,73113,66194,6919
2015-11-01,Deutsche Bank,CitiBank New York,88319,61389,26930
2015-12-01,Deutsche Bank,CitiBank New York,82982,65329,17653
2016-01-01,Deutsche Bank,CitiBank New York,85862,67677,18185
2016-02-01,Deutsche Bank,CitiBank New York,87724,64414,23310
2016-03-01,Deutsche Bank,CitiBank New York,85751,67556,18195
2016-04-01,Deutsche Bank,CitiBank New York,84127,63884,20243
2016-05-01,Deutsche Bank,CitiBank New York,88883,69176,19707
2016-06-01,Deutsche Bank,CitiBank New York,87431,64176,23255
2016-07-01,Deutsche Bank,CitiBank New York,87757,63861,23896
2016-08-01,Deutsche Bank,CitiBank New York,86374,62374,24000
2016-09-01,Deutsche Bank,CitiBank New York,93776,56735,37041
2016-10-01,Deutsche Bank,CitiBank New York,94827,56923,37904
2016-11-01,Deutsche Bank,CitiBank New York,96637,52957,43680
2016-12-01,Deutsche Bank,CitiBank New York,99857,55455,44402
2017-01-01,Deutsche Bank,CitiBank New York,91785,51739,40046
2017-02-01,Deutsche Bank,CitiBank New York,92325,56937,35388
2017-03-01,Deutsche Bank,CitiBank New York,91641,53955,37686
2017-04-01,Deutsche Bank,CitiBank New York,93799,58741,35058
2017-05-01,Deutsche Bank,CitiBank New York,97425,57775,39650
2017-06-01,Deutsche Bank,CitiBank New York,93662,56278,37384
2017-07-01,Deutsche Bank,CitiBank New York,104274,57733,46541
2017-08-01,Deutsche Bank,CitiBank New York,105399,53973,51426
2017-09-01,Deutsche Bank,CitiBank New York,101113,52185,48928
2017-10-01,Deutsche Bank,CitiBank New York,106462,56819,49643
2017-11-01,Deutsche Bank,CitiBank New York,101976,52719,49257
2017-12-01,Deutsche Bank,CitiBank New York,102475,53833,48642
2018-01-01,Deutsche Bank,CitiBank New York,102417,53998,48419
2018-02-01,Deutsche Bank,CitiBank New York,104178,54123,50055
2018-03-01,Deutsche Bank,CitiBank New York,101199,58169,43030
2018-04-01,Deutsche Bank,CitiBank New York,105758,59425,46333
2010-01-01,Deutsche Bank,CitiBank London,11376,94348,-82972
2010-02-01,Deutsche Bank,CitiBank London,17952,95241,-77289
2010-03-01,Deutsche Bank,CitiBank London,12262,93345,-81083
2010-04-01,Deutsche Bank,CitiBank London,15352,94448,-79096
2010-05-01,Deutsche Bank,CitiBank London,11652,91971,-80319
2010-06-01,Deutsche Bank,CitiBank London,11794,96357,-84563
2010-07-01,Deutsche Bank,CitiBank London,19563,93453,-73890
2010-08-01,Deutsche Bank,CitiBank London,14723,91216,-76493
2010-09-01,Deutsche Bank,CitiBank London,13237,92381,-79144
2010-10-01,Deutsche Bank,CitiBank London,13654,92932,-79278
2010-11-01,Deutsche Bank,CitiBank London,28422,95279,-66857
2010-12-01,Deutsche Bank,CitiBank London,25849,91899,-66050
2011-01-01,Deutsche Bank,CitiBank London,22471,93658,-71187
2011-02-01,Deutsche Bank,CitiBank London,28374,97782,-69408
2011-03-01,Deutsche Bank,CitiBank London,28964,96559,-67595
2011-04-01,Deutsche Bank,CitiBank London,25982,96454,-70472
2011-05-01,Deutsche Bank,CitiBank London,24812,94173,-69361
2011-06-01,Deutsche Bank,CitiBank London,28548,96192,-67644
2011-07-01,Deutsche Bank,CitiBank London,26387,92955,-66568
2011-08-01,Deutsche Bank,CitiBank London,29171,97446,-68275
2011-09-01,Deutsche Bank,CitiBank London,35497,89222,-53725
2011-10-01,Deutsche Bank,CitiBank London,39416,86413,-46997
2011-11-01,Deutsche Bank,CitiBank London,31138,86562,-55424
2011-12-01,Deutsche Bank,CitiBank London,33693,86713,-53020
2012-01-01,Deutsche Bank,CitiBank London,39321,82922,-43601
2012-02-01,Deutsche Bank,CitiBank London,38776,83747,-44971
2012-03-01,Deutsche Bank,CitiBank London,39728,84126,-44398
2012-04-01,Deutsche Bank,CitiBank London,37231,83777,-46546
2012-05-01,Deutsche Bank,CitiBank London,31147,89152,-58005
2012-06-01,Deutsche Bank,CitiBank London,37958,85736,-47778
2012-07-01,Deutsche Bank,CitiBank London,43454,84563,-41109
2012-08-01,Deutsche Bank,CitiBank London,46359,84733,-38374
2012-09-01,Deutsche Bank,CitiBank London,46547,89646,-43099
2012-10-01,Deutsche Bank,CitiBank London,41555,88365,-46810
2012-11-01,Deutsche Bank,CitiBank London,48195,85192,-36997
2012-12-01,Deutsche Bank,CitiBank London,45852,82691,-36839
2013-01-01,Deutsche Bank,CitiBank London,45534,83537,-38003
2013-02-01,Deutsche Bank,CitiBank London,46236,81187,-34951
2013-03-01,Deutsche Bank,CitiBank London,48315,89457,-41142
2013-04-01,Deutsche Bank,CitiBank London,46813,85148,-38335
2013-05-01,Deutsche Bank,CitiBank London,54247,75872,-21625
2013-06-01,Deutsche Bank,CitiBank London,51512,71985,-20473
2013-07-01,Deutsche Bank,CitiBank London,53495,75846,-22351
2013-08-01,Deutsche Bank,CitiBank London,51515,74784,-23269
2013-09-01,Deutsche Bank,CitiBank London,55264,71965,-16701
2013-10-01,Deutsche Bank,CitiBank London,58573,77339,-18766
2013-11-01,Deutsche Bank,CitiBank London,59898,74299,-14401
2013-12-01,Deutsche Bank,CitiBank London,51827,76243,-24416
2014-01-01,Deutsche Bank,CitiBank London,55137,74161,-19024
2014-02-01,Deutsche Bank,CitiBank London,54827,78243,-23416
2014-03-01,Deutsche Bank,CitiBank London,65283,71524,-6241
2014-04-01,Deutsche Bank,CitiBank London,62393,75423,-13030
2014-05-01,Deutsche Bank,CitiBank London,68445,71961,-3516
2014-06-01,Deutsche Bank,CitiBank London,65157,74346,-9189
2014-07-01,Deutsche Bank,CitiBank London,67376,76481,-9105
2014-08-01,Deutsche Bank,CitiBank London,68483,73324,-4841
2014-09-01,Deutsche Bank,CitiBank London,63933,73496,-9563
2014-10-01,Deutsche Bank,CitiBank London,64769,78798,-14029
2014-11-01,Deutsche Bank,CitiBank London,68966,74647,-5681
2014-12-01,Deutsche Bank,CitiBank London,66489,75937,-9448
2015-01-01,Deutsche Bank,CitiBank London,73783,63495,10288
2015-02-01,Deutsche Bank,CitiBank London,76916,69499,7417
2015-03-01,Deutsche Bank,CitiBank London,78757,62829,15928
2015-04-01,Deutsche Bank,CitiBank London,72982,66552,6430
2015-05-01,Deutsche Bank,CitiBank London,77289,69528,7761
2015-06-01,Deutsche Bank,CitiBank London,74318,65293,9025
2015-07-01,Deutsche Bank,CitiBank London,76978,67956,9022
2015-08-01,Deutsche Bank,CitiBank London,77274,62978,14296
2015-09-01,Deutsche Bank,CitiBank London,71992,67632,4360
2015-10-01,Deutsche Bank,CitiBank London,77825,69917,7908
2015-11-01,Deutsche Bank,CitiBank London,86968,66213,20755
2015-12-01,Deutsche Bank,CitiBank London,82357,67282,15075
2016-01-01,Deutsche Bank,CitiBank London,85668,68987,16681
2016-02-01,Deutsche Bank,CitiBank London,86297,62752,23545
2016-03-01,Deutsche Bank,CitiBank London,84759,64776,19983
2016-04-01,Deutsche Bank,CitiBank London,85674,69561,16113
2016-05-01,Deutsche Bank,CitiBank London,87951,63616,24335
2016-06-01,Deutsche Bank,CitiBank London,86568,64315,22253
2016-07-01,Deutsche Bank,CitiBank London,86364,68657,17707
2016-08-01,Deutsche Bank,CitiBank London,89185,69984,19201
2016-09-01,Deutsche Bank,CitiBank London,96734,58131,38603
2016-10-01,Deutsche Bank,CitiBank London,97416,52251,45165
2016-11-01,Deutsche Bank,CitiBank London,97941,53978,43963
2016-12-01,Deutsche Bank,CitiBank London,98954,55784,43170
2017-01-01,Deutsche Bank,CitiBank London,99946,53739,46207
2017-02-01,Deutsche Bank,CitiBank London,99332,59434,39898
2017-03-01,Deutsche Bank,CitiBank London,96886,53327,43559
2017-04-01,Deutsche Bank,CitiBank London,93561,52393,41168
2017-05-01,Deutsche Bank,CitiBank London,98434,59558,38876
2017-06-01,Deutsche Bank,CitiBank London,96972,58789,38183
2017-07-01,Deutsche Bank,CitiBank London,106448,51335,55113
2017-08-01,Deutsche Bank,CitiBank London,109783,51437,58346
2017-09-01,Deutsche Bank,CitiBank London,105458,57568,47890
2017-10-01,Deutsche Bank,CitiBank London,101559,57191,44368
2017-11-01,Deutsche Bank,CitiBank London,108319,52752,55567
2017-12-01,Deutsche Bank,CitiBank London,102358,51764,50594
2018-01-01,Deutsche Bank,CitiBank London,106547,59922,46625
2018-02-01,Deutsche Bank,CitiBank London,109598,57826,51772
2018-03-01,Deutsche Bank,CitiBank London,106832,52782,54050
2018-04-01,Deutsche Bank,CitiBank London,105231,59348,45883
2010-01-01,Deutsche Bank,CitiBank Pune,13557,99754,-86197
2010-02-01,Deutsche Bank,CitiBank Pune,13251,97931,-84680
2010-03-01,Deutsche Bank,CitiBank Pune,19627,91359,-71732
2010-04-01,Deutsche Bank,CitiBank Pune,19189,96439,-77250
2010-05-01,Deutsche Bank,CitiBank Pune,19846,95716,-75870
2010-06-01,Deutsche Bank,CitiBank Pune,14176,93396,-79220
2010-07-01,Deutsche Bank,CitiBank Pune,19835,93779,-73944
2010-08-01,Deutsche Bank,CitiBank Pune,11531,92598,-81067
2010-09-01,Deutsche Bank,CitiBank Pune,12582,97325,-84743
2010-10-01,Deutsche Bank,CitiBank Pune,15353,91867,-76514
2010-11-01,Deutsche Bank,CitiBank Pune,24443,96226,-71783
2010-12-01,Deutsche Bank,CitiBank Pune,23285,93289,-70004
2011-01-01,Deutsche Bank,CitiBank Pune,29849,93332,-63483
2011-02-01,Deutsche Bank,CitiBank Pune,23223,96119,-72896
2011-03-01,Deutsche Bank,CitiBank Pune,23742,92535,-68793
2011-04-01,Deutsche Bank,CitiBank Pune,23321,91445,-68124
2011-05-01,Deutsche Bank,CitiBank Pune,21665,99922,-78257
2011-06-01,Deutsche Bank,CitiBank Pune,21592,97113,-75521
2011-07-01,Deutsche Bank,CitiBank Pune,29386,95135,-65749
2011-08-01,Deutsche Bank,CitiBank Pune,22318,98896,-76578
2011-09-01,Deutsche Bank,CitiBank Pune,39486,81769,-42283
2011-10-01,Deutsche Bank,CitiBank Pune,31269,81294,-50025
2011-11-01,Deutsche Bank,CitiBank Pune,36243,83979,-47736
2011-12-01,Deutsche Bank,CitiBank Pune,38366,83384,-45018
2012-01-01,Deutsche Bank,CitiBank Pune,32665,89411,-56746
2012-02-01,Deutsche Bank,CitiBank Pune,31168,82342,-51174
2012-03-01,Deutsche Bank,CitiBank Pune,34124,82882,-48758
2012-04-01,Deutsche Bank,CitiBank Pune,38996,87299,-48303
2012-05-01,Deutsche Bank,CitiBank Pune,33511,87885,-54374
2012-06-01,Deutsche Bank,CitiBank Pune,38369,89371,-51002
2012-07-01,Deutsche Bank,CitiBank Pune,46519,85936,-39417
2012-08-01,Deutsche Bank,CitiBank Pune,44497,87214,-42717
2012-09-01,Deutsche Bank,CitiBank Pune,48939,82519,-33580
2012-10-01,Deutsche Bank,CitiBank Pune,43568,87353,-43785
2012-11-01,Deutsche Bank,CitiBank Pune,46133,84186,-38053
2012-12-01,Deutsche Bank,CitiBank Pune,47632,89463,-41831
2013-01-01,Deutsche Bank,CitiBank Pune,48447,89866,-41419
2013-02-01,Deutsche Bank,CitiBank Pune,43391,87659,-44268
2013-03-01,Deutsche Bank,CitiBank Pune,43285,82634,-39349
2013-04-01,Deutsche Bank,CitiBank Pune,49474,83514,-34040
2013-05-01,Deutsche Bank,CitiBank Pune,59414,74419,-15005
2013-06-01,Deutsche Bank,CitiBank Pune,51788,75363,-23575
2013-07-01,Deutsche Bank,CitiBank Pune,54281,77922,-23641
2013-08-01,Deutsche Bank,CitiBank Pune,55986,75491,-19505
2013-09-01,Deutsche Bank,CitiBank Pune,57162,74741,-17579
2013-10-01,Deutsche Bank,CitiBank Pune,57999,71559,-13560
2013-11-01,Deutsche Bank,CitiBank Pune,55623,78652,-23029
2013-12-01,Deutsche Bank,CitiBank Pune,57221,71852,-14631
2014-01-01,Deutsche Bank,CitiBank Pune,51493,72274,-20781
2014-02-01,Deutsche Bank,CitiBank Pune,53735,72286,-18551
2014-03-01,Deutsche Bank,CitiBank Pune,62385,79679,-17294
2014-04-01,Deutsche Bank,CitiBank Pune,66276,77318,-11042
2014-05-01,Deutsche Bank,CitiBank Pune,69264,75247,-5983
2014-06-01,Deutsche Bank,CitiBank Pune,61369,78994,-17625
2014-07-01,Deutsche Bank,CitiBank Pune,64345,79836,-15491
2014-08-01,Deutsche Bank,CitiBank Pune,64589,72757,-8168
2014-09-01,Deutsche Bank,CitiBank Pune,62831,78732,-15901
2014-10-01,Deutsche Bank,CitiBank Pune,62121,78846,-16725
2014-11-01,Deutsche Bank,CitiBank Pune,67497,71671,-4174
2014-12-01,Deutsche Bank,CitiBank Pune,63896,77931,-14035
2015-01-01,Deutsche Bank,CitiBank Pune,73393,65111,8282
2015-02-01,Deutsche Bank,CitiBank Pune,76222,67998,8224
2015-03-01,Deutsche Bank,CitiBank Pune,79943,61834,18109
2015-04-01,Deutsche Bank,CitiBank Pune,75311,65348,9963
2015-05-01,Deutsche Bank,CitiBank Pune,76993,63456,13537
2015-06-01,Deutsche Bank,CitiBank Pune,75843,62753,13090
2015-07-01,Deutsche Bank,CitiBank Pune,72546,66236,6310
2015-08-01,Deutsche Bank,CitiBank Pune,77767,62792,14975
2015-09-01,Deutsche Bank,CitiBank Pune,79244,66815,12429
2015-10-01,Deutsche Bank,CitiBank Pune,79679,61378,18301
2015-11-01,Deutsche Bank,CitiBank Pune,89817,63768,26049
2015-12-01,Deutsche Bank,CitiBank Pune,88395,66974,21421
2016-01-01,Deutsche Bank,CitiBank Pune,87869,66617,21252
2016-02-01,Deutsche Bank,CitiBank Pune,88296,63246,25050
2016-03-01,Deutsche Bank,CitiBank Pune,83727,66436,17291
2016-04-01,Deutsche Bank,CitiBank Pune,86691,62879,23812
2016-05-01,Deutsche Bank,CitiBank Pune,84852,67126,17726
2016-06-01,Deutsche Bank,CitiBank Pune,89566,64311,25255
2016-07-01,Deutsche Bank,CitiBank Pune,88182,66519,21663
2016-08-01,Deutsche Bank,CitiBank Pune,87717,69629,18088
2016-09-01,Deutsche Bank,CitiBank Pune,96533,52846,43687
2016-10-01,Deutsche Bank,CitiBank Pune,99633,56839,42794
2016-11-01,Deutsche Bank,CitiBank Pune,95984,57877,38107
2016-12-01,Deutsche Bank,CitiBank Pune,99158,57243,41915
2017-01-01,Deutsche Bank,CitiBank Pune,95412,59374,36038
2017-02-01,Deutsche Bank,CitiBank Pune,93436,56488,36948
2017-03-01,Deutsche Bank,CitiBank Pune,99194,53835,45359
2017-04-01,Deutsche Bank,CitiBank Pune,91627,52259,39368
2017-05-01,Deutsche Bank,CitiBank Pune,99667,54245,45422
2017-06-01,Deutsche Bank,CitiBank Pune,91141,56978,34163
2017-07-01,Deutsche Bank,CitiBank Pune,109499,59614,49885
2017-08-01,Deutsche Bank,CitiBank Pune,106398,56875,49523
2017-09-01,Deutsche Bank,CitiBank Pune,104226,59141,45085
2017-10-01,Deutsche Bank,CitiBank Pune,104515,52714,51801
2017-11-01,Deutsche Bank,CitiBank Pune,106311,52994,53317
2017-12-01,Deutsche Bank,CitiBank Pune,102626,58518,44108
2018-01-01,Deutsche Bank,CitiBank Pune,103511,57787,45724
2018-02-01,Deutsche Bank,CitiBank Pune,108556,55346,53210
2018-03-01,Deutsche Bank,CitiBank Pune,108318,51727,56591
2018-04-01,Deutsche Bank,CitiBank Pune,107392,57129,50263
2010-01-01,Deutsche Bank,CitiBank Singapore,15913,98523,-82610
2010-02-01,Deutsche Bank,CitiBank Singapore,17233,98368,-81135
2010-03-01,Deutsche Bank,CitiBank Singapore,19361,98486,-79125
2010-04-01,Deutsche Bank,CitiBank Singapore,14897,97487,-82590
2010-05-01,Deutsche Bank,CitiBank Singapore,15472,93928,-78456
2010-06-01,Deutsche Bank,CitiBank Singapore,16225,97721,-81496
2010-07-01,Deutsche Bank,CitiBank Singapore,17267,98854,-81587
2010-08-01,Deutsche Bank,CitiBank Singapore,13848,96597,-82749
2010-09-01,Deutsche Bank,CitiBank Singapore,17192,96425,-79233
2010-10-01,Deutsche Bank,CitiBank Singapore,17294,96868,-79574
2010-11-01,Deutsche Bank,CitiBank Singapore,21631,99184,-77553
2010-12-01,Deutsche Bank,CitiBank Singapore,26159,96342,-70183
2011-01-01,Deutsche Bank,CitiBank Singapore,21791,98257,-76466
2011-02-01,Deutsche Bank,CitiBank Singapore,25785,97816,-72031
2011-03-01,Deutsche Bank,CitiBank Singapore,24745,91338,-66593
2011-04-01,Deutsche Bank,CitiBank Singapore,28925,94911,-65986
2011-05-01,Deutsche Bank,CitiBank Singapore,24298,93252,-68954
2011-06-01,Deutsche Bank,CitiBank Singapore,21679,98396,-76717
2011-07-01,Deutsche Bank,CitiBank Singapore,29365,93539,-64174
2011-08-01,Deutsche Bank,CitiBank Singapore,24775,94673,-69898
2011-09-01,Deutsche Bank,CitiBank Singapore,31362,82973,-51611
2011-10-01,Deutsche Bank,CitiBank Singapore,31988,85164,-53176
2011-11-01,Deutsche Bank,CitiBank Singapore,31597,83555,-51958
2011-12-01,Deutsche Bank,CitiBank Singapore,37117,82639,-45522
2012-01-01,Deutsche Bank,CitiBank Singapore,34748,88945,-54197
2012-02-01,Deutsche Bank,CitiBank Singapore,37762,86794,-49032
2012-03-01,Deutsche Bank,CitiBank Singapore,33454,85157,-51703
2012-04-01,Deutsche Bank,CitiBank Singapore,38588,82516,-43928
2012-05-01,Deutsche Bank,CitiBank Singapore,31866,89135,-57269
2012-06-01,Deutsche Bank,CitiBank Singapore,39798,84811,-45013
2012-07-01,Deutsche Bank,CitiBank Singapore,48769,86613,-37844
2012-08-01,Deutsche Bank,CitiBank Singapore,49177,85484,-36307
2012-09-01,Deutsche Bank,CitiBank Singapore,45829,84864,-39035
2012-10-01,Deutsche Bank,CitiBank Singapore,47394,82487,-35093
2012-11-01,Deutsche Bank,CitiBank Singapore,45946,87981,-42035
2012-12-01,Deutsche Bank,CitiBank Singapore,45189,83725,-38536
2013-01-01,Deutsche Bank,CitiBank Singapore,44266,87144,-42878
2013-02-01,Deutsche Bank,CitiBank Singapore,46997,88587,-41590
2013-03-01,Deutsche Bank,CitiBank Singapore,43664,89432,-45768
2013-04-01,Deutsche Bank,CitiBank Singapore,48477,82231,-33754
2013-05-01,Deutsche Bank,CitiBank Singapore,54541,72618,-18077
2013-06-01,Deutsche Bank,CitiBank Singapore,59186,78368,-19182
2013-07-01,Deutsche Bank,CitiBank Singapore,54363,72797,-18434
2013-08-01,Deutsche Bank,CitiBank Singapore,58647,75154,-16507
2013-09-01,Deutsche Bank,CitiBank Singapore,54793,77987,-23194
2013-10-01,Deutsche Bank,CitiBank Singapore,51317,77547,-26230
2013-11-01,Deutsche Bank,CitiBank Singapore,54694,74148,-19454
2013-12-01,Deutsche Bank,CitiBank Singapore,58793,75884,-17091
2014-01-01,Deutsche Bank,CitiBank Singapore,53281,79247,-25966
2014-02-01,Deutsche Bank,CitiBank Singapore,59856,75985,-16129
2014-03-01,Deutsche Bank,CitiBank Singapore,64964,73697,-8733
2014-04-01,Deutsche Bank,CitiBank Singapore,65135,77637,-12502
2014-05-01,Deutsche Bank,CitiBank Singapore,64931,76614,-11683
2014-06-01,Deutsche Bank,CitiBank Singapore,63679,73386,-9707
2014-07-01,Deutsche Bank,CitiBank Singapore,69717,71494,-1777
2014-08-01,Deutsche Bank,CitiBank Singapore,62761,73341,-10580
2014-09-01,Deutsche Bank,CitiBank Singapore,65346,73721,-8375
2014-10-01,Deutsche Bank,CitiBank Singapore,69137,73144,-4007
2014-11-01,Deutsche Bank,CitiBank Singapore,66461,73126,-6665
2014-12-01,Deutsche Bank,CitiBank Singapore,61652,75872,-14220
2015-01-01,Deutsche Bank,CitiBank Singapore,74914,69876,5038
2015-02-01,Deutsche Bank,CitiBank Singapore,75419,61981,13438
2015-03-01,Deutsche Bank,CitiBank Singapore,78732,68498,10234
2015-04-01,Deutsche Bank,CitiBank Singapore,77569,63122,14447
2015-05-01,Deutsche Bank,CitiBank Singapore,77471,68786,8685
2015-06-01,Deutsche Bank,CitiBank Singapore,74776,69857,4919
2015-07-01,Deutsche Bank,CitiBank Singapore,76149,69422,6727
2015-08-01,Deutsche Bank,CitiBank Singapore,78694,64567,14127
2015-09-01,Deutsche Bank,CitiBank Singapore,78617,69775,8842
2015-10-01,Deutsche Bank,CitiBank Singapore,78283,68963,9320
2015-11-01,Deutsche Bank,CitiBank Singapore,87346,62813,24533
2015-12-01,Deutsche Bank,CitiBank Singapore,82352,62989,19363
2016-01-01,Deutsche Bank,CitiBank Singapore,89493,62524,26969
2016-02-01,Deutsche Bank,CitiBank Singapore,87277,66428,20849
2016-03-01,Deutsche Bank,CitiBank Singapore,86713,68124,18589
2016-04-01,Deutsche Bank,CitiBank Singapore,83362,64799,18563
2016-05-01,Deutsche Bank,CitiBank Singapore,83384,63179,20205
2016-06-01,Deutsche Bank,CitiBank Singapore,83622,66985,16637
2016-07-01,Deutsche Bank,CitiBank Singapore,83896,61535,22361
2016-08-01,Deutsche Bank,CitiBank Singapore,83912,64166,19746
2016-09-01,Deutsche Bank,CitiBank Singapore,98692,51951,46741
2016-10-01,Deutsche Bank,CitiBank Singapore,95697,57392,38305
2016-11-01,Deutsche Bank,CitiBank Singapore,92642,56642,36000
2016-12-01,Deutsche Bank,CitiBank Singapore,98276,52896,45380
2017-01-01,Deutsche Bank,CitiBank Singapore,91971,54278,37693
2017-02-01,Deutsche Bank,CitiBank Singapore,98359,54196,44163
2017-03-01,Deutsche Bank,CitiBank Singapore,99648,58667,40981
2017-04-01,Deutsche Bank,CitiBank Singapore,97382,53295,44087
2017-05-01,Deutsche Bank,CitiBank Singapore,95357,59985,35372
2017-06-01,Deutsche Bank,CitiBank Singapore,98476,54359,44117
2017-07-01,Deutsche Bank,CitiBank Singapore,102379,51895,50484
2017-08-01,Deutsche Bank,CitiBank Singapore,109889,58425,51464
2017-09-01,Deutsche Bank,CitiBank Singapore,105218,59657,45561
2017-10-01,Deutsche Bank,CitiBank Singapore,101468,53913,47555
2017-11-01,Deutsche Bank,CitiBank Singapore,105126,51215,53911
2017-12-01,Deutsche Bank,CitiBank Singapore,106949,55188,51761
2018-01-01,Deutsche Bank,CitiBank Singapore,109157,59969,49188
2018-02-01,Deutsche Bank,CitiBank Singapore,109625,58956,50669
2018-03-01,Deutsche Bank,CitiBank Singapore,103881,57821,46060
2018-04-01,Deutsche Bank,CitiBank Singapore,108457,58468,49989
2010-01-01,Deutsche Bank,CitiBank HongKong,15659,98438,-82779
2010-02-01,Deutsche Bank,CitiBank HongKong,18236,96271,-78035
2010-03-01,Deutsche Bank,CitiBank HongKong,14979,91141,-76162
2010-04-01,Deutsche Bank,CitiBank HongKong,15775,93136,-77361
2010-05-01,Deutsche Bank,CitiBank HongKong,19661,94943,-75282
2010-06-01,Deutsche Bank,CitiBank HongKong,14648,93674,-79026
2010-07-01,Deutsche Bank,CitiBank HongKong,15193,92896,-77703
2010-08-01,Deutsche Bank,CitiBank HongKong,11176,93936,-82760
2010-09-01,Deutsche Bank,CitiBank HongKong,11437,96183,-84746
2010-10-01,Deutsche Bank,CitiBank HongKong,18257,91645,-73388
2010-11-01,Deutsche Bank,CitiBank HongKong,28338,98274,-69936
2010-12-01,Deutsche Bank,CitiBank HongKong,29476,99264,-69788
2011-01-01,Deutsche Bank,CitiBank HongKong,22682,97748,-75066
2011-02-01,Deutsche Bank,CitiBank HongKong,22488,96237,-73749
2011-03-01,Deutsche Bank,CitiBank HongKong,26592,99581,-72989
2011-04-01,Deutsche Bank,CitiBank HongKong,26925,91733,-64808
2011-05-01,Deutsche Bank,CitiBank HongKong,27876,99537,-71661
2011-06-01,Deutsche Bank,CitiBank HongKong,29561,93767,-64206
2011-07-01,Deutsche Bank,CitiBank HongKong,25581,92147,-66566
2011-08-01,Deutsche Bank,CitiBank HongKong,24423,93314,-68891
2011-09-01,Deutsche Bank,CitiBank HongKong,35622,83383,-47761
2011-10-01,Deutsche Bank,CitiBank HongKong,38874,87346,-48472
2011-11-01,Deutsche Bank,CitiBank HongKong,39597,84545,-44948
2011-12-01,Deutsche Bank,CitiBank HongKong,32312,89142,-56830
2012-01-01,Deutsche Bank,CitiBank HongKong,32379,88744,-56365
2012-02-01,Deutsche Bank,CitiBank HongKong,38696,84858,-46162
2012-03-01,Deutsche Bank,CitiBank HongKong,31548,85955,-54407
2012-04-01,Deutsche Bank,CitiBank HongKong,38855,85499,-46644
2012-05-01,Deutsche Bank,CitiBank HongKong,35979,89971,-53992
2012-06-01,Deutsche Bank,CitiBank HongKong,31584,89249,-57665
2012-07-01,Deutsche Bank,CitiBank HongKong,48161,83674,-35513
2012-08-01,Deutsche Bank,CitiBank HongKong,41359,86893,-45534
2012-09-01,Deutsche Bank,CitiBank HongKong,48699,88467,-39768
2012-10-01,Deutsche Bank,CitiBank HongKong,43496,88155,-44659
2012-11-01,Deutsche Bank,CitiBank HongKong,48989,89942,-40953
2012-12-01,Deutsche Bank,CitiBank HongKong,48826,84776,-35950
2013-01-01,Deutsche Bank,CitiBank HongKong,45436,86963,-41527
2013-02-01,Deutsche Bank,CitiBank HongKong,43528,83267,-39739
2013-03-01,Deutsche Bank,CitiBank HongKong,47767,88857,-41090
2013-04-01,Deutsche Bank,CitiBank HongKong,42227,88387,-46160
2013-05-01,Deutsche Bank,CitiBank HongKong,56278,73955,-17677
2013-06-01,Deutsche Bank,CitiBank HongKong,55567,77737,-22170
2013-07-01,Deutsche Bank,CitiBank HongKong,53312,72894,-19582
2013-08-01,Deutsche Bank,CitiBank HongKong,56994,74664,-17670
2013-09-01,Deutsche Bank,CitiBank HongKong,59926,79188,-19262
2013-10-01,Deutsche Bank,CitiBank HongKong,58496,76723,-18227
2013-11-01,Deutsche Bank,CitiBank HongKong,54325,71223,-16898
2013-12-01,Deutsche Bank,CitiBank HongKong,59934,77659,-17725
2014-01-01,Deutsche Bank,CitiBank HongKong,59562,76133,-16571
2014-02-01,Deutsche Bank,CitiBank HongKong,57119,74817,-17698
2014-03-01,Deutsche Bank,CitiBank HongKong,63766,76347,-12581
2014-04-01,Deutsche Bank,CitiBank HongKong,68471,78584,-10113
2014-05-01,Deutsche Bank,CitiBank HongKong,65334,72873,-7539
2014-06-01,Deutsche Bank,CitiBank HongKong,69949,79728,-9779
2014-07-01,Deutsche Bank,CitiBank HongKong,64744,76166,-11422
2014-08-01,Deutsche Bank,CitiBank HongKong,66763,77235,-10472
2014-09-01,Deutsche Bank,CitiBank HongKong,65275,71626,-6351
2014-10-01,Deutsche Bank,CitiBank HongKong,68921,75932,-7011
2014-11-01,Deutsche Bank,CitiBank HongKong,61311,74335,-13024
2014-12-01,Deutsche Bank,CitiBank HongKong,61819,78555,-16736
2015-01-01,Deutsche Bank,CitiBank HongKong,73774,61344,12430
2015-02-01,Deutsche Bank,CitiBank HongKong,71397,68199,3198
2015-03-01,Deutsche Bank,CitiBank HongKong,76752,67642,9110
2015-04-01,Deutsche Bank,CitiBank HongKong,77782,69421,8361
2015-05-01,Deutsche Bank,CitiBank HongKong,76876,65374,11502
2015-06-01,Deutsche Bank,CitiBank HongKong,73875,68711,5164
2015-07-01,Deutsche Bank,CitiBank HongKong,79579,64856,14723
2015-08-01,Deutsche Bank,CitiBank HongKong,73838,61213,12625
2015-09-01,Deutsche Bank,CitiBank HongKong,75721,63896,11825
2015-10-01,Deutsche Bank,CitiBank HongKong,79297,65336,13961
2015-11-01,Deutsche Bank,CitiBank HongKong,87939,66492,21447
2015-12-01,Deutsche Bank,CitiBank HongKong,83231,66164,17067
2016-01-01,Deutsche Bank,CitiBank HongKong,87528,69551,17977
2016-02-01,Deutsche Bank,CitiBank HongKong,85232,61553,23679
2016-03-01,Deutsche Bank,CitiBank HongKong,89391,67987,21404
2016-04-01,Deutsche Bank,CitiBank HongKong,83572,62248,21324
2016-05-01,Deutsche Bank,CitiBank HongKong,82958,64271,18687
2016-06-01,Deutsche Bank,CitiBank HongKong,85487,66154,19333
2016-07-01,Deutsche Bank,CitiBank HongKong,84332,68987,15345
2016-08-01,Deutsche Bank,CitiBank HongKong,89931,62735,27196
2016-09-01,Deutsche Bank,CitiBank HongKong,95777,59441,36336
2016-10-01,Deutsche Bank,CitiBank HongKong,97597,51378,46219
2016-11-01,Deutsche Bank,CitiBank HongKong,94699,55135,39564
2016-12-01,Deutsche Bank,CitiBank HongKong,95375,52918,42457
2017-01-01,Deutsche Bank,CitiBank HongKong,97383,53816,43567
2017-02-01,Deutsche Bank,CitiBank HongKong,95241,59245,35996
2017-03-01,Deutsche Bank,CitiBank HongKong,92666,57439,35227
2017-04-01,Deutsche Bank,CitiBank HongKong,99284,51371,47913
2017-05-01,Deutsche Bank,CitiBank HongKong,93398,58649,34749
2017-06-01,Deutsche Bank,CitiBank HongKong,92858,54686,38172
2017-07-01,Deutsche Bank,CitiBank HongKong,107931,52982,54949
2017-08-01,Deutsche Bank,CitiBank HongKong,104331,58487,45844
2017-09-01,Deutsche Bank,CitiBank HongKong,109878,53642,56236
2017-10-01,Deutsche Bank,CitiBank HongKong,103566,54965,48601
2017-11-01,Deutsche Bank,CitiBank HongKong,108222,55356,52866
2017-12-01,Deutsche Bank,CitiBank HongKong,108623,56351,52272
2018-01-01,Deutsche Bank,CitiBank HongKong,109513,53889,55624
2018-02-01,Deutsche Bank,CitiBank HongKong,101329,55744,45585
2018-03-01,Deutsche Bank,CitiBank HongKong,101616,51152,50464
2018-04-01,Deutsche Bank,CitiBank HongKong,106615,56154,50461
2010-01-01,JP Morgan,CitiBank New York,11844,91334,-79490
2010-02-01,JP Morgan,CitiBank New York,18712,96478,-77766
2010-03-01,JP Morgan,CitiBank New York,17189,91274,-74085
2010-04-01,JP Morgan,CitiBank New York,16631,92355,-75724
2010-05-01,JP Morgan,CitiBank New York,19352,98637,-79285
2010-06-01,JP Morgan,CitiBank New York,17371,91978,-74607
2010-07-01,JP Morgan,CitiBank New York,11627,91524,-79897
2010-08-01,JP Morgan,CitiBank New York,19245,91871,-72626
2010-09-01,JP Morgan,CitiBank New York,19437,98474,-79037
2010-10-01,JP Morgan,CitiBank New York,13689,93524,-79835
2010-11-01,JP Morgan,CitiBank New York,25627,93619,-67992
2010-12-01,JP Morgan,CitiBank New York,28273,99456,-71183
2011-01-01,JP Morgan,CitiBank New York,22936,95919,-72983
2011-02-01,JP Morgan,CitiBank New York,22182,91976,-69794
2011-03-01,JP Morgan,CitiBank New York,23652,91228,-67576
2011-04-01,JP Morgan,CitiBank New York,21448,97466,-76018
2011-05-01,JP Morgan,CitiBank New York,24144,92892,-68748
2011-06-01,JP Morgan,CitiBank New York,26641,94377,-67736
2011-07-01,JP Morgan,CitiBank New York,22975,93527,-70552
2011-08-01,JP Morgan,CitiBank New York,29328,92253,-62925
2011-09-01,JP Morgan,CitiBank New York,31158,86729,-55571
2011-10-01,JP Morgan,CitiBank New York,31211,85274,-54063
2011-11-01,JP Morgan,CitiBank New York,37781,87171,-49390
2011-12-01,JP Morgan,CitiBank New York,32439,85845,-53406
2012-01-01,JP Morgan,CitiBank New York,35443,86178,-50735
2012-02-01,JP Morgan,CitiBank New York,31834,85427,-53593
2012-03-01,JP Morgan,CitiBank New York,35919,84565,-48646
2012-04-01,JP Morgan,CitiBank New York,33111,85637,-52526
2012-05-01,JP Morgan,CitiBank New York,31175,83933,-52758
2012-06-01,JP Morgan,CitiBank New York,33588,82412,-48824
2012-07-01,JP Morgan,CitiBank New York,47618,82176,-34558
2012-08-01,JP Morgan,CitiBank New York,46763,88968,-42205
2012-09-01,JP Morgan,CitiBank New York,42897,84959,-42062
2012-10-01,JP Morgan,CitiBank New York,41386,89131,-47745
2012-11-01,JP Morgan,CitiBank New York,42429,85868,-43439
2012-12-01,JP Morgan,CitiBank New York,46136,89347,-43211
2013-01-01,JP Morgan,CitiBank New York,45298,82159,-36861
2013-02-01,JP Morgan,CitiBank New York,46937,82425,-35488
2013-03-01,JP Morgan,CitiBank New York,43522,87514,-43992
2013-04-01,JP Morgan,CitiBank New York,45198,87351,-42153
2013-05-01,JP Morgan,CitiBank New York,57545,79493,-21948
2013-06-01,JP Morgan,CitiBank New York,58631,78183,-19552
2013-07-01,JP Morgan,CitiBank New York,56368,74488,-18120
2013-08-01,JP Morgan,CitiBank New York,57913,79817,-21904
2013-09-01,JP Morgan,CitiBank New York,59281,79621,-20340
2013-10-01,JP Morgan,CitiBank New York,54468,72563,-18095
2013-11-01,JP Morgan,CitiBank New York,55911,78856,-22945
2013-12-01,JP Morgan,CitiBank New York,54149,79771,-25622
2014-01-01,JP Morgan,CitiBank New York,55522,73627,-18105
2014-02-01,JP Morgan,CitiBank New York,52831,76933,-24102
2014-03-01,JP Morgan,CitiBank New York,66732,77522,-10790
2014-04-01,JP Morgan,CitiBank New York,64646,75886,-11240
2014-05-01,JP Morgan,CitiBank New York,68674,74988,-6314
2014-06-01,JP Morgan,CitiBank New York,67324,72194,-4870
2014-07-01,JP Morgan,CitiBank New York,64234,72696,-8462
2014-08-01,JP Morgan,CitiBank New York,68619,77293,-8674
2014-09-01,JP Morgan,CitiBank New York,62329,71728,-9399
2014-10-01,JP Morgan,CitiBank New York,64448,75982,-11534
2014-11-01,JP Morgan,CitiBank New York,69381,77623,-8242
2014-12-01,JP Morgan,CitiBank New York,65927,71475,-5548
2015-01-01,JP Morgan,CitiBank New York,75967,69537,6430
2015-02-01,JP Morgan,CitiBank New York,79717,65365,14352
2015-03-01,JP Morgan,CitiBank New York,71197,68633,2564
2015-04-01,JP Morgan,CitiBank New York,79688,63955,15733
2015-05-01,JP Morgan,CitiBank New York,78785,63868,14917
2015-06-01,JP Morgan,CitiBank New York,75217,69117,6100
2015-07-01,JP Morgan,CitiBank New York,78463,64991,13472
2015-08-01,JP Morgan,CitiBank New York,78932,67883,11049
2015-09-01,JP Morgan,CitiBank New York,75397,63349,12048
2015-10-01,JP Morgan,CitiBank New York,74955,65377,9578
2015-11-01,JP Morgan,CitiBank New York,82152,66611,15541
2015-12-01,JP Morgan,CitiBank New York,83741,68839,14902
2016-01-01,JP Morgan,CitiBank New York,82943,68196,14747
2016-02-01,JP Morgan,CitiBank New York,87377,62228,25149
2016-03-01,JP Morgan,CitiBank New York,83467,69121,14346
2016-04-01,JP Morgan,CitiBank New York,88175,61482,26693
2016-05-01,JP Morgan,CitiBank New York,89223,61174,28049
2016-06-01,JP Morgan,CitiBank New York,88136,64166,23970
2016-07-01,JP Morgan,CitiBank New York,85461,64858,20603
2016-08-01,JP Morgan,CitiBank New York,84494,67551,16943
2016-09-01,JP Morgan,CitiBank New York,96688,55634,41054
2016-10-01,JP Morgan,CitiBank New York,93785,54615,39170
2016-11-01,JP Morgan,CitiBank New York,99513,52222,47291
2016-12-01,JP Morgan,CitiBank New York,95568,54537,41031
2017-01-01,JP Morgan,CitiBank New York,99184,56569,42615
2017-02-01,JP Morgan,CitiBank New York,91344,51217,40127
2017-03-01,JP Morgan,CitiBank New York,92363,51323,41040
2017-04-01,JP Morgan,CitiBank New York,93185,52545,40640
2017-05-01,JP Morgan,CitiBank New York,99641,58143,41498
2017-06-01,JP Morgan,CitiBank New York,93553,58679,34874
2017-07-01,JP Morgan,CitiBank New York,109797,57932,51865
2017-08-01,JP Morgan,CitiBank New York,106445,52321,54124
2017-09-01,JP Morgan,CitiBank New York,107649,53877,53772
2017-10-01,JP Morgan,CitiBank New York,107496,55965,51531
2017-11-01,JP Morgan,CitiBank New York,104231,52756,51475
2017-12-01,JP Morgan,CitiBank New York,105824,52873,52951
2018-01-01,JP Morgan,CitiBank New York,102888,55597,47291
2018-02-01,JP Morgan,CitiBank New York,109677,55181,54496
2018-03-01,JP Morgan,CitiBank New York,107393,57756,49637
2018-04-01,JP Morgan,CitiBank New York,106378,59543,46835
2010-01-01,JP Morgan,CitiBank London,11351,97965,-86614
2010-02-01,JP Morgan,CitiBank London,14241,98194,-83953
2010-03-01,JP Morgan,CitiBank London,14932,99842,-84910
2010-04-01,JP Morgan,CitiBank London,14233,99693,-85460
2010-05-01,JP Morgan,CitiBank London,15657,91453,-75796
2010-06-01,JP Morgan,CitiBank London,11177,92545,-81368
2010-07-01,JP Morgan,CitiBank London,13187,95926,-82739
2010-08-01,JP Morgan,CitiBank London,15739,99256,-83517
2010-09-01,JP Morgan,CitiBank London,16559,99865,-83306
2010-10-01,JP Morgan,CitiBank London,18732,92597,-73865
2010-11-01,JP Morgan,CitiBank London,28551,93967,-65416
2010-12-01,JP Morgan,CitiBank London,23634,97934,-74300
2011-01-01,JP Morgan,CitiBank London,26422,99416,-72994
2011-02-01,JP Morgan,CitiBank London,22999,92568,-69569
2011-03-01,JP Morgan,CitiBank London,22227,92332,-70105
2011-04-01,JP Morgan,CitiBank London,25565,97229,-71664
2011-05-01,JP Morgan,CitiBank London,27979,93861,-65882
2011-06-01,JP Morgan,CitiBank London,26495,92866,-66371
2011-07-01,JP Morgan,CitiBank London,27358,98234,-70876
2011-08-01,JP Morgan,CitiBank London,25796,93254,-67458
2011-09-01,JP Morgan,CitiBank London,34386,88981,-54595
2011-10-01,JP Morgan,CitiBank London,36798,83769,-46971
2011-11-01,JP Morgan,CitiBank London,34456,89282,-54826
2011-12-01,JP Morgan,CitiBank London,36362,83748,-47386
2012-01-01,JP Morgan,CitiBank London,32126,86526,-54400
2012-02-01,JP Morgan,CitiBank London,34726,88916,-54190
2012-03-01,JP Morgan,CitiBank London,39711,81699,-41988
2012-04-01,JP Morgan,CitiBank London,39933,83672,-43739
2012-05-01,JP Morgan,CitiBank London,35757,89187,-53430
2012-06-01,JP Morgan,CitiBank London,34627,81324,-46697
2012-07-01,JP Morgan,CitiBank London,48582,85861,-37279
2012-08-01,JP Morgan,CitiBank London,42292,89383,-47091
2012-09-01,JP Morgan,CitiBank London,45882,86548,-40666
2012-10-01,JP Morgan,CitiBank London,43368,88596,-45228
2012-11-01,JP Morgan,CitiBank London,47644,86723,-39079
2012-12-01,JP Morgan,CitiBank London,45134,87155,-42021
2013-01-01,JP Morgan,CitiBank London,45477,85649,-40172
2013-02-01,JP Morgan,CitiBank London,46798,85723,-38925
2013-03-01,JP Morgan,CitiBank London,41127,84981,-43854
2013-04-01,JP Morgan,CitiBank London,48336,86616,-38280
2013-05-01,JP Morgan,CitiBank London,53972,75783,-21811
2013-06-01,JP Morgan,CitiBank London,52926,71371,-18445
2013-07-01,JP Morgan,CitiBank London,53498,77986,-24488
2013-08-01,JP Morgan,CitiBank London,59364,79332,-19968
2013-09-01,JP Morgan,CitiBank London,51589,78999,-27410
2013-10-01,JP Morgan,CitiBank London,56588,79438,-22850
2013-11-01,JP Morgan,CitiBank London,51199,73652,-22453
2013-12-01,JP Morgan,CitiBank London,58489,72828,-14339
2014-01-01,JP Morgan,CitiBank London,53988,77831,-23843
2014-02-01,JP Morgan,CitiBank London,56597,75994,-19397
2014-03-01,JP Morgan,CitiBank London,68844,73231,-4387
2014-04-01,JP Morgan,CitiBank London,66497,78442,-11945
2014-05-01,JP Morgan,CitiBank London,61247,74226,-12979
2014-06-01,JP Morgan,CitiBank London,63497,73965,-10468
2014-07-01,JP Morgan,CitiBank London,65873,77984,-12111
2014-08-01,JP Morgan,CitiBank London,68467,77753,-9286
2014-09-01,JP Morgan,CitiBank London,62493,78437,-15944
2014-10-01,JP Morgan,CitiBank London,62485,75152,-12667
2014-11-01,JP Morgan,CitiBank London,65522,74237,-8715
2014-12-01,JP Morgan,CitiBank London,65186,79226,-14040
2015-01-01,JP Morgan,CitiBank London,73317,69497,3820
2015-02-01,JP Morgan,CitiBank London,78585,64719,13866
2015-03-01,JP Morgan,CitiBank London,73488,61867,11621
2015-04-01,JP Morgan,CitiBank London,74233,66496,7737
2015-05-01,JP Morgan,CitiBank London,72344,61324,11020
2015-06-01,JP Morgan,CitiBank London,79461,66874,12587
2015-07-01,JP Morgan,CitiBank London,73226,69242,3984
2015-08-01,JP Morgan,CitiBank London,72364,64697,7667
2015-09-01,JP Morgan,CitiBank London,72667,65474,7193
2015-10-01,JP Morgan,CitiBank London,76745,67438,9307
2015-11-01,JP Morgan,CitiBank London,83997,62832,21165
2015-12-01,JP Morgan,CitiBank London,87432,64122,23310
2016-01-01,JP Morgan,CitiBank London,81141,68348,12793
2016-02-01,JP Morgan,CitiBank London,87121,66999,20122
2016-03-01,JP Morgan,CitiBank London,84495,65182,19313
2016-04-01,JP Morgan,CitiBank London,82951,66279,16672
2016-05-01,JP Morgan,CitiBank London,86125,67289,18836
2016-06-01,JP Morgan,CitiBank London,81668,67142,14526
2016-07-01,JP Morgan,CitiBank London,86292,69556,16736
2016-08-01,JP Morgan,CitiBank London,86541,65927,20614
2016-09-01,JP Morgan,CitiBank London,99269,52679,46590
2016-10-01,JP Morgan,CitiBank London,98537,52474,46063
2016-11-01,JP Morgan,CitiBank London,98599,54748,43851
2016-12-01,JP Morgan,CitiBank London,94865,53247,41618
2017-01-01,JP Morgan,CitiBank London,97512,57934,39578
2017-02-01,JP Morgan,CitiBank London,91125,51269,39856
2017-03-01,JP Morgan,CitiBank London,99984,55171,44813
2017-04-01,JP Morgan,CitiBank London,92316,57856,34460
2017-05-01,JP Morgan,CitiBank London,94567,54285,40282
2017-06-01,JP Morgan,CitiBank London,97958,53977,43981
2017-07-01,JP Morgan,CitiBank London,103199,58763,44436
2017-08-01,JP Morgan,CitiBank London,109984,56225,53759
2017-09-01,JP Morgan,CitiBank London,103131,57451,45680
2017-10-01,JP Morgan,CitiBank London,106217,59898,46319
2017-11-01,JP Morgan,CitiBank London,101741,52358,49383
2017-12-01,JP Morgan,CitiBank London,108824,56728,52096
2018-01-01,JP Morgan,CitiBank London,109365,56476,52889
2018-02-01,JP Morgan,CitiBank London,102667,52585,50082
2018-03-01,JP Morgan,CitiBank London,102955,55447,47508
2018-04-01,JP Morgan,CitiBank London,109538,59967,49571
2010-01-01,JP Morgan,CitiBank Pune,11661,99398,-87737
2010-02-01,JP Morgan,CitiBank Pune,18767,97957,-79190
2010-03-01,JP Morgan,CitiBank Pune,13136,98281,-85145
2010-04-01,JP Morgan,CitiBank Pune,16198,96274,-80076
2010-05-01,JP Morgan,CitiBank Pune,16676,99234,-82558
2010-06-01,JP Morgan,CitiBank Pune,11775,92488,-80713
2010-07-01,JP Morgan,CitiBank Pune,11388,98627,-87239
2010-08-01,JP Morgan,CitiBank Pune,16813,94158,-77345
2010-09-01,JP Morgan,CitiBank Pune,18854,93837,-74983
2010-10-01,JP Morgan,CitiBank Pune,11929,98251,-86322
2010-11-01,JP Morgan,CitiBank Pune,21273,98664,-77391
2010-12-01,JP Morgan,CitiBank Pune,25566,99163,-73597
2011-01-01,JP Morgan,CitiBank Pune,24387,99844,-75457
2011-02-01,JP Morgan,CitiBank Pune,21486,94336,-72850
2011-03-01,JP Morgan,CitiBank Pune,27369,98248,-70879
2011-04-01,JP Morgan,CitiBank Pune,28745,92198,-63453
2011-05-01,JP Morgan,CitiBank Pune,25192,99555,-74363
2011-06-01,JP Morgan,CitiBank Pune,29145,98138,-68993
2011-07-01,JP Morgan,CitiBank Pune,28371,99556,-71185
2011-08-01,JP Morgan,CitiBank Pune,26694,97648,-70954
2011-09-01,JP Morgan,CitiBank Pune,36672,82979,-46307
2011-10-01,JP Morgan,CitiBank Pune,31797,86219,-54422
2011-11-01,JP Morgan,CitiBank Pune,36737,81483,-44746
2011-12-01,JP Morgan,CitiBank Pune,38311,87111,-48800
2012-01-01,JP Morgan,CitiBank Pune,39623,85691,-46068
2012-02-01,JP Morgan,CitiBank Pune,38243,88621,-50378
2012-03-01,JP Morgan,CitiBank Pune,37328,81174,-43846
2012-04-01,JP Morgan,CitiBank Pune,37963,83278,-45315
2012-05-01,JP Morgan,CitiBank Pune,37292,86332,-49040
2012-06-01,JP Morgan,CitiBank Pune,31777,86919,-55142
2012-07-01,JP Morgan,CitiBank Pune,48163,83115,-34952
2012-08-01,JP Morgan,CitiBank Pune,47357,85162,-37805
2012-09-01,JP Morgan,CitiBank Pune,45493,81139,-35646
2012-10-01,JP Morgan,CitiBank Pune,48242,82166,-33924
2012-11-01,JP Morgan,CitiBank Pune,43412,83348,-39936
2012-12-01,JP Morgan,CitiBank Pune,48289,85569,-37280
2013-01-01,JP Morgan,CitiBank Pune,49577,84667,-35090
2013-02-01,JP Morgan,CitiBank Pune,46584,83847,-37263
2013-03-01,JP Morgan,CitiBank Pune,48217,85725,-37508
2013-04-01,JP Morgan,CitiBank Pune,44159,89613,-45454
2013-05-01,JP Morgan,CitiBank Pune,58965,77367,-18402
2013-06-01,JP Morgan,CitiBank Pune,56889,78271,-21382
2013-07-01,JP Morgan,CitiBank Pune,53646,79368,-25722
2013-08-01,JP Morgan,CitiBank Pune,55364,72389,-17025
2013-09-01,JP Morgan,CitiBank Pune,57154,78979,-21825
2013-10-01,JP Morgan,CitiBank Pune,59169,71252,-12083
2013-11-01,JP Morgan,CitiBank Pune,59921,77651,-17730
2013-12-01,JP Morgan,CitiBank Pune,51546,72184,-20638
2014-01-01,JP Morgan,CitiBank Pune,59439,76111,-16672
2014-02-01,JP Morgan,CitiBank Pune,57885,73445,-15560
2014-03-01,JP Morgan,CitiBank Pune,64976,77465,-12489
2014-04-01,JP Morgan,CitiBank Pune,66639,75136,-8497
2014-05-01,JP Morgan,CitiBank Pune,63686,75881,-12195
2014-06-01,JP Morgan,CitiBank Pune,66374,72476,-6102
2014-07-01,JP Morgan,CitiBank Pune,61153,71161,-10008
2014-08-01,JP Morgan,CitiBank Pune,65265,74996,-9731
2014-09-01,JP Morgan,CitiBank Pune,62491,75432,-12941
2014-10-01,JP Morgan,CitiBank Pune,63738,79112,-15374
2014-11-01,JP Morgan,CitiBank Pune,61823,74568,-12745
2014-12-01,JP Morgan,CitiBank Pune,66462,76512,-10050
2015-01-01,JP Morgan,CitiBank Pune,78442,67844,10598
2015-02-01,JP Morgan,CitiBank Pune,79849,64568,15281
2015-03-01,JP Morgan,CitiBank Pune,78732,64847,13885
2015-04-01,JP Morgan,CitiBank Pune,78358,62397,15961
2015-05-01,JP Morgan,CitiBank Pune,76471,64832,11639
2015-06-01,JP Morgan,CitiBank Pune,75677,68877,6800
2015-07-01,JP Morgan,CitiBank Pune,77512,65682,11830
2015-08-01,JP Morgan,CitiBank Pune,72336,66928,5408
2015-09-01,JP Morgan,CitiBank Pune,75615,68588,7027
2015-10-01,JP Morgan,CitiBank Pune,79781,67885,11896
2015-11-01,JP Morgan,CitiBank Pune,85529,68538,16991
2015-12-01,JP Morgan,CitiBank Pune,86992,69584,17408
2016-01-01,JP Morgan,CitiBank Pune,82343,66738,15605
2016-02-01,JP Morgan,CitiBank Pune,82218,61544,20674
2016-03-01,JP Morgan,CitiBank Pune,86768,62568,24200
2016-04-01,JP Morgan,CitiBank Pune,84986,69865,15121
2016-05-01,JP Morgan,CitiBank Pune,89633,67327,22306
2016-06-01,JP Morgan,CitiBank Pune,83741,61678,22063
2016-07-01,JP Morgan,CitiBank Pune,81644,62636,19008
2016-08-01,JP Morgan,CitiBank Pune,84216,66957,17259
2016-09-01,JP Morgan,CitiBank Pune,97644,56869,40775
2016-10-01,JP Morgan,CitiBank Pune,95283,58877,36406
2016-11-01,JP Morgan,CitiBank Pune,94984,54585,40399
2016-12-01,JP Morgan,CitiBank Pune,96519,53458,43061
2017-01-01,JP Morgan,CitiBank Pune,98821,59547,39274
2017-02-01,JP Morgan,CitiBank Pune,97227,53495,43732
2017-03-01,JP Morgan,CitiBank Pune,98736,51293,47443
2017-04-01,JP Morgan,CitiBank Pune,92269,52985,39284
2017-05-01,JP Morgan,CitiBank Pune,94134,52287,41847
2017-06-01,JP Morgan,CitiBank Pune,91338,51557,39781
2017-07-01,JP Morgan,CitiBank Pune,108829,55873,52956
2017-08-01,JP Morgan,CitiBank Pune,108219,55391,52828
2017-09-01,JP Morgan,CitiBank Pune,101143,58669,42474
2017-10-01,JP Morgan,CitiBank Pune,109172,54178,54994
2017-11-01,JP Morgan,CitiBank Pune,101554,51671,49883
2017-12-01,JP Morgan,CitiBank Pune,108432,55983,52449
2018-01-01,JP Morgan,CitiBank Pune,103257,52585,50672
2018-02-01,JP Morgan,CitiBank Pune,102113,59827,42286
2018-03-01,JP Morgan,CitiBank Pune,103211,58338,44873
2018-04-01,JP Morgan,CitiBank Pune,102537,59574,42963
2010-01-01,JP Morgan,CitiBank Singapore,14944,92736,-77792
2010-02-01,JP Morgan,CitiBank Singapore,13715,99942,-86227
2010-03-01,JP Morgan,CitiBank Singapore,15427,96872,-81445
2010-04-01,JP Morgan,CitiBank Singapore,12676,98486,-85810
2010-05-01,JP Morgan,CitiBank Singapore,18377,96965,-78588
2010-06-01,JP Morgan,CitiBank Singapore,13115,97236,-84121
2010-07-01,JP Morgan,CitiBank Singapore,14984,92118,-77134
2010-08-01,JP Morgan,CitiBank Singapore,13939,96454,-82515
2010-09-01,JP Morgan,CitiBank Singapore,11223,98424,-87201
2010-10-01,JP Morgan,CitiBank Singapore,13438,94761,-81323
2010-11-01,JP Morgan,CitiBank Singapore,27886,95789,-67903
2010-12-01,JP Morgan,CitiBank Singapore,22965,92991,-70026
2011-01-01,JP Morgan,CitiBank Singapore,28977,96323,-67346
2011-02-01,JP Morgan,CitiBank Singapore,21148,97721,-76573
2011-03-01,JP Morgan,CitiBank Singapore,23722,92785,-69063
2011-04-01,JP Morgan,CitiBank Singapore,28185,94436,-66251
2011-05-01,JP Morgan,CitiBank Singapore,22542,92727,-70185
2011-06-01,JP Morgan,CitiBank Singapore,26221,99647,-73426
2011-07-01,JP Morgan,CitiBank Singapore,24467,91439,-66972
2011-08-01,JP Morgan,CitiBank Singapore,25569,94523,-68954
2011-09-01,JP Morgan,CitiBank Singapore,38495,86818,-48323
2011-10-01,JP Morgan,CitiBank Singapore,36313,89996,-53683
2011-11-01,JP Morgan,CitiBank Singapore,38615,85493,-46878
2011-12-01,JP Morgan,CitiBank Singapore,39246,85529,-46283
2012-01-01,JP Morgan,CitiBank Singapore,37862,84931,-47069
2012-02-01,JP Morgan,CitiBank Singapore,38739,89926,-51187
2012-03-01,JP Morgan,CitiBank Singapore,35431,86387,-50956
2012-04-01,JP Morgan,CitiBank Singapore,39975,87188,-47213
2012-05-01,JP Morgan,CitiBank Singapore,38686,89954,-51268
2012-06-01,JP Morgan,CitiBank Singapore,33566,88532,-54966
2012-07-01,JP Morgan,CitiBank Singapore,45424,84598,-39174
2012-08-01,JP Morgan,CitiBank Singapore,45249,89972,-44723
2012-09-01,JP Morgan,CitiBank Singapore,47997,89747,-41750
2012-10-01,JP Morgan,CitiBank Singapore,43384,88643,-45259
2012-11-01,JP Morgan,CitiBank Singapore,47382,88111,-40729
2012-12-01,JP Morgan,CitiBank Singapore,47849,84643,-36794
2013-01-01,JP Morgan,CitiBank Singapore,45849,87683,-41834
2013-02-01,JP Morgan,CitiBank Singapore,45529,87787,-42258
2013-03-01,JP Morgan,CitiBank Singapore,42776,81987,-39211
2013-04-01,JP Morgan,CitiBank Singapore,48627,82694,-34067
2013-05-01,JP Morgan,CitiBank Singapore,58363,71673,-13310
2013-06-01,JP Morgan,CitiBank Singapore,53583,72133,-18550
2013-07-01,JP Morgan,CitiBank Singapore,56913,74171,-17258
2013-08-01,JP Morgan,CitiBank Singapore,53576,73467,-19891
2013-09-01,JP Morgan,CitiBank Singapore,54556,77159,-22603
2013-10-01,JP Morgan,CitiBank Singapore,52854,74472,-21618
2013-11-01,JP Morgan,CitiBank Singapore,53276,77112,-23836
2013-12-01,JP Morgan,CitiBank Singapore,59577,71434,-11857
2014-01-01,JP Morgan,CitiBank Singapore,52336,74152,-21816
2014-02-01,JP Morgan,CitiBank Singapore,57115,76826,-19711
2014-03-01,JP Morgan,CitiBank Singapore,67537,72794,-5257
2014-04-01,JP Morgan,CitiBank Singapore,69923,79112,-9189
2014-05-01,JP Morgan,CitiBank Singapore,63758,77611,-13853
2014-06-01,JP Morgan,CitiBank Singapore,69419,72615,-3196
2014-07-01,JP Morgan,CitiBank Singapore,61126,72714,-11588
2014-08-01,JP Morgan,CitiBank Singapore,67145,76535,-9390
2014-09-01,JP Morgan,CitiBank Singapore,69849,76853,-7004
2014-10-01,JP Morgan,CitiBank Singapore,68619,79869,-11250
2014-11-01,JP Morgan,CitiBank Singapore,65441,72565,-7124
2014-12-01,JP Morgan,CitiBank Singapore,61312,78632,-17320
2015-01-01,JP Morgan,CitiBank Singapore,73545,67355,6190
2015-02-01,JP Morgan,CitiBank Singapore,78952,69786,9166
2015-03-01,JP Morgan,CitiBank Singapore,79923,69561,10362
2015-04-01,JP Morgan,CitiBank Singapore,75329,62565,12764
2015-05-01,JP Morgan,CitiBank Singapore,71698,62293,9405
2015-06-01,JP Morgan,CitiBank Singapore,77749,62136,15613
2015-07-01,JP Morgan,CitiBank Singapore,72568,67184,5384
2015-08-01,JP Morgan,CitiBank Singapore,71896,62195,9701
2015-09-01,JP Morgan,CitiBank Singapore,71799,61824,9975
2015-10-01,JP Morgan,CitiBank Singapore,75571,69991,5580
2015-11-01,JP Morgan,CitiBank Singapore,86796,66898,19898
2015-12-01,JP Morgan,CitiBank Singapore,86452,68613,17839
2016-01-01,JP Morgan,CitiBank Singapore,82385,66346,16039
2016-02-01,JP Morgan,CitiBank Singapore,87729,68435,19294
2016-03-01,JP Morgan,CitiBank Singapore,88978,67289,21689
2016-04-01,JP Morgan,CitiBank Singapore,84333,65164,19169
2016-05-01,JP Morgan,CitiBank Singapore,87377,62567,24810
2016-06-01,JP Morgan,CitiBank Singapore,87256,67329,19927
2016-07-01,JP Morgan,CitiBank Singapore,89617,63293,26324
2016-08-01,JP Morgan,CitiBank Singapore,81129,66879,14250
2016-09-01,JP Morgan,CitiBank Singapore,91137,51941,39196
2016-10-01,JP Morgan,CitiBank Singapore,95739,58873,36866
2016-11-01,JP Morgan,CitiBank Singapore,94983,53412,41571
2016-12-01,JP Morgan,CitiBank Singapore,99289,55611,43678
2017-01-01,JP Morgan,CitiBank Singapore,97818,53988,43830
2017-02-01,JP Morgan,CitiBank Singapore,98733,56511,42222
2017-03-01,JP Morgan,CitiBank Singapore,91923,59833,32090
2017-04-01,JP Morgan,CitiBank Singapore,98498,51522,46976
2017-05-01,JP Morgan,CitiBank Singapore,91211,56229,34982
2017-06-01,JP Morgan,CitiBank Singapore,93681,51548,42133
2017-07-01,JP Morgan,CitiBank Singapore,108933,53444,55489
2017-08-01,JP Morgan,CitiBank Singapore,109579,52269,57310
2017-09-01,JP Morgan,CitiBank Singapore,107154,53446,53708
2017-10-01,JP Morgan,CitiBank Singapore,105937,54336,51601
2017-11-01,JP Morgan,CitiBank Singapore,104783,58615,46168
2017-12-01,JP Morgan,CitiBank Singapore,103162,55294,47868
2018-01-01,JP Morgan,CitiBank Singapore,107713,52536,55177
2018-02-01,JP Morgan,CitiBank Singapore,102465,52284,50181
2018-03-01,JP Morgan,CitiBank Singapore,105641,54295,51346
2018-04-01,JP Morgan,CitiBank Singapore,105365,56488,48877
2010-01-01,JP Morgan,CitiBank HongKong,17772,94358,-76586
2010-02-01,JP Morgan,CitiBank HongKong,13171,98514,-85343
2010-03-01,JP Morgan,CitiBank HongKong,19699,93577,-73878
2010-04-01,JP Morgan,CitiBank HongKong,18778,94584,-75806
2010-05-01,JP Morgan,CitiBank HongKong,19622,98228,-78606
2010-06-01,JP Morgan,CitiBank HongKong,11598,97234,-85636
2010-07-01,JP Morgan,CitiBank HongKong,18175,99578,-81403
2010-08-01,JP Morgan,CitiBank HongKong,18771,97942,-79171
2010-09-01,JP Morgan,CitiBank HongKong,13836,97337,-83501
2010-10-01,JP Morgan,CitiBank HongKong,12291,94521,-82230
2010-11-01,JP Morgan,CitiBank HongKong,26393,91128,-64735
2010-12-01,JP Morgan,CitiBank HongKong,29489,93941,-64452
2011-01-01,JP Morgan,CitiBank HongKong,26857,93341,-66484
2011-02-01,JP Morgan,CitiBank HongKong,28681,97771,-69090
2011-03-01,JP Morgan,CitiBank HongKong,26698,99571,-72873
2011-04-01,JP Morgan,CitiBank HongKong,28735,99283,-70548
2011-05-01,JP Morgan,CitiBank HongKong,27999,99826,-71827
2011-06-01,JP Morgan,CitiBank HongKong,22693,95679,-72986
2011-07-01,JP Morgan,CitiBank HongKong,24226,97719,-73493
2011-08-01,JP Morgan,CitiBank HongKong,25291,91377,-66086
2011-09-01,JP Morgan,CitiBank HongKong,39437,89881,-50444
2011-10-01,JP Morgan,CitiBank HongKong,36512,85659,-49147
2011-11-01,JP Morgan,CitiBank HongKong,31432,84854,-53422
2011-12-01,JP Morgan,CitiBank HongKong,36874,86548,-49674
2012-01-01,JP Morgan,CitiBank HongKong,38442,87992,-49550
2012-02-01,JP Morgan,CitiBank HongKong,34578,85355,-50777
2012-03-01,JP Morgan,CitiBank HongKong,37423,85948,-48525
2012-04-01,JP Morgan,CitiBank HongKong,32882,86899,-54017
2012-05-01,JP Morgan,CitiBank HongKong,33313,83975,-50662
2012-06-01,JP Morgan,CitiBank HongKong,39453,81953,-42500
2012-07-01,JP Morgan,CitiBank HongKong,46215,89116,-42901
2012-08-01,JP Morgan,CitiBank HongKong,48878,87613,-38735
2012-09-01,JP Morgan,CitiBank HongKong,43785,83961,-40176
2012-10-01,JP Morgan,CitiBank HongKong,48522,81462,-32940
2012-11-01,JP Morgan,CitiBank HongKong,49714,83875,-34161
2012-12-01,JP Morgan,CitiBank HongKong,42149,85392,-43243
2013-01-01,JP Morgan,CitiBank HongKong,45598,84687,-39089
2013-02-01,JP Morgan,CitiBank HongKong,48854,88185,-39331
2013-03-01,JP Morgan,CitiBank HongKong,45685,89851,-44166
2013-04-01,JP Morgan,CitiBank HongKong,49461,84858,-35397
2013-05-01,JP Morgan,CitiBank HongKong,56644,72825,-16181
2013-06-01,JP Morgan,CitiBank HongKong,58584,77722,-19138
2013-07-01,JP Morgan,CitiBank HongKong,58768,74824,-16056
2013-08-01,JP Morgan,CitiBank HongKong,59223,78577,-19354
2013-09-01,JP Morgan,CitiBank HongKong,58426,76315,-17889
2013-10-01,JP Morgan,CitiBank HongKong,54228,73469,-19241
2013-11-01,JP Morgan,CitiBank HongKong,56133,72857,-16724
2013-12-01,JP Morgan,CitiBank HongKong,54544,77454,-22910
2014-01-01,JP Morgan,CitiBank HongKong,57716,79812,-22096
2014-02-01,JP Morgan,CitiBank HongKong,57822,72778,-14956
2014-03-01,JP Morgan,CitiBank HongKong,62189,76196,-14007
2014-04-01,JP Morgan,CitiBank HongKong,64133,71217,-7084
2014-05-01,JP Morgan,CitiBank HongKong,69734,71922,-2188
2014-06-01,JP Morgan,CitiBank HongKong,67121,71497,-4376
2014-07-01,JP Morgan,CitiBank HongKong,62526,78877,-16351
2014-08-01,JP Morgan,CitiBank HongKong,62745,75738,-12993
2014-09-01,JP Morgan,CitiBank HongKong,69549,77369,-7820
2014-10-01,JP Morgan,CitiBank HongKong,69146,78176,-9030
2014-11-01,JP Morgan,CitiBank HongKong,62623,77361,-14738
2014-12-01,JP Morgan,CitiBank HongKong,64163,79254,-15091
2015-01-01,JP Morgan,CitiBank HongKong,75258,68569,6689
2015-02-01,JP Morgan,CitiBank HongKong,72366,67456,4910
2015-03-01,JP Morgan,CitiBank HongKong,71173,62514,8659
2015-04-01,JP Morgan,CitiBank HongKong,73197,64991,8206
2015-05-01,JP Morgan,CitiBank HongKong,76481,67789,8692
2015-06-01,JP Morgan,CitiBank HongKong,72489,64471,8018
2015-07-01,JP Morgan,CitiBank HongKong,79975,62726,17249
2015-08-01,JP Morgan,CitiBank HongKong,72546,68146,4400
2015-09-01,JP Morgan,CitiBank HongKong,77522,63266,14256
2015-10-01,JP Morgan,CitiBank HongKong,71734,67581,4153
2015-11-01,JP Morgan,CitiBank HongKong,86887,63477,23410
2015-12-01,JP Morgan,CitiBank HongKong,81749,63757,17992
2016-01-01,JP Morgan,CitiBank HongKong,81283,68911,12372
2016-02-01,JP Morgan,CitiBank HongKong,89936,62983,26953
2016-03-01,JP Morgan,CitiBank HongKong,89459,69587,19872
2016-04-01,JP Morgan,CitiBank HongKong,87163,63438,23725
2016-05-01,JP Morgan,CitiBank HongKong,84776,62752,22024
2016-06-01,JP Morgan,CitiBank HongKong,89528,61317,28211
2016-07-01,JP Morgan,CitiBank HongKong,88979,66731,22248
2016-08-01,JP Morgan,CitiBank HongKong,88951,68728,20223
2016-09-01,JP Morgan,CitiBank HongKong,95476,51581,43895
2016-10-01,JP Morgan,CitiBank HongKong,91427,52966,38461
2016-11-01,JP Morgan,CitiBank HongKong,98956,58467,40489
2016-12-01,JP Morgan,CitiBank HongKong,91217,52913,38304
2017-01-01,JP Morgan,CitiBank HongKong,92292,54714,37578
2017-02-01,JP Morgan,CitiBank HongKong,96657,56346,40311
2017-03-01,JP Morgan,CitiBank HongKong,92722,52237,40485
2017-04-01,JP Morgan,CitiBank HongKong,98773,57924,40849
2017-05-01,JP Morgan,CitiBank HongKong,93153,57786,35367
2017-06-01,JP Morgan,CitiBank HongKong,95541,58419,37122
2017-07-01,JP Morgan,CitiBank HongKong,108367,52935,55432
2017-08-01,JP Morgan,CitiBank HongKong,101937,55952,45985
2017-09-01,JP Morgan,CitiBank HongKong,107832,51896,55936
2017-10-01,JP Morgan,CitiBank HongKong,103392,56116,47276
2017-11-01,JP Morgan,CitiBank HongKong,106475,52429,54046
2017-12-01,JP Morgan,CitiBank HongKong,104674,53368,51306
2018-01-01,JP Morgan,CitiBank HongKong,103211,51833,51378
2018-02-01,JP Morgan,CitiBank HongKong,108169,59292,48877
2018-03-01,JP Morgan,CitiBank HongKong,107257,58759,48498
2018-04-01,JP Morgan,CitiBank HongKong,101672,52192,49480
2010-01-01,Bank of America,CitiBank New York,11542,94663,-83121
2010-02-01,Bank of America,CitiBank New York,18914,94592,-75678
2010-03-01,Bank of America,CitiBank New York,18148,99997,-81849
2010-04-01,Bank of America,CitiBank New York,17796,93355,-75559
2010-05-01,Bank of America,CitiBank New York,15624,91881,-76257
2010-06-01,Bank of America,CitiBank New York,17678,91491,-73813
2010-07-01,Bank of America,CitiBank New York,18356,95492,-77136
2010-08-01,Bank of America,CitiBank New York,11236,92977,-81741
2010-09-01,Bank of America,CitiBank New York,19242,98222,-78980
2010-10-01,Bank of America,CitiBank New York,18488,99416,-80928
2010-11-01,Bank of America,CitiBank New York,28413,92483,-64070
2010-12-01,Bank of America,CitiBank New York,25336,95421,-70085
2011-01-01,Bank of America,CitiBank New York,23592,92512,-68920
2011-02-01,Bank of America,CitiBank New York,23956,97669,-73713
2011-03-01,Bank of America,CitiBank New York,23728,92155,-68427
2011-04-01,Bank of America,CitiBank New York,26736,93182,-66446
2011-05-01,Bank of America,CitiBank New York,26471,99449,-72978
2011-06-01,Bank of America,CitiBank New York,25845,92132,-66287
2011-07-01,Bank of America,CitiBank New York,25575,95296,-69721
2011-08-01,Bank of America,CitiBank New York,25239,92469,-67230
2011-09-01,Bank of America,CitiBank New York,35156,83367,-48211
2011-10-01,Bank of America,CitiBank New York,39796,82498,-42702
2011-11-01,Bank of America,CitiBank New York,39357,81161,-41804
2011-12-01,Bank of America,CitiBank New York,37345,85965,-48620
2012-01-01,Bank of America,CitiBank New York,38556,85964,-47408
2012-02-01,Bank of America,CitiBank New York,37299,83353,-46054
2012-03-01,Bank of America,CitiBank New York,32259,87159,-54900
2012-04-01,Bank of America,CitiBank New York,31712,85834,-54122
2012-05-01,Bank of America,CitiBank New York,34155,82329,-48174
2012-06-01,Bank of America,CitiBank New York,39245,81537,-42292
2012-07-01,Bank of America,CitiBank New York,45621,84784,-39163
2012-08-01,Bank of America,CitiBank New York,44126,89332,-45206
2012-09-01,Bank of America,CitiBank New York,44791,86923,-42132
2012-10-01,Bank of America,CitiBank New York,49383,87689,-38306
2012-11-01,Bank of America,CitiBank New York,41923,81262,-39339
2012-12-01,Bank of America,CitiBank New York,45554,85438,-39884
2013-01-01,Bank of America,CitiBank New York,46739,86358,-39619
2013-02-01,Bank of America,CitiBank New York,45513,82762,-37249
2013-03-01,Bank of America,CitiBank New York,44418,86156,-41738
2013-04-01,Bank of America,CitiBank New York,46656,81944,-35288
2013-05-01,Bank of America,CitiBank New York,59627,78783,-19156
2013-06-01,Bank of America,CitiBank New York,55533,76465,-20932
2013-07-01,Bank of America,CitiBank New York,56439,71498,-15059
2013-08-01,Bank of America,CitiBank New York,54146,71534,-17388
2013-09-01,Bank of America,CitiBank New York,53949,72893,-18944
2013-10-01,Bank of America,CitiBank New York,53751,72718,-18967
2013-11-01,Bank of America,CitiBank New York,52228,75689,-23461
2013-12-01,Bank of America,CitiBank New York,58912,77759,-18847
2014-01-01,Bank of America,CitiBank New York,53466,78133,-24667
2014-02-01,Bank of America,CitiBank New York,58217,77556,-19339
2014-03-01,Bank of America,CitiBank New York,64258,73111,-8853
2014-04-01,Bank of America,CitiBank New York,64647,73745,-9098
2014-05-01,Bank of America,CitiBank New York,63621,74945,-11324
2014-06-01,Bank of America,CitiBank New York,62887,76861,-13974
2014-07-01,Bank of America,CitiBank New York,63752,71923,-8171
2014-08-01,Bank of America,CitiBank New York,64228,75244,-11016
2014-09-01,Bank of America,CitiBank New York,63125,78995,-15870
2014-10-01,Bank of America,CitiBank New York,61739,72668,-10929
2014-11-01,Bank of America,CitiBank New York,66637,77984,-11347
2014-12-01,Bank of America,CitiBank New York,61125,79128,-18003
2015-01-01,Bank of America,CitiBank New York,72248,68135,4113
2015-02-01,Bank of America,CitiBank New York,74198,67259,6939
2015-03-01,Bank of America,CitiBank New York,74727,63171,11556
2015-04-01,Bank of America,CitiBank New York,79713,64362,15351
2015-05-01,Bank of America,CitiBank New York,78238,69158,9080
2015-06-01,Bank of America,CitiBank New York,72525,65569,6956
2015-07-01,Bank of America,CitiBank New York,76226,62352,13874
2015-08-01,Bank of America,CitiBank New York,78366,62412,15954
2015-09-01,Bank of America,CitiBank New York,75723,64822,10901
2015-10-01,Bank of America,CitiBank New York,73836,66644,7192
2015-11-01,Bank of America,CitiBank New York,86841,65113,21728
2015-12-01,Bank of America,CitiBank New York,86255,64477,21778
2016-01-01,Bank of America,CitiBank New York,85229,66567,18662
2016-02-01,Bank of America,CitiBank New York,87827,62596,25231
2016-03-01,Bank of America,CitiBank New York,88382,67747,20635
2016-04-01,Bank of America,CitiBank New York,81412,69982,11430
2016-05-01,Bank of America,CitiBank New York,82378,65324,17054
2016-06-01,Bank of America,CitiBank New York,85967,64191,21776
2016-07-01,Bank of America,CitiBank New York,82515,66268,16247
2016-08-01,Bank of America,CitiBank New York,89517,66195,23322
2016-09-01,Bank of America,CitiBank New York,97629,51571,46058
2016-10-01,Bank of America,CitiBank New York,98345,58366,39979
2016-11-01,Bank of America,CitiBank New York,93837,58142,35695
2016-12-01,Bank of America,CitiBank New York,94368,58985,35383
2017-01-01,Bank of America,CitiBank New York,97111,58799,38312
2017-02-01,Bank of America,CitiBank New York,93465,51115,42350
2017-03-01,Bank of America,CitiBank New York,98143,58217,39926
2017-04-01,Bank of America,CitiBank New York,91779,54794,36985
2017-05-01,Bank of America,CitiBank New York,93472,59492,33980
2017-06-01,Bank of America,CitiBank New York,91545,51228,40317
2017-07-01,Bank of America,CitiBank New York,104651,51458,53193
2017-08-01,Bank of America,CitiBank New York,103326,51163,52163
2017-09-01,Bank of America,CitiBank New York,109911,59258,50653
2017-10-01,Bank of America,CitiBank New York,105295,56682,48613
2017-11-01,Bank of America,CitiBank New York,102414,54612,47802
2017-12-01,Bank of America,CitiBank New York,104618,59152,45466
2018-01-01,Bank of America,CitiBank New York,108673,57634,51039
2018-02-01,Bank of America,CitiBank New York,103639,52513,51126
2018-03-01,Bank of America,CitiBank New York,101536,52348,49188
2018-04-01,Bank of America,CitiBank New York,108853,56657,52196
2010-01-01,Bank of America,CitiBank London,14535,94668,-80133
2010-02-01,Bank of America,CitiBank London,11313,91985,-80672
2010-03-01,Bank of America,CitiBank London,16182,96148,-79966
2010-04-01,Bank of America,CitiBank London,12642,91641,-78999
2010-05-01,Bank of America,CitiBank London,15815,96959,-81144
2010-06-01,Bank of America,CitiBank London,16147,93571,-77424
2010-07-01,Bank of America,CitiBank London,16598,95383,-78785
2010-08-01,Bank of America,CitiBank London,19846,94285,-74439
2010-09-01,Bank of America,CitiBank London,17286,94873,-77587
2010-10-01,Bank of America,CitiBank London,19219,96886,-77667
2010-11-01,Bank of America,CitiBank London,24947,99373,-74426
2010-12-01,Bank of America,CitiBank London,24768,91488,-66720
2011-01-01,Bank of America,CitiBank London,21723,94311,-72588
2011-02-01,Bank of America,CitiBank London,25174,96124,-70950
2011-03-01,Bank of America,CitiBank London,26597,98278,-71681
2011-04-01,Bank of America,CitiBank London,28747,93479,-64732
2011-05-01,Bank of America,CitiBank London,21196,92847,-71651
2011-06-01,Bank of America,CitiBank London,27897,96168,-68271
2011-07-01,Bank of America,CitiBank London,21957,93172,-71215
2011-08-01,Bank of America,CitiBank London,27496,95128,-67632
2011-09-01,Bank of America,CitiBank London,37938,84828,-46890
2011-10-01,Bank of America,CitiBank London,33572,86242,-52670
2011-11-01,Bank of America,CitiBank London,33312,81853,-48541
2011-12-01,Bank of America,CitiBank London,33688,85425,-51737
2012-01-01,Bank of America,CitiBank London,38829,85619,-46790
2012-02-01,Bank of America,CitiBank London,35469,83583,-48114
2012-03-01,Bank of America,CitiBank London,36315,86249,-49934
2012-04-01,Bank of America,CitiBank London,35278,82117,-46839
2012-05-01,Bank of America,CitiBank London,35641,83616,-47975
2012-06-01,Bank of America,CitiBank London,38747,89444,-50697
2012-07-01,Bank of America,CitiBank London,41442,87536,-46094
2012-08-01,Bank of America,CitiBank London,44248,82569,-38321
2012-09-01,Bank of America,CitiBank London,44563,88159,-43596
2012-10-01,Bank of America,CitiBank London,43786,84355,-40569
2012-11-01,Bank of America,CitiBank London,44474,81629,-37155
2012-12-01,Bank of America,CitiBank London,44519,87115,-42596
2013-01-01,Bank of America,CitiBank London,46881,84735,-37854
2013-02-01,Bank of America,CitiBank London,49244,82831,-33587
2013-03-01,Bank of America,CitiBank London,47699,88444,-40745
2013-04-01,Bank of America,CitiBank London,45594,82961,-37367
2013-05-01,Bank of America,CitiBank London,59169,72122,-12953
2013-06-01,Bank of America,CitiBank London,55823,78322,-22499
2013-07-01,Bank of America,CitiBank London,51319,78228,-26909
2013-08-01,Bank of America,CitiBank London,57948,73575,-15627
2013-09-01,Bank of America,CitiBank London,59238,72456,-13218
2013-10-01,Bank of America,CitiBank London,57985,77842,-19857
2013-11-01,Bank of America,CitiBank London,51847,75776,-23929
2013-12-01,Bank of America,CitiBank London,56484,76294,-19810
2014-01-01,Bank of America,CitiBank London,51612,76567,-24955
2014-02-01,Bank of America,CitiBank London,58827,77566,-18739
2014-03-01,Bank of America,CitiBank London,69462,71711,-2249
2014-04-01,Bank of America,CitiBank London,63867,79893,-16026
2014-05-01,Bank of America,CitiBank London,69636,78938,-9302
2014-06-01,Bank of America,CitiBank London,62293,71421,-9128
2014-07-01,Bank of America,CitiBank London,65321,78214,-12893
2014-08-01,Bank of America,CitiBank London,67861,78918,-11057
2014-09-01,Bank of America,CitiBank London,67993,79673,-11680
2014-10-01,Bank of America,CitiBank London,61515,78668,-17153
2014-11-01,Bank of America,CitiBank London,68324,74688,-6364
2014-12-01,Bank of America,CitiBank London,67999,71863,-3864
2015-01-01,Bank of America,CitiBank London,78631,66533,12098
2015-02-01,Bank of America,CitiBank London,73973,69185,4788
2015-03-01,Bank of America,CitiBank London,73139,62982,10157
2015-04-01,Bank of America,CitiBank London,74236,64432,9804
2015-05-01,Bank of America,CitiBank London,77874,61366,16508
2015-06-01,Bank of America,CitiBank London,79749,67568,12181
2015-07-01,Bank of America,CitiBank London,76347,66498,9849
2015-08-01,Bank of America,CitiBank London,77317,68719,8598
2015-09-01,Bank of America,CitiBank London,76828,69276,7552
2015-10-01,Bank of America,CitiBank London,78855,66873,11982
2015-11-01,Bank of America,CitiBank London,88322,63331,24991
2015-12-01,Bank of America,CitiBank London,88668,62277,26391
2016-01-01,Bank of America,CitiBank London,85828,63688,22140
2016-02-01,Bank of America,CitiBank London,85918,64582,21336
2016-03-01,Bank of America,CitiBank London,83494,64256,19238
2016-04-01,Bank of America,CitiBank London,87277,68772,18505
2016-05-01,Bank of America,CitiBank London,83522,62468,21054
2016-06-01,Bank of America,CitiBank London,83455,67119,16336
2016-07-01,Bank of America,CitiBank London,83241,64547,18694
2016-08-01,Bank of America,CitiBank London,86684,69535,17149
2016-09-01,Bank of America,CitiBank London,95629,52444,43185
2016-10-01,Bank of America,CitiBank London,94293,58838,35455
2016-11-01,Bank of America,CitiBank London,97833,55298,42535
2016-12-01,Bank of America,CitiBank London,99357,58796,40561
2017-01-01,Bank of America,CitiBank London,96634,52393,44241
2017-02-01,Bank of America,CitiBank London,93712,58564,35148
2017-03-01,Bank of America,CitiBank London,91476,56683,34793
2017-04-01,Bank of America,CitiBank London,98468,56138,42330
2017-05-01,Bank of America,CitiBank London,93668,51971,41697
2017-06-01,Bank of America,CitiBank London,96362,56877,39485
2017-07-01,Bank of America,CitiBank London,108346,57421,50925
2017-08-01,Bank of America,CitiBank London,108662,55616,53046
2017-09-01,Bank of America,CitiBank London,102443,54225,48218
2017-10-01,Bank of America,CitiBank London,107167,57835,49332
2017-11-01,Bank of America,CitiBank London,105666,51374,54292
2017-12-01,Bank of America,CitiBank London,105446,52529,52917
2018-01-01,Bank of America,CitiBank London,103329,56455,46874
2018-02-01,Bank of America,CitiBank London,103228,52786,50442
2018-03-01,Bank of America,CitiBank London,108857,54296,54561
2018-04-01,Bank of America,CitiBank London,107615,57919,49696
2010-01-01,Bank of America,CitiBank Pune,14611,92764,-78153
2010-02-01,Bank of America,CitiBank Pune,16866,99226,-82360
2010-03-01,Bank of America,CitiBank Pune,15845,97629,-81784
2010-04-01,Bank of America,CitiBank Pune,18367,99146,-80779
2010-05-01,Bank of America,CitiBank Pune,15555,92684,-77129
2010-06-01,Bank of America,CitiBank Pune,18477,99842,-81365
2010-07-01,Bank of America,CitiBank Pune,11752,91622,-79870
2010-08-01,Bank of America,CitiBank Pune,16232,99681,-83449
2010-09-01,Bank of America,CitiBank Pune,17124,93883,-76759
2010-10-01,Bank of America,CitiBank Pune,16834,94886,-78052
2010-11-01,Bank of America,CitiBank Pune,25478,99179,-73701
2010-12-01,Bank of America,CitiBank Pune,26414,95918,-69504
2011-01-01,Bank of America,CitiBank Pune,27723,91363,-63640
2011-02-01,Bank of America,CitiBank Pune,22497,94478,-71981
2011-03-01,Bank of America,CitiBank Pune,25855,93789,-67934
2011-04-01,Bank of America,CitiBank Pune,29145,92694,-63549
2011-05-01,Bank of America,CitiBank Pune,22566,94436,-71870
2011-06-01,Bank of America,CitiBank Pune,21593,94833,-73240
2011-07-01,Bank of America,CitiBank Pune,23317,95973,-72656
2011-08-01,Bank of America,CitiBank Pune,25144,94583,-69439
2011-09-01,Bank of America,CitiBank Pune,34329,88322,-53993
2011-10-01,Bank of America,CitiBank Pune,33964,83869,-49905
2011-11-01,Bank of America,CitiBank Pune,39296,84663,-45367
2011-12-01,Bank of America,CitiBank Pune,37796,86656,-48860
2012-01-01,Bank of America,CitiBank Pune,37767,86116,-48349
2012-02-01,Bank of America,CitiBank Pune,35845,87441,-51596
2012-03-01,Bank of America,CitiBank Pune,38381,87485,-49104
2012-04-01,Bank of America,CitiBank Pune,35646,87692,-52046
2012-05-01,Bank of America,CitiBank Pune,35221,86786,-51565
2012-06-01,Bank of America,CitiBank Pune,35598,88286,-52688
2012-07-01,Bank of America,CitiBank Pune,41276,81586,-40310
2012-08-01,Bank of America,CitiBank Pune,44348,89128,-44780
2012-09-01,Bank of America,CitiBank Pune,46953,87744,-40791
2012-10-01,Bank of America,CitiBank Pune,41596,83341,-41745
2012-11-01,Bank of America,CitiBank Pune,49579,87256,-37677
2012-12-01,Bank of America,CitiBank Pune,48155,86559,-38404
2013-01-01,Bank of America,CitiBank Pune,42434,81218,-38784
2013-02-01,Bank of America,CitiBank Pune,41757,82135,-40378
2013-03-01,Bank of America,CitiBank Pune,45759,88548,-42789
2013-04-01,Bank of America,CitiBank Pune,49278,89557,-40279
2013-05-01,Bank of America,CitiBank Pune,52917,78972,-26055
2013-06-01,Bank of America,CitiBank Pune,57114,75514,-18400
2013-07-01,Bank of America,CitiBank Pune,59868,72728,-12860
2013-08-01,Bank of America,CitiBank Pune,52766,75652,-22886
2013-09-01,Bank of America,CitiBank Pune,52529,76637,-24108
2013-10-01,Bank of America,CitiBank Pune,59575,74652,-15077
2013-11-01,Bank of America,CitiBank Pune,53416,78116,-24700
2013-12-01,Bank of America,CitiBank Pune,56173,77549,-21376
2014-01-01,Bank of America,CitiBank Pune,58277,71611,-13334
2014-02-01,Bank of America,CitiBank Pune,55497,75246,-19749
2014-03-01,Bank of America,CitiBank Pune,61249,71523,-10274
2014-04-01,Bank of America,CitiBank Pune,64214,71761,-7547
2014-05-01,Bank of America,CitiBank Pune,63686,77691,-14005
2014-06-01,Bank of America,CitiBank Pune,62163,75338,-13175
2014-07-01,Bank of America,CitiBank Pune,61215,74431,-13216
2014-08-01,Bank of America,CitiBank Pune,62988,74875,-11887
2014-09-01,Bank of America,CitiBank Pune,64144,78941,-14797
2014-10-01,Bank of America,CitiBank Pune,61517,75115,-13598
2014-11-01,Bank of America,CitiBank Pune,67876,77992,-10116
2014-12-01,Bank of America,CitiBank Pune,67229,77112,-9883
2015-01-01,Bank of America,CitiBank Pune,75721,61643,14078
2015-02-01,Bank of America,CitiBank Pune,75737,62282,13455
2015-03-01,Bank of America,CitiBank Pune,76242,68923,7319
2015-04-01,Bank of America,CitiBank Pune,75567,63236,12331
2015-05-01,Bank of America,CitiBank Pune,78546,67391,11155
2015-06-01,Bank of America,CitiBank Pune,78426,62387,16039
2015-07-01,Bank of America,CitiBank Pune,75267,68988,6279
2015-08-01,Bank of America,CitiBank Pune,72239,69898,2341
2015-09-01,Bank of America,CitiBank Pune,74737,63975,10762
2015-10-01,Bank of America,CitiBank Pune,73692,66811,6881
2015-11-01,Bank of America,CitiBank Pune,81468,63622,17846
2015-12-01,Bank of America,CitiBank Pune,85278,63561,21717
2016-01-01,Bank of America,CitiBank Pune,84549,66532,18017
2016-02-01,Bank of America,CitiBank Pune,88772,61957,26815
2016-03-01,Bank of America,CitiBank Pune,82341,66286,16055
2016-04-01,Bank of America,CitiBank Pune,86934,66291,20643
2016-05-01,Bank of America,CitiBank Pune,87282,66311,20971
2016-06-01,Bank of America,CitiBank Pune,85863,65121,20742
2016-07-01,Bank of America,CitiBank Pune,84332,64342,19990
2016-08-01,Bank of America,CitiBank Pune,86661,66318,20343
2016-09-01,Bank of America,CitiBank Pune,91138,57329,33809
2016-10-01,Bank of America,CitiBank Pune,96834,51918,44916
2016-11-01,Bank of America,CitiBank Pune,97615,55338,42277
2016-12-01,Bank of America,CitiBank Pune,92924,51335,41589
2017-01-01,Bank of America,CitiBank Pune,94448,55793,38655
2017-02-01,Bank of America,CitiBank Pune,96227,56462,39765
2017-03-01,Bank of America,CitiBank Pune,93477,55669,37808
2017-04-01,Bank of America,CitiBank Pune,99412,53691,45721
2017-05-01,Bank of America,CitiBank Pune,94126,51599,42527
2017-06-01,Bank of America,CitiBank Pune,99689,59272,40417
2017-07-01,Bank of America,CitiBank Pune,105631,55143,50488
2017-08-01,Bank of America,CitiBank Pune,102153,55981,46172
2017-09-01,Bank of America,CitiBank Pune,109287,52297,56990
2017-10-01,Bank of America,CitiBank Pune,109428,56466,52962
2017-11-01,Bank of America,CitiBank Pune,108283,51795,56488
2017-12-01,Bank of America,CitiBank Pune,105357,56581,48776
2018-01-01,Bank of America,CitiBank Pune,105587,54512,51075
2018-02-01,Bank of America,CitiBank Pune,105691,55137,50554
2018-03-01,Bank of America,CitiBank Pune,106419,56349,50070
2018-04-01,Bank of America,CitiBank Pune,109161,56357,52804
2010-01-01,Bank of America,CitiBank Singapore,16262,94634,-78372
2010-02-01,Bank of America,CitiBank Singapore,11536,94785,-83249
2010-03-01,Bank of America,CitiBank Singapore,11889,99582,-87693
2010-04-01,Bank of America,CitiBank Singapore,18443,98759,-80316
2010-05-01,Bank of America,CitiBank Singapore,11987,98247,-86260
2010-06-01,Bank of America,CitiBank Singapore,13757,97911,-84154
2010-07-01,Bank of America,CitiBank Singapore,17314,91959,-74645
2010-08-01,Bank of America,CitiBank Singapore,19424,93486,-74062
2010-09-01,Bank of America,CitiBank Singapore,18252,97928,-79676
2010-10-01,Bank of America,CitiBank Singapore,14532,92766,-78234
2010-11-01,Bank of America,CitiBank Singapore,21635,92933,-71298
2010-12-01,Bank of America,CitiBank Singapore,28585,93438,-64853
2011-01-01,Bank of America,CitiBank Singapore,29852,97997,-68145
2011-02-01,Bank of America,CitiBank Singapore,25639,91198,-65559
2011-03-01,Bank of America,CitiBank Singapore,22186,91921,-69735
2011-04-01,Bank of America,CitiBank Singapore,29169,97825,-68656
2011-05-01,Bank of America,CitiBank Singapore,25796,91333,-65537
2011-06-01,Bank of America,CitiBank Singapore,27414,91244,-63830
2011-07-01,Bank of America,CitiBank Singapore,27151,99149,-71998
2011-08-01,Bank of America,CitiBank Singapore,26834,92396,-65562
2011-09-01,Bank of America,CitiBank Singapore,32145,83892,-51747
2011-10-01,Bank of America,CitiBank Singapore,36518,85412,-48894
2011-11-01,Bank of America,CitiBank Singapore,34881,83723,-48842
2011-12-01,Bank of America,CitiBank Singapore,33232,85727,-52495
2012-01-01,Bank of America,CitiBank Singapore,35329,87762,-52433
2012-02-01,Bank of America,CitiBank Singapore,34819,86791,-51972
2012-03-01,Bank of America,CitiBank Singapore,39226,88447,-49221
2012-04-01,Bank of America,CitiBank Singapore,36349,83883,-47534
2012-05-01,Bank of America,CitiBank Singapore,37784,83556,-45772
2012-06-01,Bank of America,CitiBank Singapore,32131,84132,-52001
2012-07-01,Bank of America,CitiBank Singapore,47826,85227,-37401
2012-08-01,Bank of America,CitiBank Singapore,41855,82854,-40999
2012-09-01,Bank of America,CitiBank Singapore,46554,84587,-38033
2012-10-01,Bank of America,CitiBank Singapore,47618,85187,-37569
2012-11-01,Bank of America,CitiBank Singapore,45643,81944,-36301
2012-12-01,Bank of America,CitiBank Singapore,48892,89969,-41077
2013-01-01,Bank of America,CitiBank Singapore,47964,87787,-39823
2013-02-01,Bank of America,CitiBank Singapore,46254,86431,-40177
2013-03-01,Bank of America,CitiBank Singapore,41733,86721,-44988
2013-04-01,Bank of America,CitiBank Singapore,44865,83431,-38566
2013-05-01,Bank of America,CitiBank Singapore,51229,79228,-27999
2013-06-01,Bank of America,CitiBank Singapore,57418,79514,-22096
2013-07-01,Bank of America,CitiBank Singapore,54991,72776,-17785
2013-08-01,Bank of America,CitiBank Singapore,55547,74941,-19394
2013-09-01,Bank of America,CitiBank Singapore,55395,76948,-21553
2013-10-01,Bank of America,CitiBank Singapore,53172,73865,-20693
2013-11-01,Bank of America,CitiBank Singapore,54554,73869,-19315
2013-12-01,Bank of America,CitiBank Singapore,54523,79881,-25358
2014-01-01,Bank of America,CitiBank Singapore,56251,78547,-22296
2014-02-01,Bank of America,CitiBank Singapore,53855,76776,-22921
2014-03-01,Bank of America,CitiBank Singapore,67411,75245,-7834
2014-04-01,Bank of America,CitiBank Singapore,63738,74836,-11098
2014-05-01,Bank of America,CitiBank Singapore,69732,75138,-5406
2014-06-01,Bank of America,CitiBank Singapore,62827,72642,-9815
2014-07-01,Bank of America,CitiBank Singapore,66428,72987,-6559
2014-08-01,Bank of America,CitiBank Singapore,69815,76317,-6502
2014-09-01,Bank of America,CitiBank Singapore,68729,75288,-6559
2014-10-01,Bank of America,CitiBank Singapore,61875,74869,-12994
2014-11-01,Bank of America,CitiBank Singapore,63526,74893,-11367
2014-12-01,Bank of America,CitiBank Singapore,63255,73514,-10259
2015-01-01,Bank of America,CitiBank Singapore,75869,61321,14548
2015-02-01,Bank of America,CitiBank Singapore,78377,62583,15794
2015-03-01,Bank of America,CitiBank Singapore,72739,69236,3503
2015-04-01,Bank of America,CitiBank Singapore,76379,63663,12716
2015-05-01,Bank of America,CitiBank Singapore,77845,64328,13517
2015-06-01,Bank of America,CitiBank Singapore,73633,67515,6118
2015-07-01,Bank of America,CitiBank Singapore,72446,66247,6199
2015-08-01,Bank of America,CitiBank Singapore,76373,66358,10015
2015-09-01,Bank of America,CitiBank Singapore,79226,66315,12911
2015-10-01,Bank of America,CitiBank Singapore,78821,64138,14683
2015-11-01,Bank of America,CitiBank Singapore,85943,63229,22714
2015-12-01,Bank of America,CitiBank Singapore,87512,65762,21750
2016-01-01,Bank of America,CitiBank Singapore,83279,68428,14851
2016-02-01,Bank of America,CitiBank Singapore,83594,69549,14045
2016-03-01,Bank of America,CitiBank Singapore,86158,65466,20692
2016-04-01,Bank of America,CitiBank Singapore,86244,68226,18018
2016-05-01,Bank of America,CitiBank Singapore,84613,63191,21422
2016-06-01,Bank of America,CitiBank Singapore,83368,67357,16011
2016-07-01,Bank of America,CitiBank Singapore,88193,65148,23045
2016-08-01,Bank of America,CitiBank Singapore,81649,65638,16011
2016-09-01,Bank of America,CitiBank Singapore,92746,58787,33959
2016-10-01,Bank of America,CitiBank Singapore,99987,57687,42300
2016-11-01,Bank of America,CitiBank Singapore,96271,54692,41579
2016-12-01,Bank of America,CitiBank Singapore,95981,58585,37396
2017-01-01,Bank of America,CitiBank Singapore,91938,52632,39306
2017-02-01,Bank of America,CitiBank Singapore,96121,53957,42164
2017-03-01,Bank of America,CitiBank Singapore,92929,57568,35361
2017-04-01,Bank of America,CitiBank Singapore,99274,54551,44723
2017-05-01,Bank of America,CitiBank Singapore,92259,52135,40124
2017-06-01,Bank of America,CitiBank Singapore,93537,53512,40025
2017-07-01,Bank of America,CitiBank Singapore,109618,54499,55119
2017-08-01,Bank of America,CitiBank Singapore,109678,53344,56334
2017-09-01,Bank of America,CitiBank Singapore,104373,57523,46850
2017-10-01,Bank of America,CitiBank Singapore,108493,55962,52531
2017-11-01,Bank of America,CitiBank Singapore,103249,53765,49484
2017-12-01,Bank of America,CitiBank Singapore,107881,51319,56562
2018-01-01,Bank of America,CitiBank Singapore,107542,55373,52169
2018-02-01,Bank of America,CitiBank Singapore,104137,58626,45511
2018-03-01,Bank of America,CitiBank Singapore,107441,55211,52230
2018-04-01,Bank of America,CitiBank Singapore,108199,55563,52636
2010-01-01,Bank of America,CitiBank HongKong,16919,93244,-76325
2010-02-01,Bank of America,CitiBank HongKong,18643,95288,-76645
2010-03-01,Bank of America,CitiBank HongKong,16161,93495,-77334
2010-04-01,Bank of America,CitiBank HongKong,17734,96814,-79080
2010-05-01,Bank of America,CitiBank HongKong,12936,96933,-83997
2010-06-01,Bank of America,CitiBank HongKong,16122,92924,-76802
2010-07-01,Bank of America,CitiBank HongKong,13361,95561,-82200
2010-08-01,Bank of America,CitiBank HongKong,13362,99539,-86177
2010-09-01,Bank of America,CitiBank HongKong,12352,98933,-86581
2010-10-01,Bank of America,CitiBank HongKong,17192,95646,-78454
2010-11-01,Bank of America,CitiBank HongKong,21451,99248,-77797
2010-12-01,Bank of America,CitiBank HongKong,28198,94571,-66373
2011-01-01,Bank of America,CitiBank HongKong,23827,91957,-68130
2011-02-01,Bank of America,CitiBank HongKong,28475,97784,-69309
2011-03-01,Bank of America,CitiBank HongKong,28987,91422,-62435
2011-04-01,Bank of America,CitiBank HongKong,26944,92228,-65284
2011-05-01,Bank of America,CitiBank HongKong,27156,91433,-64277
2011-06-01,Bank of America,CitiBank HongKong,21577,94481,-72904
2011-07-01,Bank of America,CitiBank HongKong,25261,99426,-74165
2011-08-01,Bank of America,CitiBank HongKong,26676,91517,-64841
2011-09-01,Bank of America,CitiBank HongKong,34566,85314,-50748
2011-10-01,Bank of America,CitiBank HongKong,39177,86693,-47516
2011-11-01,Bank of America,CitiBank HongKong,39969,83927,-43958
2011-12-01,Bank of America,CitiBank HongKong,38397,89565,-51168
2012-01-01,Bank of America,CitiBank HongKong,36779,82887,-46108
2012-02-01,Bank of America,CitiBank HongKong,38979,84934,-45955
2012-03-01,Bank of America,CitiBank HongKong,39395,88382,-48987
2012-04-01,Bank of America,CitiBank HongKong,35558,86337,-50779
2012-05-01,Bank of America,CitiBank HongKong,37353,81345,-43992
2012-06-01,Bank of America,CitiBank HongKong,38586,89135,-50549
2012-07-01,Bank of America,CitiBank HongKong,41521,83138,-41617
2012-08-01,Bank of America,CitiBank HongKong,44851,85198,-40347
2012-09-01,Bank of America,CitiBank HongKong,44167,83664,-39497
2012-10-01,Bank of America,CitiBank HongKong,41158,86231,-45073
2012-11-01,Bank of America,CitiBank HongKong,45766,82892,-37126
2012-12-01,Bank of America,CitiBank HongKong,42986,81857,-38871
2013-01-01,Bank of America,CitiBank HongKong,48124,83713,-35589
2013-02-01,Bank of America,CitiBank HongKong,45925,88135,-42210
2013-03-01,Bank of America,CitiBank HongKong,42424,85782,-43358
2013-04-01,Bank of America,CitiBank HongKong,46768,86833,-40065
2013-05-01,Bank of America,CitiBank HongKong,56975,71291,-14316
2013-06-01,Bank of America,CitiBank HongKong,56328,79885,-23557
2013-07-01,Bank of America,CitiBank HongKong,59758,72542,-12784
2013-08-01,Bank of America,CitiBank HongKong,57422,71433,-14011
2013-09-01,Bank of America,CitiBank HongKong,54564,79479,-24915
2013-10-01,Bank of America,CitiBank HongKong,57743,71359,-13616
2013-11-01,Bank of America,CitiBank HongKong,51426,79642,-28216
2013-12-01,Bank of America,CitiBank HongKong,54616,74676,-20060
2014-01-01,Bank of America,CitiBank HongKong,51918,75666,-23748
2014-02-01,Bank of America,CitiBank HongKong,51396,79447,-28051
2014-03-01,Bank of America,CitiBank HongKong,68271,79589,-11318
2014-04-01,Bank of America,CitiBank HongKong,63424,71263,-7839
2014-05-01,Bank of America,CitiBank HongKong,67715,78633,-10918
2014-06-01,Bank of America,CitiBank HongKong,65762,75677,-9915
2014-07-01,Bank of America,CitiBank HongKong,69155,78548,-9393
2014-08-01,Bank of America,CitiBank HongKong,68152,77834,-9682
2014-09-01,Bank of America,CitiBank HongKong,69752,78619,-8867
2014-10-01,Bank of America,CitiBank HongKong,63621,74895,-11274
2014-11-01,Bank of America,CitiBank HongKong,62523,77249,-14726
2014-12-01,Bank of America,CitiBank HongKong,66238,74947,-8709
2015-01-01,Bank of America,CitiBank HongKong,74594,64738,9856
2015-02-01,Bank of America,CitiBank HongKong,73934,69878,4056
2015-03-01,Bank of America,CitiBank HongKong,71498,68269,3229
2015-04-01,Bank of America,CitiBank HongKong,73563,64739,8824
2015-05-01,Bank of America,CitiBank HongKong,75485,61774,13711
2015-06-01,Bank of America,CitiBank HongKong,74834,68515,6319
2015-07-01,Bank of America,CitiBank HongKong,72256,69132,3124
2015-08-01,Bank of America,CitiBank HongKong,72439,68611,3828
2015-09-01,Bank of America,CitiBank HongKong,78296,69589,8707
2015-10-01,Bank of America,CitiBank HongKong,72538,68457,4081
2015-11-01,Bank of America,CitiBank HongKong,87621,61378,26243
2015-12-01,Bank of America,CitiBank HongKong,83978,64783,19195
2016-01-01,Bank of America,CitiBank HongKong,85856,62168,23688
2016-02-01,Bank of America,CitiBank HongKong,83489,62312,21177
2016-03-01,Bank of America,CitiBank HongKong,86351,66836,19515
2016-04-01,Bank of America,CitiBank HongKong,87557,63219,24338
2016-05-01,Bank of America,CitiBank HongKong,81528,65684,15844
2016-06-01,Bank of America,CitiBank HongKong,85852,62942,22910
2016-07-01,Bank of America,CitiBank HongKong,85785,66264,19521
2016-08-01,Bank of America,CitiBank HongKong,86624,65376,21248
2016-09-01,Bank of America,CitiBank HongKong,93537,59583,33954
2016-10-01,Bank of America,CitiBank HongKong,93337,54273,39064
2016-11-01,Bank of America,CitiBank HongKong,98244,54562,43682
2016-12-01,Bank of America,CitiBank HongKong,96799,58245,38554
2017-01-01,Bank of America,CitiBank HongKong,96731,53587,43144
2017-02-01,Bank of America,CitiBank HongKong,99989,55511,44478
2017-03-01,Bank of America,CitiBank HongKong,91376,52216,39160
2017-04-01,Bank of America,CitiBank HongKong,92637,54226,38411
2017-05-01,Bank of America,CitiBank HongKong,93586,52815,40771
2017-06-01,Bank of America,CitiBank HongKong,91854,58879,32975
2017-07-01,Bank of America,CitiBank HongKong,109976,51128,58848
2017-08-01,Bank of America,CitiBank HongKong,105193,56833,48360
2017-09-01,Bank of America,CitiBank HongKong,104553,59983,44570
2017-10-01,Bank of America,CitiBank HongKong,101413,57392,44021
2017-11-01,Bank of America,CitiBank HongKong,103388,54192,49196
2017-12-01,Bank of America,CitiBank HongKong,105535,51976,53559
2018-01-01,Bank of America,CitiBank HongKong,106139,53144,52995
2018-02-01,Bank of America,CitiBank HongKong,108772,53468,55304
2018-03-01,Bank of America,CitiBank HongKong,104924,59982,44942
2018-04-01,Bank of America,CitiBank HongKong,106243,56823,49420
2010-01-01,Barclays,CitiBank New York,13227,94964,-81737
2010-02-01,Barclays,CitiBank New York,14514,97178,-82664
2010-03-01,Barclays,CitiBank New York,16159,94585,-78426
2010-04-01,Barclays,CitiBank New York,19183,97488,-78305
2010-05-01,Barclays,CitiBank New York,11786,99633,-87847
2010-06-01,Barclays,CitiBank New York,19948,92593,-72645
2010-07-01,Barclays,CitiBank New York,18223,91793,-73570
2010-08-01,Barclays,CitiBank New York,19386,95844,-76458
2010-09-01,Barclays,CitiBank New York,14553,92813,-78260
2010-10-01,Barclays,CitiBank New York,17593,98718,-81125
2010-11-01,Barclays,CitiBank New York,28669,95515,-66846
2010-12-01,Barclays,CitiBank New York,24216,95298,-71082
2011-01-01,Barclays,CitiBank New York,29854,95329,-65475
2011-02-01,Barclays,CitiBank New York,28113,95513,-67400
2011-03-01,Barclays,CitiBank New York,25831,99166,-73335
2011-04-01,Barclays,CitiBank New York,24392,93199,-68807
2011-05-01,Barclays,CitiBank New York,23189,92986,-69797
2011-06-01,Barclays,CitiBank New York,21994,99424,-77430
2011-07-01,Barclays,CitiBank New York,23282,95948,-72666
2011-08-01,Barclays,CitiBank New York,21737,91792,-70055
2011-09-01,Barclays,CitiBank New York,34277,83728,-49451
2011-10-01,Barclays,CitiBank New York,36639,86159,-49520
2011-11-01,Barclays,CitiBank New York,36598,88222,-51624
2011-12-01,Barclays,CitiBank New York,33463,89342,-55879
2012-01-01,Barclays,CitiBank New York,36717,83421,-46704
2012-02-01,Barclays,CitiBank New York,34327,82675,-48348
2012-03-01,Barclays,CitiBank New York,36772,89573,-52801
2012-04-01,Barclays,CitiBank New York,36863,83852,-46989
2012-05-01,Barclays,CitiBank New York,38867,87159,-48292
2012-06-01,Barclays,CitiBank New York,36419,84561,-48142
2012-07-01,Barclays,CitiBank New York,48265,88633,-40368
2012-08-01,Barclays,CitiBank New York,44574,81253,-36679
2012-09-01,Barclays,CitiBank New York,43696,86148,-42452
2012-10-01,Barclays,CitiBank New York,42137,84227,-42090
2012-11-01,Barclays,CitiBank New York,48147,86539,-38392
2012-12-01,Barclays,CitiBank New York,47756,89243,-41487
2013-01-01,Barclays,CitiBank New York,46778,84417,-37639
2013-02-01,Barclays,CitiBank New York,44582,84584,-40002
2013-03-01,Barclays,CitiBank New York,41693,81229,-39536
2013-04-01,Barclays,CitiBank New York,45855,81548,-35693
2013-05-01,Barclays,CitiBank New York,52751,74566,-21815
2013-06-01,Barclays,CitiBank New York,55868,71417,-15549
2013-07-01,Barclays,CitiBank New York,51524,79897,-28373
2013-08-01,Barclays,CitiBank New York,58667,77916,-19249
2013-09-01,Barclays,CitiBank New York,59642,75488,-15846
2013-10-01,Barclays,CitiBank New York,52497,72993,-20496
2013-11-01,Barclays,CitiBank New York,52837,74643,-21806
2013-12-01,Barclays,CitiBank New York,57754,72372,-14618
2014-01-01,Barclays,CitiBank New York,55519,76869,-21350
2014-02-01,Barclays,CitiBank New York,57849,77171,-19322
2014-03-01,Barclays,CitiBank New York,64318,76341,-12023
2014-04-01,Barclays,CitiBank New York,69664,71917,-2253
2014-05-01,Barclays,CitiBank New York,67546,78271,-10725
2014-06-01,Barclays,CitiBank New York,64738,72943,-8205
2014-07-01,Barclays,CitiBank New York,63871,73994,-10123
2014-08-01,Barclays,CitiBank New York,66337,78852,-12515
2014-09-01,Barclays,CitiBank New York,66123,76725,-10602
2014-10-01,Barclays,CitiBank New York,68623,74592,-5969
2014-11-01,Barclays,CitiBank New York,68856,73968,-5112
2014-12-01,Barclays,CitiBank New York,61323,75183,-13860
2015-01-01,Barclays,CitiBank New York,71292,64244,7048
2015-02-01,Barclays,CitiBank New York,77949,62989,14960
2015-03-01,Barclays,CitiBank New York,75854,67663,8191
2015-04-01,Barclays,CitiBank New York,77278,65334,11944
2015-05-01,Barclays,CitiBank New York,71632,68397,3235
2015-06-01,Barclays,CitiBank New York,79494,62776,16718
2015-07-01,Barclays,CitiBank New York,78912,66619,12293
2015-08-01,Barclays,CitiBank New York,75119,64553,10566
2015-09-01,Barclays,CitiBank New York,76377,67589,8788
2015-10-01,Barclays,CitiBank New York,78674,68848,9826
2015-11-01,Barclays,CitiBank New York,85757,62386,23371
2015-12-01,Barclays,CitiBank New York,88639,65531,23108
2016-01-01,Barclays,CitiBank New York,88785,62435,26350
2016-02-01,Barclays,CitiBank New York,83265,69832,13433
2016-03-01,Barclays,CitiBank New York,83898,64572,19326
2016-04-01,Barclays,CitiBank New York,81321,68814,12507
2016-05-01,Barclays,CitiBank New York,89189,62381,26808
2016-06-01,Barclays,CitiBank New York,84844,62293,22551
2016-07-01,Barclays,CitiBank New York,82542,66699,15843
2016-08-01,Barclays,CitiBank New York,87183,66426,20757
2016-09-01,Barclays,CitiBank New York,94531,54477,40054
2016-10-01,Barclays,CitiBank New York,99449,55256,44193
2016-11-01,Barclays,CitiBank New York,96591,52758,43833
2016-12-01,Barclays,CitiBank New York,99958,57443,42515
2017-01-01,Barclays,CitiBank New York,97668,56346,41322
2017-02-01,Barclays,CitiBank New York,94511,53575,40936
2017-03-01,Barclays,CitiBank New York,97353,59694,37659
2017-04-01,Barclays,CitiBank New York,95792,55633,40159
2017-05-01,Barclays,CitiBank New York,97943,54542,43401
2017-06-01,Barclays,CitiBank New York,97436,58927,38509
2017-07-01,Barclays,CitiBank New York,106865,57242,49623
2017-08-01,Barclays,CitiBank New York,106963,56127,50836
2017-09-01,Barclays,CitiBank New York,106262,58833,47429
2017-10-01,Barclays,CitiBank New York,107891,54949,52942
2017-11-01,Barclays,CitiBank New York,105177,55875,49302
2017-12-01,Barclays,CitiBank New York,105493,51672,53821
2018-01-01,Barclays,CitiBank New York,107267,51772,55495
2018-02-01,Barclays,CitiBank New York,107523,59839,47684
2018-03-01,Barclays,CitiBank New York,101365,56844,44521
2018-04-01,Barclays,CitiBank New York,103529,53987,49542
2010-01-01,Barclays,CitiBank London,12222,95753,-83531
2010-02-01,Barclays,CitiBank London,13458,95138,-81680
2010-03-01,Barclays,CitiBank London,16984,97331,-80347
2010-04-01,Barclays,CitiBank London,15493,92139,-76646
2010-05-01,Barclays,CitiBank London,11519,92541,-81022
2010-06-01,Barclays,CitiBank London,19584,91358,-71774
2010-07-01,Barclays,CitiBank London,16665,95117,-78452
2010-08-01,Barclays,CitiBank London,16433,92998,-76565
2010-09-01,Barclays,CitiBank London,14497,98249,-83752
2010-10-01,Barclays,CitiBank London,19584,93622,-74038
2010-11-01,Barclays,CitiBank London,23946,91851,-67905
2010-12-01,Barclays,CitiBank London,24938,95884,-70946
2011-01-01,Barclays,CitiBank London,26761,91466,-64705
2011-02-01,Barclays,CitiBank London,28394,92546,-64152
2011-03-01,Barclays,CitiBank London,25948,95385,-69437
2011-04-01,Barclays,CitiBank London,26623,98545,-71922
2011-05-01,Barclays,CitiBank London,28122,92485,-64363
2011-06-01,Barclays,CitiBank London,21839,91919,-70080
2011-07-01,Barclays,CitiBank London,25169,92228,-67059
2011-08-01,Barclays,CitiBank London,21284,96761,-75477
2011-09-01,Barclays,CitiBank London,31844,88737,-56893
2011-10-01,Barclays,CitiBank London,32121,89646,-57525
2011-11-01,Barclays,CitiBank London,31978,84969,-52991
2011-12-01,Barclays,CitiBank London,35781,85914,-50133
2012-01-01,Barclays,CitiBank London,34444,88132,-53688
2012-02-01,Barclays,CitiBank London,38682,86291,-47609
2012-03-01,Barclays,CitiBank London,32135,88972,-56837
2012-04-01,Barclays,CitiBank London,38445,86587,-48142
2012-05-01,Barclays,CitiBank London,34129,83998,-49869
2012-06-01,Barclays,CitiBank London,31996,82883,-50887
2012-07-01,Barclays,CitiBank London,48287,87554,-39267
2012-08-01,Barclays,CitiBank London,43441,89793,-46352
2012-09-01,Barclays,CitiBank London,44423,82951,-38528
2012-10-01,Barclays,CitiBank London,42637,84455,-41818
2012-11-01,Barclays,CitiBank London,41192,85389,-44197
2012-12-01,Barclays,CitiBank London,44923,89475,-44552
2013-01-01,Barclays,CitiBank London,43877,86139,-42262
2013-02-01,Barclays,CitiBank London,42894,86871,-43977
2013-03-01,Barclays,CitiBank London,49743,89661,-39918
2013-04-01,Barclays,CitiBank London,45631,85827,-40196
2013-05-01,Barclays,CitiBank London,57697,75595,-17898
2013-06-01,Barclays,CitiBank London,57886,75278,-17392
2013-07-01,Barclays,CitiBank London,57321,77276,-19955
2013-08-01,Barclays,CitiBank London,55196,72197,-17001
2013-09-01,Barclays,CitiBank London,51456,75747,-24291
2013-10-01,Barclays,CitiBank London,59691,79336,-19645
2013-11-01,Barclays,CitiBank London,58967,75855,-16888
2013-12-01,Barclays,CitiBank London,55892,76365,-20473
2014-01-01,Barclays,CitiBank London,54133,71239,-17106
2014-02-01,Barclays,CitiBank London,56933,76387,-19454
2014-03-01,Barclays,CitiBank London,62967,72297,-9330
2014-04-01,Barclays,CitiBank London,62439,73421,-10982
2014-05-01,Barclays,CitiBank London,61255,71579,-10324
2014-06-01,Barclays,CitiBank London,62346,77189,-14843
2014-07-01,Barclays,CitiBank London,65781,75918,-10137
2014-08-01,Barclays,CitiBank London,63421,79545,-16124
2014-09-01,Barclays,CitiBank London,66963,73597,-6634
2014-10-01,Barclays,CitiBank London,65597,73329,-7732
2014-11-01,Barclays,CitiBank London,67894,71563,-3669
2014-12-01,Barclays,CitiBank London,65717,73821,-8104
2015-01-01,Barclays,CitiBank London,71616,61178,10438
2015-02-01,Barclays,CitiBank London,78525,67811,10714
2015-03-01,Barclays,CitiBank London,73311,66233,7078
2015-04-01,Barclays,CitiBank London,75736,68127,7609
2015-05-01,Barclays,CitiBank London,77817,63345,14472
2015-06-01,Barclays,CitiBank London,74693,69718,4975
2015-07-01,Barclays,CitiBank London,77479,63946,13533
2015-08-01,Barclays,CitiBank London,72136,66657,5479
2015-09-01,Barclays,CitiBank London,77885,66351,11534
2015-10-01,Barclays,CitiBank London,78813,66976,11837
2015-11-01,Barclays,CitiBank London,81234,67535,13699
2015-12-01,Barclays,CitiBank London,88957,65338,23619
2016-01-01,Barclays,CitiBank London,87737,64878,22859
2016-02-01,Barclays,CitiBank London,87964,61657,26307
2016-03-01,Barclays,CitiBank London,81213,63244,17969
2016-04-01,Barclays,CitiBank London,82268,63772,18496
2016-05-01,Barclays,CitiBank London,87917,68534,19383
2016-06-01,Barclays,CitiBank London,88399,66642,21757
2016-07-01,Barclays,CitiBank London,83156,69178,13978
2016-08-01,Barclays,CitiBank London,82129,66257,15872
2016-09-01,Barclays,CitiBank London,91735,59728,32007
2016-10-01,Barclays,CitiBank London,91625,52326,39299
2016-11-01,Barclays,CitiBank London,91442,56133,35309
2016-12-01,Barclays,CitiBank London,99157,57419,41738
2017-01-01,Barclays,CitiBank London,99791,57981,41810
2017-02-01,Barclays,CitiBank London,92281,54623,37658
2017-03-01,Barclays,CitiBank London,95569,52796,42773
2017-04-01,Barclays,CitiBank London,96468,56335,40133
2017-05-01,Barclays,CitiBank London,95486,56886,38600
2017-06-01,Barclays,CitiBank London,92681,54994,37687
2017-07-01,Barclays,CitiBank London,103556,53617,49939
2017-08-01,Barclays,CitiBank London,102884,53919,48965
2017-09-01,Barclays,CitiBank London,102597,59762,42835
2017-10-01,Barclays,CitiBank London,102627,59342,43285
2017-11-01,Barclays,CitiBank London,105511,59188,46323
2017-12-01,Barclays,CitiBank London,109782,55637,54145
2018-01-01,Barclays,CitiBank London,104554,58167,46387
2018-02-01,Barclays,CitiBank London,104332,52725,51607
2018-03-01,Barclays,CitiBank London,108475,59238,49237
2018-04-01,Barclays,CitiBank London,106916,51855,55061
2010-01-01,Barclays,CitiBank Pune,18489,93792,-75303
2010-02-01,Barclays,CitiBank Pune,12821,99874,-87053
2010-03-01,Barclays,CitiBank Pune,12679,91758,-79079
2010-04-01,Barclays,CitiBank Pune,15965,98544,-82579
2010-05-01,Barclays,CitiBank Pune,12847,93824,-80977
2010-06-01,Barclays,CitiBank Pune,11765,92569,-80804
2010-07-01,Barclays,CitiBank Pune,14395,91765,-77370
2010-08-01,Barclays,CitiBank Pune,14733,99384,-84651
2010-09-01,Barclays,CitiBank Pune,19616,91767,-72151
2010-10-01,Barclays,CitiBank Pune,16449,92445,-75996
2010-11-01,Barclays,CitiBank Pune,25651,92333,-66682
2010-12-01,Barclays,CitiBank Pune,29555,91734,-62179
2011-01-01,Barclays,CitiBank Pune,23613,96764,-73151
2011-02-01,Barclays,CitiBank Pune,25743,92576,-66833
2011-03-01,Barclays,CitiBank Pune,21668,97554,-75886
2011-04-01,Barclays,CitiBank Pune,26275,93757,-67482
2011-05-01,Barclays,CitiBank Pune,27491,96861,-69370
2011-06-01,Barclays,CitiBank Pune,29793,97574,-67781
2011-07-01,Barclays,CitiBank Pune,23371,93787,-70416
2011-08-01,Barclays,CitiBank Pune,22748,93515,-70767
2011-09-01,Barclays,CitiBank Pune,33287,83462,-50175
2011-10-01,Barclays,CitiBank Pune,35141,82721,-47580
2011-11-01,Barclays,CitiBank Pune,35159,87142,-51983
2011-12-01,Barclays,CitiBank Pune,39744,84465,-44721
2012-01-01,Barclays,CitiBank Pune,36847,81512,-44665
2012-02-01,Barclays,CitiBank Pune,35171,82289,-47118
2012-03-01,Barclays,CitiBank Pune,33488,87872,-54384
2012-04-01,Barclays,CitiBank Pune,39921,82583,-42662
2012-05-01,Barclays,CitiBank Pune,33897,88861,-54964
2012-06-01,Barclays,CitiBank Pune,38395,82636,-44241
2012-07-01,Barclays,CitiBank Pune,46683,82388,-35705
2012-08-01,Barclays,CitiBank Pune,46352,84123,-37771
2012-09-01,Barclays,CitiBank Pune,43344,88819,-45475
2012-10-01,Barclays,CitiBank Pune,42453,87998,-45545
2012-11-01,Barclays,CitiBank Pune,44253,87574,-43321
2012-12-01,Barclays,CitiBank Pune,49769,85672,-35903
2013-01-01,Barclays,CitiBank Pune,47682,83767,-36085
2013-02-01,Barclays,CitiBank Pune,48886,83693,-34807
2013-03-01,Barclays,CitiBank Pune,42981,88266,-45285
2013-04-01,Barclays,CitiBank Pune,49627,85618,-35991
2013-05-01,Barclays,CitiBank Pune,59232,75656,-16424
2013-06-01,Barclays,CitiBank Pune,56692,74493,-17801
2013-07-01,Barclays,CitiBank Pune,54364,75622,-21258
2013-08-01,Barclays,CitiBank Pune,54112,78214,-24102
2013-09-01,Barclays,CitiBank Pune,58735,74945,-16210
2013-10-01,Barclays,CitiBank Pune,57356,72857,-15501
2013-11-01,Barclays,CitiBank Pune,54116,75234,-21118
2013-12-01,Barclays,CitiBank Pune,58694,73822,-15128
2014-01-01,Barclays,CitiBank Pune,55574,74822,-19248
2014-02-01,Barclays,CitiBank Pune,57434,77123,-19689
2014-03-01,Barclays,CitiBank Pune,67599,73762,-6163
2014-04-01,Barclays,CitiBank Pune,64825,78212,-13387
2014-05-01,Barclays,CitiBank Pune,67195,77647,-10452
2014-06-01,Barclays,CitiBank Pune,63777,75728,-11951
2014-07-01,Barclays,CitiBank Pune,66763,77233,-10470
2014-08-01,Barclays,CitiBank Pune,63522,74519,-10997
2014-09-01,Barclays,CitiBank Pune,61512,75342,-13830
2014-10-01,Barclays,CitiBank Pune,64644,76336,-11692
2014-11-01,Barclays,CitiBank Pune,66289,73411,-7122
2014-12-01,Barclays,CitiBank Pune,63772,73981,-10209
2015-01-01,Barclays,CitiBank Pune,79573,64931,14642
2015-02-01,Barclays,CitiBank Pune,78394,67241,11153
2015-03-01,Barclays,CitiBank Pune,74546,64861,9685
2015-04-01,Barclays,CitiBank Pune,78898,65125,13773
2015-05-01,Barclays,CitiBank Pune,79773,68182,11591
2015-06-01,Barclays,CitiBank Pune,79424,66672,12752
2015-07-01,Barclays,CitiBank Pune,72311,62962,9349
2015-08-01,Barclays,CitiBank Pune,75488,67567,7921
2015-09-01,Barclays,CitiBank Pune,74177,61942,12235
2015-10-01,Barclays,CitiBank Pune,78971,64376,14595
2015-11-01,Barclays,CitiBank Pune,85321,67832,17489
2015-12-01,Barclays,CitiBank Pune,83651,62963,20688
2016-01-01,Barclays,CitiBank Pune,81547,67253,14294
2016-02-01,Barclays,CitiBank Pune,84499,65334,19165
2016-03-01,Barclays,CitiBank Pune,89758,68363,21395
2016-04-01,Barclays,CitiBank Pune,87774,64666,23108
2016-05-01,Barclays,CitiBank Pune,84414,61671,22743
2016-06-01,Barclays,CitiBank Pune,87749,66553,21196
2016-07-01,Barclays,CitiBank Pune,88457,69484,18973
2016-08-01,Barclays,CitiBank Pune,82222,61649,20573
2016-09-01,Barclays,CitiBank Pune,93399,52431,40968
2016-10-01,Barclays,CitiBank Pune,98338,53551,44787
2016-11-01,Barclays,CitiBank Pune,93246,59136,34110
2016-12-01,Barclays,CitiBank Pune,92332,59366,32966
2017-01-01,Barclays,CitiBank Pune,99192,57265,41927
2017-02-01,Barclays,CitiBank Pune,92848,55397,37451
2017-03-01,Barclays,CitiBank Pune,94224,55431,38793
2017-04-01,Barclays,CitiBank Pune,96776,58121,38655
2017-05-01,Barclays,CitiBank Pune,97766,59315,38451
2017-06-01,Barclays,CitiBank Pune,93825,54168,39657
2017-07-01,Barclays,CitiBank Pune,103275,56829,46446
2017-08-01,Barclays,CitiBank Pune,109819,53874,55945
2017-09-01,Barclays,CitiBank Pune,103589,57348,46241
2017-10-01,Barclays,CitiBank Pune,109452,51788,57664
2017-11-01,Barclays,CitiBank Pune,103682,51113,52569
2017-12-01,Barclays,CitiBank Pune,107133,51967,55166
2018-01-01,Barclays,CitiBank Pune,102351,59777,42574
2018-02-01,Barclays,CitiBank Pune,109358,59289,50069
2018-03-01,Barclays,CitiBank Pune,104912,54678,50234
2018-04-01,Barclays,CitiBank Pune,107962,53428,54534
2010-01-01,Barclays,CitiBank Singapore,16451,95181,-78730
2010-02-01,Barclays,CitiBank Singapore,19728,91138,-71410
2010-03-01,Barclays,CitiBank Singapore,18292,94152,-75860
2010-04-01,Barclays,CitiBank Singapore,11458,99873,-88415
2010-05-01,Barclays,CitiBank Singapore,15762,99242,-83480
2010-06-01,Barclays,CitiBank Singapore,11846,91684,-79838
2010-07-01,Barclays,CitiBank Singapore,16288,96272,-79984
2010-08-01,Barclays,CitiBank Singapore,14756,97953,-83197
2010-09-01,Barclays,CitiBank Singapore,14345,94856,-80511
2010-10-01,Barclays,CitiBank Singapore,19583,92936,-73353
2010-11-01,Barclays,CitiBank Singapore,25563,91494,-65931
2010-12-01,Barclays,CitiBank Singapore,23434,99443,-76009
2011-01-01,Barclays,CitiBank Singapore,21293,97885,-76592
2011-02-01,Barclays,CitiBank Singapore,28435,91325,-62890
2011-03-01,Barclays,CitiBank Singapore,27873,97225,-69352
2011-04-01,Barclays,CitiBank Singapore,29511,95872,-66361
2011-05-01,Barclays,CitiBank Singapore,22763,91861,-69098
2011-06-01,Barclays,CitiBank Singapore,25262,97292,-72030
2011-07-01,Barclays,CitiBank Singapore,25744,96664,-70920
2011-08-01,Barclays,CitiBank Singapore,27897,99861,-71964
2011-09-01,Barclays,CitiBank Singapore,32638,85511,-52873
2011-10-01,Barclays,CitiBank Singapore,36162,83472,-47310
2011-11-01,Barclays,CitiBank Singapore,32275,85611,-53336
2011-12-01,Barclays,CitiBank Singapore,33716,83441,-49725
2012-01-01,Barclays,CitiBank Singapore,39876,88254,-48378
2012-02-01,Barclays,CitiBank Singapore,39988,86892,-46904
2012-03-01,Barclays,CitiBank Singapore,39961,89115,-49154
2012-04-01,Barclays,CitiBank Singapore,38598,89245,-50647
2012-05-01,Barclays,CitiBank Singapore,32824,82756,-49932
2012-06-01,Barclays,CitiBank Singapore,36499,81997,-45498
2012-07-01,Barclays,CitiBank Singapore,46387,82367,-35980
2012-08-01,Barclays,CitiBank Singapore,47268,84781,-37513
2012-09-01,Barclays,CitiBank Singapore,42876,89376,-46500
2012-10-01,Barclays,CitiBank Singapore,44824,88149,-43325
2012-11-01,Barclays,CitiBank Singapore,43622,85515,-41893
2012-12-01,Barclays,CitiBank Singapore,49748,89816,-40068
2013-01-01,Barclays,CitiBank Singapore,43528,85619,-42091
2013-02-01,Barclays,CitiBank Singapore,44616,85446,-40830
2013-03-01,Barclays,CitiBank Singapore,46376,87559,-41183
2013-04-01,Barclays,CitiBank Singapore,44828,85696,-40868
2013-05-01,Barclays,CitiBank Singapore,56437,79256,-22819
2013-06-01,Barclays,CitiBank Singapore,58857,75653,-16796
2013-07-01,Barclays,CitiBank Singapore,59929,74656,-14727
2013-08-01,Barclays,CitiBank Singapore,59996,72855,-12859
2013-09-01,Barclays,CitiBank Singapore,51763,76651,-24888
2013-10-01,Barclays,CitiBank Singapore,57868,72673,-14805
2013-11-01,Barclays,CitiBank Singapore,55525,75966,-20441
2013-12-01,Barclays,CitiBank Singapore,58434,72939,-14505
2014-01-01,Barclays,CitiBank Singapore,56891,77728,-20837
2014-02-01,Barclays,CitiBank Singapore,56638,72887,-16249
2014-03-01,Barclays,CitiBank Singapore,66168,73533,-7365
2014-04-01,Barclays,CitiBank Singapore,61854,71525,-9671
2014-05-01,Barclays,CitiBank Singapore,66152,77836,-11684
2014-06-01,Barclays,CitiBank Singapore,65276,75949,-10673
2014-07-01,Barclays,CitiBank Singapore,65324,74311,-8987
2014-08-01,Barclays,CitiBank Singapore,66344,77364,-11020
2014-09-01,Barclays,CitiBank Singapore,66215,73878,-7663
2014-10-01,Barclays,CitiBank Singapore,63378,77271,-13893
2014-11-01,Barclays,CitiBank Singapore,67164,79893,-12729
2014-12-01,Barclays,CitiBank Singapore,67952,75586,-7634
2015-01-01,Barclays,CitiBank Singapore,74772,67766,7006
2015-02-01,Barclays,CitiBank Singapore,71491,63162,8329
2015-03-01,Barclays,CitiBank Singapore,77168,67187,9981
2015-04-01,Barclays,CitiBank Singapore,71163,62468,8695
2015-05-01,Barclays,CitiBank Singapore,76953,63748,13205
2015-06-01,Barclays,CitiBank Singapore,73118,69989,3129
2015-07-01,Barclays,CitiBank Singapore,73357,61886,11471
2015-08-01,Barclays,CitiBank Singapore,73349,66524,6825
2015-09-01,Barclays,CitiBank Singapore,71153,62153,9000
2015-10-01,Barclays,CitiBank Singapore,74637,61525,13112
2015-11-01,Barclays,CitiBank Singapore,83118,62591,20527
2015-12-01,Barclays,CitiBank Singapore,85471,67536,17935
2016-01-01,Barclays,CitiBank Singapore,83193,67435,15758
2016-02-01,Barclays,CitiBank Singapore,82794,66164,16630
2016-03-01,Barclays,CitiBank Singapore,87974,67428,20546
2016-04-01,Barclays,CitiBank Singapore,88513,67583,20930
2016-05-01,Barclays,CitiBank Singapore,81617,69359,12258
2016-06-01,Barclays,CitiBank Singapore,83576,66979,16597
2016-07-01,Barclays,CitiBank Singapore,85872,68348,17524
2016-08-01,Barclays,CitiBank Singapore,88281,62686,25595
2016-09-01,Barclays,CitiBank Singapore,92517,51923,40594
2016-10-01,Barclays,CitiBank Singapore,96329,52466,43863
2016-11-01,Barclays,CitiBank Singapore,98736,55378,43358
2016-12-01,Barclays,CitiBank Singapore,95935,53578,42357
2017-01-01,Barclays,CitiBank Singapore,94299,53311,40988
2017-02-01,Barclays,CitiBank Singapore,95546,52737,42809
2017-03-01,Barclays,CitiBank Singapore,91582,57851,33731
2017-04-01,Barclays,CitiBank Singapore,97519,52638,44881
2017-05-01,Barclays,CitiBank Singapore,99655,58415,41240
2017-06-01,Barclays,CitiBank Singapore,96152,52115,44037
2017-07-01,Barclays,CitiBank Singapore,106779,56875,49904
2017-08-01,Barclays,CitiBank Singapore,105371,52915,52456
2017-09-01,Barclays,CitiBank Singapore,107356,53249,54107
2017-10-01,Barclays,CitiBank Singapore,105564,58892,46672
2017-11-01,Barclays,CitiBank Singapore,103571,59325,44246
2017-12-01,Barclays,CitiBank Singapore,108954,59573,49381
2018-01-01,Barclays,CitiBank Singapore,107818,54416,53402
2018-02-01,Barclays,CitiBank Singapore,109481,53428,56053
2018-03-01,Barclays,CitiBank Singapore,107863,53613,54250
2018-04-01,Barclays,CitiBank Singapore,109242,57667,51575
2010-01-01,Barclays,CitiBank HongKong,16875,96282,-79407
2010-02-01,Barclays,CitiBank HongKong,18929,94578,-75649
2010-03-01,Barclays,CitiBank HongKong,11973,97843,-85870
2010-04-01,Barclays,CitiBank HongKong,17764,99782,-82018
2010-05-01,Barclays,CitiBank HongKong,16921,95294,-78373
2010-06-01,Barclays,CitiBank HongKong,17884,97361,-79477
2010-07-01,Barclays,CitiBank HongKong,18151,91137,-72986
2010-08-01,Barclays,CitiBank HongKong,11285,97741,-86456
2010-09-01,Barclays,CitiBank HongKong,13561,95386,-81825
2010-10-01,Barclays,CitiBank HongKong,17511,94494,-76983
2010-11-01,Barclays,CitiBank HongKong,25375,99411,-74036
2010-12-01,Barclays,CitiBank HongKong,23893,99998,-76105
2011-01-01,Barclays,CitiBank HongKong,21945,96246,-74301
2011-02-01,Barclays,CitiBank HongKong,21534,99167,-77633
2011-03-01,Barclays,CitiBank HongKong,29124,98692,-69568
2011-04-01,Barclays,CitiBank HongKong,23713,97179,-73466
2011-05-01,Barclays,CitiBank HongKong,29618,93964,-64346
2011-06-01,Barclays,CitiBank HongKong,21526,97692,-76166
2011-07-01,Barclays,CitiBank HongKong,21294,94656,-73362
2011-08-01,Barclays,CitiBank HongKong,27431,92637,-65206
2011-09-01,Barclays,CitiBank HongKong,36926,86889,-49963
2011-10-01,Barclays,CitiBank HongKong,35428,88367,-52939
2011-11-01,Barclays,CitiBank HongKong,33371,88345,-54974
2011-12-01,Barclays,CitiBank HongKong,35233,82154,-46921
2012-01-01,Barclays,CitiBank HongKong,38251,81455,-43204
2012-02-01,Barclays,CitiBank HongKong,37385,88156,-50771
2012-03-01,Barclays,CitiBank HongKong,39353,85348,-45995
2012-04-01,Barclays,CitiBank HongKong,35598,81264,-45666
2012-05-01,Barclays,CitiBank HongKong,36362,81352,-44990
2012-06-01,Barclays,CitiBank HongKong,31162,86918,-55756
2012-07-01,Barclays,CitiBank HongKong,47168,85145,-37977
2012-08-01,Barclays,CitiBank HongKong,47185,88878,-41693
2012-09-01,Barclays,CitiBank HongKong,49382,87984,-38602
2012-10-01,Barclays,CitiBank HongKong,42797,87287,-44490
2012-11-01,Barclays,CitiBank HongKong,44287,86756,-42469
2012-12-01,Barclays,CitiBank HongKong,41513,88112,-46599
2013-01-01,Barclays,CitiBank HongKong,41547,81317,-39770
2013-02-01,Barclays,CitiBank HongKong,44186,83326,-39140
2013-03-01,Barclays,CitiBank HongKong,45338,88847,-43509
2013-04-01,Barclays,CitiBank HongKong,45583,82562,-36979
2013-05-01,Barclays,CitiBank HongKong,57219,72287,-15068
2013-06-01,Barclays,CitiBank HongKong,59994,72961,-12967
2013-07-01,Barclays,CitiBank HongKong,57829,71237,-13408
2013-08-01,Barclays,CitiBank HongKong,54264,76959,-22695
2013-09-01,Barclays,CitiBank HongKong,53319,73132,-19813
2013-10-01,Barclays,CitiBank HongKong,57259,72595,-15336
2013-11-01,Barclays,CitiBank HongKong,55661,72543,-16882
2013-12-01,Barclays,CitiBank HongKong,57942,77497,-19555
2014-01-01,Barclays,CitiBank HongKong,58982,77527,-18545
2014-02-01,Barclays,CitiBank HongKong,55112,74974,-19862
2014-03-01,Barclays,CitiBank HongKong,65287,78342,-13055
2014-04-01,Barclays,CitiBank HongKong,62559,77828,-15269
2014-05-01,Barclays,CitiBank HongKong,65274,76623,-11349
2014-06-01,Barclays,CitiBank HongKong,64741,78277,-13536
2014-07-01,Barclays,CitiBank HongKong,63351,72588,-9237
2014-08-01,Barclays,CitiBank HongKong,63125,79657,-16532
2014-09-01,Barclays,CitiBank HongKong,63311,76775,-13464
2014-10-01,Barclays,CitiBank HongKong,62513,71758,-9245
2014-11-01,Barclays,CitiBank HongKong,68379,78798,-10419
2014-12-01,Barclays,CitiBank HongKong,61631,76152,-14521
2015-01-01,Barclays,CitiBank HongKong,75147,65342,9805
2015-02-01,Barclays,CitiBank HongKong,71648,62422,9226
2015-03-01,Barclays,CitiBank HongKong,77782,67122,10660
2015-04-01,Barclays,CitiBank HongKong,71872,63651,8221
2015-05-01,Barclays,CitiBank HongKong,73513,64285,9228
2015-06-01,Barclays,CitiBank HongKong,73219,66632,6587
2015-07-01,Barclays,CitiBank HongKong,75342,68515,6827
2015-08-01,Barclays,CitiBank HongKong,72177,65822,6355
2015-09-01,Barclays,CitiBank HongKong,75845,64795,11050
2015-10-01,Barclays,CitiBank HongKong,79237,68867,10370
2015-11-01,Barclays,CitiBank HongKong,86441,69782,16659
2015-12-01,Barclays,CitiBank HongKong,89149,63946,25203
2016-01-01,Barclays,CitiBank HongKong,81896,65417,16479
2016-02-01,Barclays,CitiBank HongKong,85139,62777,22362
2016-03-01,Barclays,CitiBank HongKong,83473,68535,14938
2016-04-01,Barclays,CitiBank HongKong,88566,67226,21340
2016-05-01,Barclays,CitiBank HongKong,81941,61571,20370
2016-06-01,Barclays,CitiBank HongKong,84564,63147,21417
2016-07-01,Barclays,CitiBank HongKong,85867,63483,22384
2016-08-01,Barclays,CitiBank HongKong,86381,63394,22987
2016-09-01,Barclays,CitiBank HongKong,96531,59322,37209
2016-10-01,Barclays,CitiBank HongKong,93468,53613,39855
2016-11-01,Barclays,CitiBank HongKong,95351,59852,35499
2016-12-01,Barclays,CitiBank HongKong,94141,52951,41190
2017-01-01,Barclays,CitiBank HongKong,96455,52835,43620
2017-02-01,Barclays,CitiBank HongKong,95999,59935,36064
2017-03-01,Barclays,CitiBank HongKong,97115,52167,44948
2017-04-01,Barclays,CitiBank HongKong,98917,52712,46205
2017-05-01,Barclays,CitiBank HongKong,92924,52187,40737
2017-06-01,Barclays,CitiBank HongKong,93196,58357,34839
2017-07-01,Barclays,CitiBank HongKong,103131,54254,48877
2017-08-01,Barclays,CitiBank HongKong,106855,55311,51544
2017-09-01,Barclays,CitiBank HongKong,104533,57865,46668
2017-10-01,Barclays,CitiBank HongKong,108336,52487,55849
2017-11-01,Barclays,CitiBank HongKong,108181,55957,52224
2017-12-01,Barclays,CitiBank HongKong,107535,54228,53307
2018-01-01,Barclays,CitiBank HongKong,102282,54398,47884
2018-02-01,Barclays,CitiBank HongKong,108246,52662,55584
2018-03-01,Barclays,CitiBank HongKong,102517,57174,45343
2018-04-01,Barclays,CitiBank HongKong,101977,55991,45986
