Date,Client Name,Legal Entity,Received Amount,Delivered Amount,Net Amount
2010-01-01,HSBC,CitiBank New York,19788,99853,-80065
2010-02-01,HSBC,CitiBank New York,15675,93961,-78286
2010-03-01,HSBC,CitiBank New York,13937,95121,-81184
2010-04-01,HSBC,CitiBank New York,13357,93498,-80141
2010-05-01,HSBC,CitiBank New York,17859,96935,-79076
2010-06-01,HSBC,CitiBank New York,15936,96415,-80479
2010-07-01,HSBC,CitiBank New York,15714,94826,-79112
2010-08-01,HSBC,CitiBank New York,19771,92464,-72693
2010-09-01,HSBC,CitiBank New York,15568,91212,-75644
2010-10-01,HSBC,CitiBank New York,15496,99883,-84387
2010-11-01,HSBC,CitiBank New York,21498,92462,-70964
2010-12-01,HSBC,CitiBank New York,24289,99941,-75652
2011-01-01,HSBC,CitiBank New York,21224,92899,-71675
2011-02-01,HSBC,CitiBank New York,28689,97531,-68842
2011-03-01,HSBC,CitiBank New York,25151,93681,-68530
2011-04-01,HSBC,CitiBank New York,22711,99641,-76930
2011-05-01,HSBC,CitiBank New York,23153,96283,-73130
2011-06-01,HSBC,CitiBank New York,28679,97778,-69099
2011-07-01,HSBC,CitiBank New York,28212,94243,-66031
2011-08-01,HSBC,CitiBank New York,24215,99671,-75456
2011-09-01,HSBC,CitiBank New York,34382,89147,-54765
2011-10-01,HSBC,CitiBank New York,31665,82498,-50833
2011-11-01,HSBC,CitiBank New York,31557,83563,-52006
2011-12-01,HSBC,CitiBank New York,35971,88978,-53007
2012-01-01,HSBC,CitiBank New York,34662,83573,-48911
2012-02-01,HSBC,CitiBank New York,34162,85343,-51181
2012-03-01,HSBC,CitiBank New York,38757,84681,-45924
2012-04-01,HSBC,CitiBank New York,36442,85454,-49012
2012-05-01,HSBC,CitiBank New York,32144,85585,-53441
2012-06-01,HSBC,CitiBank New York,34118,89852,-55734
2012-07-01,HSBC,CitiBank New York,44399,89741,-45342
2012-08-01,HSBC,CitiBank New York,45778,84279,-38501
2012-09-01,HSBC,CitiBank New York,48696,81273,-32577
2012-10-01,HSBC,CitiBank New York,43331,87422,-44091
2012-11-01,HSBC,CitiBank New York,46776,84258,-37482
2012-12-01,HSBC,CitiBank New York,41885,87919,-46034
2013-01-01,HSBC,CitiBank New York,47132,82323,-35191
2013-02-01,HSBC,CitiBank New York,47176,82857,-35681
2013-03-01,HSBC,CitiBank New York,45646,81485,-35839
2013-04-01,HSBC,CitiBank New York,47819,86666,-38847
2013-05-01,HSBC,CitiBank New York,57732,74327,-16595
2013-06-01,HSBC,CitiBank New York,52488,77596,-25108
2013-07-01,HSBC,CitiBank New York,58792,79376,-20584
2013-08-01,HSBC,CitiBank New York,55542,71946,-16404
2013-09-01,HSBC,CitiBank New York,51551,79953,-28402
2013-10-01,HSBC,CitiBank New York,51161,77968,-26807
2013-11-01,HSBC,CitiBank New York,57492,78878,-21386
2013-12-01,HSBC,CitiBank New York,57278,77992,-20714
2014-01-01,HSBC,CitiBank New York,59213,74884,-15671
2014-02-01,HSBC,CitiBank New York,53524,78541,-25017
2014-03-01,HSBC,CitiBank New York,62155,74459,-12304
2014-04-01,HSBC,CitiBank New York,64623,75293,-10670
2014-05-01,HSBC,CitiBank New York,64799,78469,-13670
2014-06-01,HSBC,CitiBank New York,62159,79945,-17786
2014-07-01,HSBC,CitiBank New York,65474,73561,-8087
2014-08-01,HSBC,CitiBank New York,62665,74376,-11711
2014-09-01,HSBC,CitiBank New York,65296,79383,-14087
2014-10-01,HSBC,CitiBank New York,64166,74847,-10681
2014-11-01,HSBC,CitiBank New York,62363,74474,-12111
2014-12-01,HSBC,CitiBank New York,62523,79597,-17074
2015-01-01,HSBC,CitiBank New York,73866,62522,11344
2015-02-01,HSBC,CitiBank New York,79617,62111,17506
2015-03-01,HSBC,CitiBank New York,78383,65831,12552
2015-04-01,HSBC,CitiBank New York,78824,61382,17442
2015-05-01,HSBC,CitiBank New York,78387,64862,13525
2015-06-01,HSBC,CitiBank New York,75451,69752,5699
2015-07-01,HSBC,CitiBank New York,71271,62722,8549
2015-08-01,HSBC,CitiBank New York,79999,67355,12644
2015-09-01,HSBC,CitiBank New York,77337,66497,10840
2015-10-01,HSBC,CitiBank New York,79622,67727,11895
2015-11-01,HSBC,CitiBank New York,88756,64878,23878
2015-12-01,HSBC,CitiBank New York,86336,65663,20673
2016-01-01,HSBC,CitiBank New York,81268,64966,16302
2016-02-01,HSBC,CitiBank New York,85538,67283,18255
2016-03-01,HSBC,CitiBank New York,85838,63696,22142
2016-04-01,HSBC,CitiBank New York,89834,64141,25693
2016-05-01,HSBC,CitiBank New York,82691,66696,15995
2016-06-01,HSBC,CitiBank New York,86654,68757,17897
2016-07-01,HSBC,CitiBank New York,85537,61376,24161
2016-08-01,HSBC,CitiBank New York,82161,66968,15193
2016-09-01,HSBC,CitiBank New York,94973,58727,36246
2016-10-01,HSBC,CitiBank New York,92233,58815,33418
2016-11-01,HSBC,CitiBank New York,94492,52172,42320
2016-12-01,HSBC,CitiBank New York,93291,56164,37127
2017-01-01,HSBC,CitiBank New York,94439,58786,35653
2017-02-01,HSBC,CitiBank New York,92846,52355,40491
2017-03-01,HSBC,CitiBank New York,96555,52674,43881
2017-04-01,HSBC,CitiBank New York,91563,52515,39048
2017-05-01,HSBC,CitiBank New York,91763,54283,37480
2017-06-01,HSBC,CitiBank New York,98171,56531,41640
2017-07-01,HSBC,CitiBank New York,105187,56345,48842
2017-08-01,HSBC,CitiBank New York,109917,58196,51721
2017-09-01,HSBC,CitiBank New York,107455,56456,50999
2017-10-01,HSBC,CitiBank New York,104985,56816,48169
2017-11-01,HSBC,CitiBank New York,104712,55475,49237
2017-12-01,HSBC,CitiBank New York,107437,52276,55161
2018-01-01,HSBC,CitiBank New York,108891,51934,56957
2018-02-01,HSBC,CitiBank New York,109895,56225,53670
2018-03-01,HSBC,CitiBank New York,103253,53451,49802
2018-04-01,HSBC,CitiBank New York,101454,56656,44798
2010-01-01,HSBC,CitiBank London,18784,92226,-73442
2010-02-01,HSBC,CitiBank London,12757,97352,-84595
2010-03-01,HSBC,CitiBank London,17324,95464,-78140
2010-04-01,HSBC,CitiBank London,14343,92828,-78485
2010-05-01,HSBC,CitiBank London,13794,96913,-83119
2010-06-01,HSBC,CitiBank London,19247,97353,-78106
2010-07-01,HSBC,CitiBank London,12696,95224,-82528
2010-08-01,HSBC,CitiBank London,15644,94625,-78981
2010-09-01,HSBC,CitiBank London,12326,98254,-85928
2010-10-01,HSBC,CitiBank London,15577,94915,-79338
2010-11-01,HSBC,CitiBank London,29215,95199,-65984
2010-12-01,HSBC,CitiBank London,28495,98192,-69697
2011-01-01,HSBC,CitiBank London,24752,99136,-74384
2011-02-01,HSBC,CitiBank London,23481,95326,-71845
2011-03-01,HSBC,CitiBank London,28111,99243,-71132
2011-04-01,HSBC,CitiBank London,21525,91426,-69901
2011-05-01,HSBC,CitiBank London,21667,99359,-77692
2011-06-01,HSBC,CitiBank London,28936,92377,-63441
2011-07-01,HSBC,CitiBank London,27397,93222,-65825
2011-08-01,HSBC,CitiBank London,27677,91488,-63811
2011-09-01,HSBC,CitiBank London,38443,86233,-47790
2011-10-01,HSBC,CitiBank London,34885,84964,-50079
2011-11-01,HSBC,CitiBank London,31428,83291,-51863
2011-12-01,HSBC,CitiBank London,35994,82784,-46790
2012-01-01,HSBC,CitiBank London,39274,81563,-42289
2012-02-01,HSBC,CitiBank London,36268,87853,-51585
2012-03-01,HSBC,CitiBank London,39569,86358,-46789
2012-04-01,HSBC,CitiBank London,35981,84845,-48864
2012-05-01,HSBC,CitiBank London,38311,83556,-45245
2012-06-01,HSBC,CitiBank London,35441,82252,-46811
2012-07-01,HSBC,CitiBank London,41999,83341,-41342
2012-08-01,HSBC,CitiBank London,47459,88313,-40854
2012-09-01,HSBC,CitiBank London,49656,82628,-32972
2012-10-01,HSBC,CitiBank London,45921,89178,-43257
2012-11-01,HSBC,CitiBank London,48543,84857,-36314
2012-12-01,HSBC,CitiBank London,46234,84198,-37964
2013-01-01,HSBC,CitiBank London,48163,83277,-35114
2013-02-01,HSBC,CitiBank London,42491,81466,-38975
2013-03-01,HSBC,CitiBank London,47438,81262,-33824
2013-04-01,HSBC,CitiBank London,43838,85116,-41278
2013-05-01,HSBC,CitiBank London,57437,79742,-22305
2013-06-01,HSBC,CitiBank London,58349,71171,-12822
2013-07-01,HSBC,CitiBank London,56286,71784,-15498
2013-08-01,HSBC,CitiBank London,53785,74731,-20946
2013-09-01,HSBC,CitiBank London,55786,73686,-17900
2013-10-01,HSBC,CitiBank London,51851,74212,-22361
2013-11-01,HSBC,CitiBank London,52653,79433,-26780
2013-12-01,HSBC,CitiBank London,58959,75819,-16860
2014-01-01,HSBC,CitiBank London,58525,77666,-19141
2014-02-01,HSBC,CitiBank London,57281,73127,-15846
2014-03-01,HSBC,CitiBank London,64798,72753,-7955
2014-04-01,HSBC,CitiBank London,67672,72323,-4651
2014-05-01,HSBC,CitiBank London,69537,76473,-6936
2014-06-01,HSBC,CitiBank London,64443,71742,-7299
2014-07-01,HSBC,CitiBank London,63212,72689,-9477
2014-08-01,HSBC,CitiBank London,62819,75441,-12622
2014-09-01,HSBC,CitiBank London,63735,74113,-10378
2014-10-01,HSBC,CitiBank London,63828,79716,-15888
2014-11-01,HSBC,CitiBank London,69735,72862,-3127
2014-12-01,HSBC,CitiBank London,61924,73197,-11273
2015-01-01,HSBC,CitiBank London,73536,67992,5544
2015-02-01,HSBC,CitiBank London,78772,67785,10987
2015-03-01,HSBC,CitiBank London,74142,68964,5178
2015-04-01,HSBC,CitiBank London,79391,68189,11202
2015-05-01,HSBC,CitiBank London,72216,61367,10849
2015-06-01,HSBC,CitiBank London,79167,63874,15293
2015-07-01,HSBC,CitiBank London,75589,67771,7818
2015-08-01,HSBC,CitiBank London,74968,68792,6176
2015-09-01,HSBC,CitiBank London,79233,61383,17850
2015-10-01,HSBC,CitiBank London,75575,66735,8840
2015-11-01,HSBC,CitiBank London,86476,68753,17723
2015-12-01,HSBC,CitiBank London,81824,62839,18985
2016-01-01,HSBC,CitiBank London,87124,63682,23442
2016-02-01,HSBC,CitiBank London,89715,68694,21021
2016-03-01,HSBC,CitiBank London,85817,62687,23130
2016-04-01,HSBC,CitiBank London,89442,61155,28287
2016-05-01,HSBC,CitiBank London,87517,61221,26296
2016-06-01,HSBC,CitiBank London,85957,69558,16399
2016-07-01,HSBC,CitiBank London,85589,62397,23192
2016-08-01,HSBC,CitiBank London,81241,62625,18616
2016-09-01,HSBC,CitiBank London,98242,59617,38625
2016-10-01,HSBC,CitiBank London,93466,55218,38248
2016-11-01,HSBC,CitiBank London,98956,55546,43410
2016-12-01,HSBC,CitiBank London,95429,55436,39993
2017-01-01,HSBC,CitiBank London,97539,57451,40088
2017-02-01,HSBC,CitiBank London,95499,53691,41808
2017-03-01,HSBC,CitiBank London,91779,51517,40262
2017-04-01,HSBC,CitiBank London,97567,57359,40208
2017-05-01,HSBC,CitiBank London,96673,57997,38676
2017-06-01,HSBC,CitiBank London,92581,59473,33108
2017-07-01,HSBC,CitiBank London,106379,59418,46961
2017-08-01,HSBC,CitiBank London,109277,59765,49512
2017-09-01,HSBC,CitiBank London,107672,54667,53005
2017-10-01,HSBC,CitiBank London,102863,54511,48352
2017-11-01,HSBC,CitiBank London,109124,55411,53713
2017-12-01,HSBC,CitiBank London,109652,55774,53878
2018-01-01,HSBC,CitiBank London,103911,54571,49340
2018-02-01,HSBC,CitiBank London,106465,51223,55242
2018-03-01,HSBC,CitiBank London,102328,57753,44575
2018-04-01,HSBC,CitiBank London,107264,57586,49678
2010-01-01,HSBC,CitiBank Pune,11898,95971,-84073
2010-02-01,HSBC,CitiBank Pune,12534,91499,-78965
2010-03-01,HSBC,CitiBank Pune,16531,99895,-83364
2010-04-01,HSBC,CitiBank Pune,17517,98542,-81025
2010-05-01,HSBC,CitiBank Pune,11624,99976,-88352
2010-06-01,HSBC,CitiBank Pune,16915,98743,-81828
2010-07-01,HSBC,CitiBank Pune,14552,96372,-81820
2010-08-01,HSBC,CitiBank Pune,14698,97797,-83099
2010-09-01,HSBC,CitiBank Pune,16569,94197,-77628
2010-10-01,HSBC,CitiBank Pune,19849,92359,-72510
2010-11-01,HSBC,CitiBank Pune,22292,98849,-76557
2010-12-01,HSBC,CitiBank Pune,25388,91578,-66190
2011-01-01,HSBC,CitiBank Pune,28271,99994,-71723
2011-02-01,HSBC,CitiBank Pune,29876,91978,-62102
2011-03-01,HSBC,CitiBank Pune,28997,92285,-63288
2011-04-01,HSBC,CitiBank Pune,29839,92755,-62916
2011-05-01,HSBC,CitiBank Pune,28666,98924,-70258
2011-06-01,HSBC,CitiBank Pune,24374,99473,-75099
2011-07-01,HSBC,CitiBank Pune,23483,99757,-76274
2011-08-01,HSBC,CitiBank Pune,29521,91893,-62372
2011-09-01,HSBC,CitiBank Pune,36298,87934,-51636
2011-10-01,HSBC,CitiBank Pune,34775,89656,-54881
2011-11-01,HSBC,CitiBank Pune,37149,84282,-47133
2011-12-01,HSBC,CitiBank Pune,36835,84713,-47878
2012-01-01,HSBC,CitiBank Pune,35559,88231,-52672
2012-02-01,HSBC,CitiBank Pune,38499,89684,-51185
2012-03-01,HSBC,CitiBank Pune,38559,82792,-44233
2012-04-01,HSBC,CitiBank Pune,36732,87359,-50627
2012-05-01,HSBC,CitiBank Pune,34282,83258,-48976
2012-06-01,HSBC,CitiBank Pune,39543,87839,-48296
2012-07-01,HSBC,CitiBank Pune,46516,89294,-42778
2012-08-01,HSBC,CitiBank Pune,45582,84452,-38870
2012-09-01,HSBC,CitiBank Pune,44385,83827,-39442
2012-10-01,HSBC,CitiBank Pune,49534,81569,-32035
2012-11-01,HSBC,CitiBank Pune,48324,88679,-40355
2012-12-01,HSBC,CitiBank Pune,43279,86274,-42995
2013-01-01,HSBC,CitiBank Pune,49249,83416,-34167
2013-02-01,HSBC,CitiBank Pune,47967,84112,-36145
2013-03-01,HSBC,CitiBank Pune,41173,81391,-40218
2013-04-01,HSBC,CitiBank Pune,43821,87889,-44068
2013-05-01,HSBC,CitiBank Pune,54475,76328,-21853
2013-06-01,HSBC,CitiBank Pune,52613,76516,-23903
2013-07-01,HSBC,CitiBank Pune,55386,72149,-16763
2013-08-01,HSBC,CitiBank Pune,54838,74191,-19353
2013-09-01,HSBC,CitiBank Pune,56469,79839,-23370
2013-10-01,HSBC,CitiBank Pune,59583,73877,-14294
2013-11-01,HSBC,CitiBank Pune,54828,79293,-24465
2013-12-01,HSBC,CitiBank Pune,55984,74692,-18708
2014-01-01,HSBC,CitiBank Pune,59896,78642,-18746
2014-02-01,HSBC,CitiBank Pune,53896,78647,-24751
2014-03-01,HSBC,CitiBank Pune,66958,75995,-9037
2014-04-01,HSBC,CitiBank Pune,69668,74486,-4818
2014-05-01,HSBC,CitiBank Pune,69639,79536,-9897
2014-06-01,HSBC,CitiBank Pune,67287,76464,-9177
2014-07-01,HSBC,CitiBank Pune,67555,75258,-7703
2014-08-01,HSBC,CitiBank Pune,62963,79778,-16815
2014-09-01,HSBC,CitiBank Pune,68252,78656,-10404
2014-10-01,HSBC,CitiBank Pune,64986,71893,-6907
2014-11-01,HSBC,CitiBank Pune,68413,73113,-4700
2014-12-01,HSBC,CitiBank Pune,65862,71589,-5727
2015-01-01,HSBC,CitiBank Pune,78572,69652,8920
2015-02-01,HSBC,CitiBank Pune,75287,62545,12742
2015-03-01,HSBC,CitiBank Pune,74986,68127,6859
2015-04-01,HSBC,CitiBank Pune,75944,61489,14455
2015-05-01,HSBC,CitiBank Pune,76789,66211,10578
2015-06-01,HSBC,CitiBank Pune,72194,67232,4962
2015-07-01,HSBC,CitiBank Pune,75498,65926,9572
2015-08-01,HSBC,CitiBank Pune,73529,63644,9885
2015-09-01,HSBC,CitiBank Pune,76484,69939,6545
2015-10-01,HSBC,CitiBank Pune,76857,68667,8190
2015-11-01,HSBC,CitiBank Pune,86553,63688,22865
2015-12-01,HSBC,CitiBank Pune,87679,66237,21442
2016-01-01,HSBC,CitiBank Pune,86475,61288,25187
2016-02-01,HSBC,CitiBank Pune,84769,65767,19002
2016-03-01,HSBC,CitiBank Pune,83416,64361,19055
2016-04-01,HSBC,CitiBank Pune,86854,67456,19398
2016-05-01,HSBC,CitiBank Pune,82541,65986,16555
2016-06-01,HSBC,CitiBank Pune,86312,67381,18931
2016-07-01,HSBC,CitiBank Pune,87977,66498,21479
2016-08-01,HSBC,CitiBank Pune,82257,68948,13309
2016-09-01,HSBC,CitiBank Pune,94658,55721,38937
2016-10-01,HSBC,CitiBank Pune,95514,56812,38702
2016-11-01,HSBC,CitiBank Pune,93955,51479,42476
2016-12-01,HSBC,CitiBank Pune,93898,52462,41436
2017-01-01,HSBC,CitiBank Pune,97316,55192,42124
2017-02-01,HSBC,CitiBank Pune,98485,54245,44240
2017-03-01,HSBC,CitiBank Pune,99153,56619,42534
2017-04-01,HSBC,CitiBank Pune,99548,56123,43425
2017-05-01,HSBC,CitiBank Pune,95648,56799,38849
2017-06-01,HSBC,CitiBank Pune,91689,51379,40310
2017-07-01,HSBC,CitiBank Pune,107917,54761,53156
2017-08-01,HSBC,CitiBank Pune,105115,59559,45556
2017-09-01,HSBC,CitiBank Pune,105732,51487,54245
2017-10-01,HSBC,CitiBank Pune,107499,59895,47604
2017-11-01,HSBC,CitiBank Pune,102595,56292,46303
2017-12-01,HSBC,CitiBank Pune,102654,51933,50721
2018-01-01,HSBC,CitiBank Pune,106227,54369,51858
2018-02-01,HSBC,CitiBank Pune,108957,52926,56031
2018-03-01,HSBC,CitiBank Pune,108582,58747,49835
2018-04-01,HSBC,CitiBank Pune,101151,55887,45264
2010-01-01,HSBC,CitiBank Singapore,15389,92453,-77064
2010-02-01,HSBC,CitiBank Singapore,14235,97138,-82903
2010-03-01,HSBC,CitiBank Singapore,17621,93194,-75573
2010-04-01,HSBC,CitiBank Singapore,11633,97791,-86158
2010-05-01,HSBC,CitiBank Singapore,15659,91198,-75539
2010-06-01,HSBC,CitiBank Singapore,15116,99875,-84759
2010-07-01,HSBC,CitiBank Singapore,15174,91835,-76661
2010-08-01,HSBC,CitiBank Singapore,17398,93683,-76285
2010-09-01,HSBC,CitiBank Singapore,12745,92514,-79769
2010-10-01,HSBC,CitiBank Singapore,15217,97565,-82348
2010-11-01,HSBC,CitiBank Singapore,22925,94977,-72052
2010-12-01,HSBC,CitiBank Singapore,21547,91146,-69599
2011-01-01,HSBC,CitiBank Singapore,25467,98531,-73064
2011-02-01,HSBC,CitiBank Singapore,29143,93366,-64223
2011-03-01,HSBC,CitiBank Singapore,21372,99365,-77993
2011-04-01,HSBC,CitiBank Singapore,29135,93636,-64501
2011-05-01,HSBC,CitiBank Singapore,26124,96346,-70222
2011-06-01,HSBC,CitiBank Singapore,23836,94568,-70732
2011-07-01,HSBC,CitiBank Singapore,23998,99437,-75439
2011-08-01,HSBC,CitiBank Singapore,29287,99887,-70600
2011-09-01,HSBC,CitiBank Singapore,32676,81241,-48565
2011-10-01,HSBC,CitiBank Singapore,35838,83266,-47428
2011-11-01,HSBC,CitiBank Singapore,37511,89627,-52116
2011-12-01,HSBC,CitiBank Singapore,37356,82871,-45515
2012-01-01,HSBC,CitiBank Singapore,39299,85782,-46483
2012-02-01,HSBC,CitiBank Singapore,36183,86615,-50432
2012-03-01,HSBC,CitiBank Singapore,32877,82159,-49282
2012-04-01,HSBC,CitiBank Singapore,35148,88376,-53228
2012-05-01,HSBC,CitiBank Singapore,36965,83377,-46412
2012-06-01,HSBC,CitiBank Singapore,33938,83791,-49853
2012-07-01,HSBC,CitiBank Singapore,44196,81851,-37655
2012-08-01,HSBC,CitiBank Singapore,41564,87952,-46388
2012-09-01,HSBC,CitiBank Singapore,44448,87699,-43251
2012-10-01,HSBC,CitiBank Singapore,41268,84816,-43548
2012-11-01,HSBC,CitiBank Singapore,49581,83593,-34012
2012-12-01,HSBC,CitiBank Singapore,44672,86187,-41515
2013-01-01,HSBC,CitiBank Singapore,45796,82554,-36758
2013-02-01,HSBC,CitiBank Singapore,44313,83397,-39084
2013-03-01,HSBC,CitiBank Singapore,42487,82568,-40081
2013-04-01,HSBC,CitiBank Singapore,43842,81286,-37444
2013-05-01,HSBC,CitiBank Singapore,58914,74364,-15450
2013-06-01,HSBC,CitiBank Singapore,57344,77972,-20628
2013-07-01,HSBC,CitiBank Singapore,57634,72385,-14751
2013-08-01,HSBC,CitiBank Singapore,54938,73733,-18795
2013-09-01,HSBC,CitiBank Singapore,51782,75819,-24037
2013-10-01,HSBC,CitiBank Singapore,58183,78994,-20811
2013-11-01,HSBC,CitiBank Singapore,57446,78932,-21486
2013-12-01,HSBC,CitiBank Singapore,59149,74348,-15199
2014-01-01,HSBC,CitiBank Singapore,54555,71913,-17358
2014-02-01,HSBC,CitiBank Singapore,53284,77852,-24568
2014-03-01,HSBC,CitiBank Singapore,69859,74725,-4866
2014-04-01,HSBC,CitiBank Singapore,64885,73747,-8862
2014-05-01,HSBC,CitiBank Singapore,68389,76387,-7998
2014-06-01,HSBC,CitiBank Singapore,63531,71376,-7845
2014-07-01,HSBC,CitiBank Singapore,63281,78743,-15462
2014-08-01,HSBC,CitiBank Singapore,63413,71356,-7943
2014-09-01,HSBC,CitiBank Singapore,67718,79297,-11579
2014-10-01,HSBC,CitiBank Singapore,69497,78523,-9026
2014-11-01,HSBC,CitiBank Singapore,66145,73863,-7718
2014-12-01,HSBC,CitiBank Singapore,62236,76339,-14103
2015-01-01,HSBC,CitiBank Singapore,74282,61838,12444
2015-02-01,HSBC,CitiBank Singapore,76341,66123,10218
2015-03-01,HSBC,CitiBank Singapore,72778,65186,7592
2015-04-01,HSBC,CitiBank Singapore,79533,64993,14540
2015-05-01,HSBC,CitiBank Singapore,79484,62532,16952
2015-06-01,HSBC,CitiBank Singapore,78762,69795,8967
2015-07-01,HSBC,CitiBank Singapore,77723,63281,14442
2015-08-01,HSBC,CitiBank Singapore,79629,63172,16457
2015-09-01,HSBC,CitiBank Singapore,73941,67873,6068
2015-10-01,HSBC,CitiBank Singapore,74376,67388,6988
2015-11-01,HSBC,CitiBank Singapore,84447,66262,18185
2015-12-01,HSBC,CitiBank Singapore,87964,67727,20237
2016-01-01,HSBC,CitiBank Singapore,83884,61569,22315
2016-02-01,HSBC,CitiBank Singapore,87359,67669,19690
2016-03-01,HSBC,CitiBank Singapore,88293,66212,22081
2016-04-01,HSBC,CitiBank Singapore,86682,61146,25536
2016-05-01,HSBC,CitiBank Singapore,83989,63786,20203
2016-06-01,HSBC,CitiBank Singapore,85747,61849,23898
2016-07-01,HSBC,CitiBank Singapore,89517,68789,20728
2016-08-01,HSBC,CitiBank Singapore,85785,65421,20364
2016-09-01,HSBC,CitiBank Singapore,99891,55523,44368
2016-10-01,HSBC,CitiBank Singapore,97931,51652,46279
2016-11-01,HSBC,CitiBank Singapore,97882,58869,39013
2016-12-01,HSBC,CitiBank Singapore,96557,54594,41963
2017-01-01,HSBC,CitiBank Singapore,96857,56475,40382
2017-02-01,HSBC,CitiBank Singapore,95743,59222,36521
2017-03-01,HSBC,CitiBank Singapore,92246,59835,32411
2017-04-01,HSBC,CitiBank Singapore,98533,56117,42416
2017-05-01,HSBC,CitiBank Singapore,99366,54683,44683
2017-06-01,HSBC,CitiBank Singapore,95778,52534,43244
2017-07-01,HSBC,CitiBank Singapore,105179,58813,46366
2017-08-01,HSBC,CitiBank Singapore,104979,58869,46110
2017-09-01,HSBC,CitiBank Singapore,101357,59573,41784
2017-10-01,HSBC,CitiBank Singapore,103144,56941,46203
2017-11-01,HSBC,CitiBank Singapore,105595,57764,47831
2017-12-01,HSBC,CitiBank Singapore,109476,56474,53002
2018-01-01,HSBC,CitiBank Singapore,104769,52839,51930
2018-02-01,HSBC,CitiBank Singapore,109812,56466,53346
2018-03-01,HSBC,CitiBank Singapore,104638,58459,46179
2018-04-01,HSBC,CitiBank Singapore,105747,53632,52115
2010-01-01,HSBC,CitiBank HongKong,12462,95387,-82925
2010-02-01,HSBC,CitiBank HongKong,17971,94465,-76494
2010-03-01,HSBC,CitiBank HongKong,17213,93845,-76632
2010-04-01,HSBC,CitiBank HongKong,18887,95353,-76466
2010-05-01,HSBC,CitiBank HongKong,18868,95679,-76811
2010-06-01,HSBC,CitiBank HongKong,16664,97947,-81283
2010-07-01,HSBC,CitiBank HongKong,19988,94741,-74753
2010-08-01,HSBC,CitiBank HongKong,15928,94662,-78734
2010-09-01,HSBC,CitiBank HongKong,17217,96526,-79309
2010-10-01,HSBC,CitiBank HongKong,11698,95189,-83491
2010-11-01,HSBC,CitiBank HongKong,21589,93275,-71686
2010-12-01,HSBC,CitiBank HongKong,27344,93465,-66121
2011-01-01,HSBC,CitiBank HongKong,29965,91762,-61797
2011-02-01,HSBC,CitiBank HongKong,26568,92353,-65785
2011-03-01,HSBC,CitiBank HongKong,21941,93713,-71772
2011-04-01,HSBC,CitiBank HongKong,29254,98892,-69638
2011-05-01,HSBC,CitiBank HongKong,28257,92321,-64064
2011-06-01,HSBC,CitiBank HongKong,27755,91531,-63776
2011-07-01,HSBC,CitiBank HongKong,21929,91352,-69423
2011-08-01,HSBC,CitiBank HongKong,22583,97123,-74540
2011-09-01,HSBC,CitiBank HongKong,31328,86667,-55339
2011-10-01,HSBC,CitiBank HongKong,35363,86934,-51571
2011-11-01,HSBC,CitiBank HongKong,32989,83116,-50127
2011-12-01,HSBC,CitiBank HongKong,33417,86512,-53095
2012-01-01,HSBC,CitiBank HongKong,37539,81749,-44210
2012-02-01,HSBC,CitiBank HongKong,38184,81898,-43714
2012-03-01,HSBC,CitiBank HongKong,31447,85761,-54314
2012-04-01,HSBC,CitiBank HongKong,38497,85481,-46984
2012-05-01,HSBC,CitiBank HongKong,31716,82587,-50871
2012-06-01,HSBC,CitiBank HongKong,38716,89946,-51230
2012-07-01,HSBC,CitiBank HongKong,43421,89361,-45940
2012-08-01,HSBC,CitiBank HongKong,45261,85679,-40418
2012-09-01,HSBC,CitiBank HongKong,44379,89644,-45265
2012-10-01,HSBC,CitiBank HongKong,47779,89852,-42073
2012-11-01,HSBC,CitiBank HongKong,42551,86851,-44300
2012-12-01,HSBC,CitiBank HongKong,49594,88891,-39297
2013-01-01,HSBC,CitiBank HongKong,49977,87574,-37597
2013-02-01,HSBC,CitiBank HongKong,47461,87339,-39878
2013-03-01,HSBC,CitiBank HongKong,48915,82267,-33352
2013-04-01,HSBC,CitiBank HongKong,42892,88617,-45725
2013-05-01,HSBC,CitiBank HongKong,59419,77445,-18026
2013-06-01,HSBC,CitiBank HongKong,51191,77491,-26300
2013-07-01,HSBC,CitiBank HongKong,56628,75836,-19208
2013-08-01,HSBC,CitiBank HongKong,59133,71772,-12639
2013-09-01,HSBC,CitiBank HongKong,51623,72483,-20860
2013-10-01,HSBC,CitiBank HongKong,59275,77295,-18020
2013-11-01,HSBC,CitiBank HongKong,53674,79434,-25760
2013-12-01,HSBC,CitiBank HongKong,51879,74248,-22369
2014-01-01,HSBC,CitiBank HongKong,56232,76448,-20216
2014-02-01,HSBC,CitiBank HongKong,58284,75863,-17579
2014-03-01,HSBC,CitiBank HongKong,64534,72278,-7744
2014-04-01,HSBC,CitiBank HongKong,68454,77332,-8878
2014-05-01,HSBC,CitiBank HongKong,64871,73499,-8628
2014-06-01,HSBC,CitiBank HongKong,67291,72873,-5582
2014-07-01,HSBC,CitiBank HongKong,61916,78762,-16846
2014-08-01,HSBC,CitiBank HongKong,63368,71439,-8071
2014-09-01,HSBC,CitiBank HongKong,62673,71894,-9221
2014-10-01,HSBC,CitiBank HongKong,62983,74323,-11340
2014-11-01,HSBC,CitiBank HongKong,69557,72494,-2937
2014-12-01,HSBC,CitiBank HongKong,69829,73724,-3895
2015-01-01,HSBC,CitiBank HongKong,78925,61638,17287
2015-02-01,HSBC,CitiBank HongKong,78554,67968,10586
2015-03-01,HSBC,CitiBank HongKong,79315,69173,10142
2015-04-01,HSBC,CitiBank HongKong,73486,66333,7153
2015-05-01,HSBC,CitiBank HongKong,71868,66586,5282
2015-06-01,HSBC,CitiBank HongKong,72594,65611,6983
2015-07-01,HSBC,CitiBank HongKong,74197,63452,10745
2015-08-01,HSBC,CitiBank HongKong,72117,67822,4295
2015-09-01,HSBC,CitiBank HongKong,76165,67455,8710
2015-10-01,HSBC,CitiBank HongKong,75563,64687,10876
2015-11-01,HSBC,CitiBank HongKong,82116,63345,18771
2015-12-01,HSBC,CitiBank HongKong,89412,64164,25248
2016-01-01,HSBC,CitiBank HongKong,83514,68926,14588
2016-02-01,HSBC,CitiBank HongKong,89439,67113,22326
2016-03-01,HSBC,CitiBank HongKong,82589,65438,17151
2016-04-01,HSBC,CitiBank HongKong,84194,65378,18816
2016-05-01,HSBC,CitiBank HongKong,81816,68381,13435
2016-06-01,HSBC,CitiBank HongKong,82152,67823,14329
2016-07-01,HSBC,CitiBank HongKong,86394,63118,23276
2016-08-01,HSBC,CitiBank HongKong,88171,62193,25978
2016-09-01,HSBC,CitiBank HongKong,95877,56481,39396
2016-10-01,HSBC,CitiBank HongKong,98687,51738,46949
2016-11-01,HSBC,CitiBank HongKong,99611,54998,44613
2016-12-01,HSBC,CitiBank HongKong,99123,55632,43491
2017-01-01,HSBC,CitiBank HongKong,95918,56397,39521
2017-02-01,HSBC,CitiBank HongKong,98132,51132,47000
2017-03-01,HSBC,CitiBank HongKong,93819,58269,35550
2017-04-01,HSBC,CitiBank HongKong,95279,58981,36298
2017-05-01,HSBC,CitiBank HongKong,98859,57953,40906
2017-06-01,HSBC,CitiBank HongKong,99526,57331,42195
2017-07-01,HSBC,CitiBank HongKong,108461,54882,53579
2017-08-01,HSBC,CitiBank HongKong,106871,59648,47223
2017-09-01,HSBC,CitiBank HongKong,103149,52884,50265
2017-10-01,HSBC,CitiBank HongKong,109434,52238,57196
2017-11-01,HSBC,CitiBank HongKong,106942,57162,49780
2017-12-01,HSBC,CitiBank HongKong,104225,51457,52768
2018-01-01,HSBC,CitiBank HongKong,105767,56738,49029
2018-02-01,HSBC,CitiBank HongKong,108369,59427,48942
2018-03-01,HSBC,CitiBank HongKong,106582,56318,50264
2018-04-01,HSBC,CitiBank HongKong,107537,54397,53140
2010-01-01,BNY Mellon,CitiBank New York,12831,92937,-80106
2010-02-01,BNY Mellon,CitiBank New York,18335,98813,-80478
2010-03-01,BNY Mellon,CitiBank New York,14382,95817,-81435
2010-04-01,BNY Mellon,CitiBank New York,13347,97395,-84048
2010-05-01,BNY Mellon,CitiBank New York,13979,97423,-83444
2010-06-01,BNY Mellon,CitiBank New York,13973,92573,-78600
2010-07-01,BNY Mellon,CitiBank New York,16425,98699,-82274
2010-08-01,BNY Mellon,CitiBank New York,11145,95283,-84138
2010-09-01,BNY Mellon,CitiBank New York,17817,93138,-75321
2010-10-01,BNY Mellon,CitiBank New York,12795,94626,-81831
2010-11-01,BNY Mellon,CitiBank New York,21569,95642,-74073
2010-12-01,BNY Mellon,CitiBank New York,29611,96434,-66823
2011-01-01,BNY Mellon,CitiBank New York,29922,92117,-62195
2011-02-01,BNY Mellon,CitiBank New York,21979,93446,-71467
2011-03-01,BNY Mellon,CitiBank New York,28897,92574,-63677
2011-04-01,BNY Mellon,CitiBank New York,28712,99253,-70541
2011-05-01,BNY Mellon,CitiBank New York,28548,94859,-66311
2011-06-01,BNY Mellon,CitiBank New York,27791,93795,-66004
2011-07-01,BNY Mellon,CitiBank New York,29366,99746,-70380
2011-08-01,BNY Mellon,CitiBank New York,29862,99997,-70135
2011-09-01,BNY Mellon,CitiBank New York,32362,82535,-50173
2011-10-01,BNY Mellon,CitiBank New York,35736,86718,-50982
2011-11-01,BNY Mellon,CitiBank New York,32433,84225,-51792
2011-12-01,BNY Mellon,CitiBank New York,36553,82521,-45968
2012-01-01,BNY Mellon,CitiBank New York,33515,84768,-51253
2012-02-01,BNY Mellon,CitiBank New York,32293,88384,-56091
2012-03-01,BNY Mellon,CitiBank New York,36286,81634,-45348
2012-04-01,BNY Mellon,CitiBank New York,35787,88629,-52842
2012-05-01,BNY Mellon,CitiBank New York,34596,86742,-52146
2012-06-01,BNY Mellon,CitiBank New York,31423,81493,-50070
2012-07-01,BNY Mellon,CitiBank New York,44471,85556,-41085
2012-08-01,BNY Mellon,CitiBank New York,47258,88816,-41558
2012-09-01,BNY Mellon,CitiBank New York,47742,84722,-36980
2012-10-01,BNY Mellon,CitiBank New York,45272,86121,-40849
2012-11-01,BNY Mellon,CitiBank New York,42559,85248,-42689
2012-12-01,BNY Mellon,CitiBank New York,44989,81814,-36825
2013-01-01,BNY Mellon,CitiBank New York,45616,84685,-39069
2013-02-01,BNY Mellon,CitiBank New York,47683,81729,-34046
2013-03-01,BNY Mellon,CitiBank New York,41399,86763,-45364
2013-04-01,BNY Mellon,CitiBank New York,48769,84523,-35754
2013-05-01,BNY Mellon,CitiBank New York,55318,72875,-17557
2013-06-01,BNY Mellon,CitiBank New York,51379,76246,-24867
2013-07-01,BNY Mellon,CitiBank New York,53979,78655,-24676
2013-08-01,BNY Mellon,CitiBank New York,52358,79765,-27407
2013-09-01,BNY Mellon,CitiBank New York,54124,73292,-19168
2013-10-01,BNY Mellon,CitiBank New York,58121,72788,-14667
2013-11-01,BNY Mellon,CitiBank New York,57789,79713,-21924
2013-12-01,BNY Mellon,CitiBank New York,51972,73551,-21579
2014-01-01,BNY Mellon,CitiBank New York,58915,75126,-16211
2014-02-01,BNY Mellon,CitiBank New York,59531,78751,-19220
2014-03-01,BNY Mellon,CitiBank New York,63689,78166,-14477
2014-04-01,BNY Mellon,CitiBank New York,66561,72639,-6078
2014-05-01,BNY Mellon,CitiBank New York,62978,72891,-9913
2014-06-01,BNY Mellon,CitiBank New York,65877,76277,-10400
2014-07-01,BNY Mellon,CitiBank New York,67742,76884,-9142
2014-08-01,BNY Mellon,CitiBank New York,69315,73763,-4448
2014-09-01,BNY Mellon,CitiBank New York,63127,71997,-8870
2014-10-01,BNY Mellon,CitiBank New York,61793,78674,-16881
2014-11-01,BNY Mellon,CitiBank New York,69819,71951,-2132
2014-12-01,BNY Mellon,CitiBank New York,61984,77257,-15273
2015-01-01,BNY Mellon,CitiBank New York,71318,65643,5675
2015-02-01,BNY Mellon,CitiBank New York,74175,61269,12906
2015-03-01,BNY Mellon,CitiBank New York,71679,64686,6993
2015-04-01,BNY Mellon,CitiBank New York,74915,62887,12028
2015-05-01,BNY Mellon,CitiBank New York,78624,69636,8988
2015-06-01,BNY Mellon,CitiBank New York,78272,67549,10723
2015-07-01,BNY Mellon,CitiBank New York,75251,61643,13608
2015-08-01,BNY Mellon,CitiBank New York,79574,68553,11021
2015-09-01,BNY Mellon,CitiBank New York,76327,66826,9501
2015-10-01,BNY Mellon,CitiBank New York,76234,67628,8606
2015-11-01,BNY Mellon,CitiBank New York,87975,65569,22406
2015-12-01,BNY Mellon,CitiBank New York,87883,67889,19994
2016-01-01,BNY Mellon,CitiBank New York,87389,68714,18675
2016-02-01,BNY Mellon,CitiBank New York,84994,61159,23835
2016-03-01,BNY Mellon,CitiBank New York,85448,69938,15510
2016-04-01,BNY Mellon,CitiBank New York,89961,61586,28375
2016-05-01,BNY Mellon,CitiBank New York,83851,66683,17168
2016-06-01,BNY Mellon,CitiBank New York,83353,62884,20469
2016-07-01,BNY Mellon,CitiBank New York,84572,69845,14727
2016-08-01,BNY Mellon,CitiBank New York,83381,67118,16263
2016-09-01,BNY Mellon,CitiBank New York,96255,53124,43131
2016-10-01,BNY Mellon,CitiBank New York,97396,52665,44731
2016-11-01,BNY Mellon,CitiBank New York,99945,58825,41120
2016-12-01,BNY Mellon,CitiBank New York,95986,57625,38361
2017-01-01,BNY Mellon,CitiBank New York,94414,58159,36255
2017-02-01,BNY Mellon,CitiBank New York,98277,56679,41598
2017-03-01,BNY Mellon,CitiBank New York,91691,55592,36099
2017-04-01,BNY Mellon,CitiBank New York,96874,55516,41358
2017-05-01,BNY Mellon,CitiBank New York,96962,53568,43394
2017-06-01,BNY Mellon,CitiBank New York,97448,58235,39213
2017-07-01,BNY Mellon,CitiBank New York,101898,56764,45134
2017-08-01,BNY Mellon,CitiBank New York,107545,56517,51028
2017-09-01,BNY Mellon,CitiBank New York,106174,55755,50419
2017-10-01,BNY Mellon,CitiBank New York,104515,53361,51154
2017-11-01,BNY Mellon,CitiBank New York,108286,53587,54699
2017-12-01,BNY Mellon,CitiBank New York,104531,54881,49650
2018-01-01,BNY Mellon,CitiBank New York,103366,51252,52114
2018-02-01,BNY Mellon,CitiBank New York,108485,52211,56274
2018-03-01,BNY Mellon,CitiBank New York,104551,57285,47266
2018-04-01,BNY Mellon,CitiBank New York,101642,59852,41790
2010-01-01,BNY Mellon,CitiBank London,18399,96752,-78353
2010-02-01,BNY Mellon,CitiBank London,11349,98134,-86785
2010-03-01,BNY Mellon,CitiBank London,11415,94511,-83096
2010-04-01,BNY Mellon,CitiBank London,19759,91373,-71614
2010-05-01,BNY Mellon,CitiBank London,13725,97843,-84118
2010-06-01,BNY Mellon,CitiBank London,11591,96622,-85031
2010-07-01,BNY Mellon,CitiBank London,11149,93724,-82575
2010-08-01,BNY Mellon,CitiBank London,19842,94773,-74931
2010-09-01,BNY Mellon,CitiBank London,17719,95461,-77742
2010-10-01,BNY Mellon,CitiBank London,17345,98979,-81634
2010-11-01,BNY Mellon,CitiBank London,29843,99737,-69894
2010-12-01,BNY Mellon,CitiBank London,22676,98936,-76260
2011-01-01,BNY Mellon,CitiBank London,24216,98547,-74331
2011-02-01,BNY Mellon,CitiBank London,28986,96417,-67431
2011-03-01,BNY Mellon,CitiBank London,26255,92813,-66558
2011-04-01,BNY Mellon,CitiBank London,24845,91759,-66914
2011-05-01,BNY Mellon,CitiBank London,25796,92841,-67045
2011-06-01,BNY Mellon,CitiBank London,21511,92394,-70883
2011-07-01,BNY Mellon,CitiBank London,26987,98556,-71569
2011-08-01,BNY Mellon,CitiBank London,29234,99552,-70318
2011-09-01,BNY Mellon,CitiBank London,33366,84725,-51359
2011-10-01,BNY Mellon,CitiBank London,34354,82179,-47825
2011-11-01,BNY Mellon,CitiBank London,39438,86268,-46830
2011-12-01,BNY Mellon,CitiBank London,38793,85371,-46578
2012-01-01,BNY Mellon,CitiBank London,34231,87735,-53504
2012-02-01,BNY Mellon,CitiBank London,32589,88181,-55592
2012-03-01,BNY Mellon,CitiBank London,34224,86168,-51944
2012-04-01,BNY Mellon,CitiBank London,39298,81891,-42593
2012-05-01,BNY Mellon,CitiBank London,35145,85472,-50327
2012-06-01,BNY Mellon,CitiBank London,38194,86387,-48193
2012-07-01,BNY Mellon,CitiBank London,41267,82132,-40865
2012-08-01,BNY Mellon,CitiBank London,42371,81655,-39284
2012-09-01,BNY Mellon,CitiBank London,48712,82167,-33455
2012-10-01,BNY Mellon,CitiBank London,49154,86697,-37543
2012-11-01,BNY Mellon,CitiBank London,42314,87128,-44814
2012-12-01,BNY Mellon,CitiBank London,46769,83955,-37186
2013-01-01,BNY Mellon,CitiBank London,46887,87558,-40671
2013-02-01,BNY Mellon,CitiBank London,49514,86251,-36737
2013-03-01,BNY Mellon,CitiBank London,45299,81137,-35838
2013-04-01,BNY Mellon,CitiBank London,47812,81592,-33780
2013-05-01,BNY Mellon,CitiBank London,57261,72437,-15176
2013-06-01,BNY Mellon,CitiBank London,55552,78223,-22671
2013-07-01,BNY Mellon,CitiBank London,57195,72344,-15149
2013-08-01,BNY Mellon,CitiBank London,56127,76434,-20307
2013-09-01,BNY Mellon,CitiBank London,55269,72331,-17062
2013-10-01,BNY Mellon,CitiBank London,51591,73176,-21585
2013-11-01,BNY Mellon,CitiBank London,56426,71976,-15550
2013-12-01,BNY Mellon,CitiBank London,59151,72422,-13271
2014-01-01,BNY Mellon,CitiBank London,51347,74818,-23471
2014-02-01,BNY Mellon,CitiBank London,55564,74572,-19008
2014-03-01,BNY Mellon,CitiBank London,62657,71166,-8509
2014-04-01,BNY Mellon,CitiBank London,63125,72194,-9069
2014-05-01,BNY Mellon,CitiBank London,67698,72236,-4538
2014-06-01,BNY Mellon,CitiBank London,69249,75426,-6177
2014-07-01,BNY Mellon,CitiBank London,64179,75998,-11819
2014-08-01,BNY Mellon,CitiBank London,67449,78883,-11434
2014-09-01,BNY Mellon,CitiBank London,61386,77833,-16447
2014-10-01,BNY Mellon,CitiBank London,62598,77519,-14921
2014-11-01,BNY Mellon,CitiBank London,69739,72556,-2817
2014-12-01,BNY Mellon,CitiBank London,69842,73852,-4010
2015-01-01,BNY Mellon,CitiBank London,75899,61697,14202
2015-02-01,BNY Mellon,CitiBank London,78585,61346,17239
2015-03-01,BNY Mellon,CitiBank London,75887,66456,9431
2015-04-01,BNY Mellon,CitiBank London,72485,67327,5158
2015-05-01,BNY Mellon,CitiBank London,76162,67392,8770
2015-06-01,BNY Mellon,CitiBank London,73911,62651,11260
2015-07-01,BNY Mellon,CitiBank London,76348,65451,10897
2015-08-01,BNY Mellon,CitiBank London,77115,62144,14971
2015-09-01,BNY Mellon,CitiBank London,77271,67246,10025
2015-10-01,BNY Mellon,CitiBank London,75882,64752,11130
2015-11-01,BNY Mellon,CitiBank London,85752,67926,17826
2015-12-01,BNY Mellon,CitiBank London,82475,69753,12722
2016-01-01,BNY Mellon,CitiBank London,88751,68134,20617
2016-02-01,BNY Mellon,CitiBank London,83111,63773,19338
2016-03-01,BNY Mellon,CitiBank London,83338,63694,19644
2016-04-01,BNY Mellon,CitiBank London,83956,64457,19499
2016-05-01,BNY Mellon,CitiBank London,86828,68916,17912
2016-06-01,BNY Mellon,CitiBank London,85518,69946,15572
2016-07-01,BNY Mellon,CitiBank London,89157,65983,23174
2016-08-01,BNY Mellon,CitiBank London,83525,68778,14747
2016-09-01,BNY Mellon,CitiBank London,99871,58221,41650
2016-10-01,BNY Mellon,CitiBank London,93811,59222,34589
2016-11-01,BNY Mellon,CitiBank London,96831,51272,45559
2016-12-01,BNY Mellon,CitiBank London,94986,53824,41162
2017-01-01,BNY Mellon,CitiBank London,93116,54541,38575
2017-02-01,BNY Mellon,CitiBank London,98431,52645,45786
2017-03-01,BNY Mellon,CitiBank London,93446,55849,37597
2017-04-01,BNY Mellon,CitiBank London,94595,57827,36768
2017-05-01,BNY Mellon,CitiBank London,95927,51187,44740
2017-06-01,BNY Mellon,CitiBank London,98899,53255,45644
2017-07-01,BNY Mellon,CitiBank London,105197,57837,47360
2017-08-01,BNY Mellon,CitiBank London,107221,53655,53566
2017-09-01,BNY Mellon,CitiBank London,106512,57385,49127
2017-10-01,BNY Mellon,CitiBank London,107893,55187,52706
2017-11-01,BNY Mellon,CitiBank London,109422,56357,53065
2017-12-01,BNY Mellon,CitiBank London,102428,51824,50604
2018-01-01,BNY Mellon,CitiBank London,105764,53122,52642
2018-02-01,BNY Mellon,CitiBank London,106945,53162,53783
2018-03-01,BNY Mellon,CitiBank London,103137,51493,51644
2018-04-01,BNY Mellon,CitiBank London,106365,54819,51546
2010-01-01,BNY Mellon,CitiBank Pune,16972,91959,-74987
2010-02-01,BNY Mellon,CitiBank Pune,14719,98894,-84175
2010-03-01,BNY Mellon,CitiBank Pune,12677,96762,-84085
2010-04-01,BNY Mellon,CitiBank Pune,11147,97173,-86026
2010-05-01,BNY Mellon,CitiBank Pune,16398,96773,-80375
2010-06-01,BNY Mellon,CitiBank Pune,18283,96875,-78592
2010-07-01,BNY Mellon,CitiBank Pune,16849,91232,-74383
2010-08-01,BNY Mellon,CitiBank Pune,14963,99419,-84456
2010-09-01,BNY Mellon,CitiBank Pune,14197,93456,-79259
2010-10-01,BNY Mellon,CitiBank Pune,18376,96498,-78122
2010-11-01,BNY Mellon,CitiBank Pune,26259,96311,-70052
2010-12-01,BNY Mellon,CitiBank Pune,25659,92614,-66955
2011-01-01,BNY Mellon,CitiBank Pune,21866,98915,-77049
2011-02-01,BNY Mellon,CitiBank Pune,27523,92898,-65375
2011-03-01,BNY Mellon,CitiBank Pune,26936,98677,-71741
2011-04-01,BNY Mellon,CitiBank Pune,27623,98358,-70735
2011-05-01,BNY Mellon,CitiBank Pune,23727,99118,-75391
2011-06-01,BNY Mellon,CitiBank Pune,21629,95187,-73558
2011-07-01,BNY Mellon,CitiBank Pune,25281,98455,-73174
2011-08-01,BNY Mellon,CitiBank Pune,27327,92781,-65454
2011-09-01,BNY Mellon,CitiBank Pune,33278,82172,-48894
2011-10-01,BNY Mellon,CitiBank Pune,38375,83189,-44814
2011-11-01,BNY Mellon,CitiBank Pune,39726,89656,-49930
2011-12-01,BNY Mellon,CitiBank Pune,34996,83123,-48127
2012-01-01,BNY Mellon,CitiBank Pune,32734,87139,-54405
2012-02-01,BNY Mellon,CitiBank Pune,36998,86825,-49827
2012-03-01,BNY Mellon,CitiBank Pune,31422,85892,-54470
2012-04-01,BNY Mellon,CitiBank Pune,36859,84172,-47313
2012-05-01,BNY Mellon,CitiBank Pune,34181,81242,-47061
2012-06-01,BNY Mellon,CitiBank Pune,32348,88643,-56295
2012-07-01,BNY Mellon,CitiBank Pune,41492,84844,-43352
2012-08-01,BNY Mellon,CitiBank Pune,45737,85124,-39387
2012-09-01,BNY Mellon,CitiBank Pune,46156,81727,-35571
2012-10-01,BNY Mellon,CitiBank Pune,47761,89476,-41715
2012-11-01,BNY Mellon,CitiBank Pune,41718,89116,-47398
2012-12-01,BNY Mellon,CitiBank Pune,43416,86374,-42958
2013-01-01,BNY Mellon,CitiBank Pune,42288,88695,-46407
2013-02-01,BNY Mellon,CitiBank Pune,48743,82386,-33643
2013-03-01,BNY Mellon,CitiBank Pune,48113,86429,-38316
2013-04-01,BNY Mellon,CitiBank Pune,48555,83314,-34759
2013-05-01,BNY Mellon,CitiBank Pune,52499,75215,-22716
2013-06-01,BNY Mellon,CitiBank Pune,55528,74137,-18609
2013-07-01,BNY Mellon,CitiBank Pune,59922,74989,-15067
2013-08-01,BNY Mellon,CitiBank Pune,58337,79656,-21319
2013-09-01,BNY Mellon,CitiBank Pune,58512,76478,-17966
2013-10-01,BNY Mellon,CitiBank Pune,52743,78283,-25540
2013-11-01,BNY Mellon,CitiBank Pune,53824,73742,-19918
2013-12-01,BNY Mellon,CitiBank Pune,55444,79259,-23815
2014-01-01,BNY Mellon,CitiBank Pune,57959,77769,-19810
2014-02-01,BNY Mellon,CitiBank Pune,51734,77661,-25927
2014-03-01,BNY Mellon,CitiBank Pune,64839,71988,-7149
2014-04-01,BNY Mellon,CitiBank Pune,61117,76671,-15554
2014-05-01,BNY Mellon,CitiBank Pune,61971,76155,-14184
2014-06-01,BNY Mellon,CitiBank Pune,66582,79561,-12979
2014-07-01,BNY Mellon,CitiBank Pune,65284,75625,-10341
2014-08-01,BNY Mellon,CitiBank Pune,68666,76634,-7968
2014-09-01,BNY Mellon,CitiBank Pune,65562,71174,-5612
2014-10-01,BNY Mellon,CitiBank Pune,67791,74971,-7180
2014-11-01,BNY Mellon,CitiBank Pune,62531,73685,-11154
2014-12-01,BNY Mellon,CitiBank Pune,65373,72315,-6942
2015-01-01,BNY Mellon,CitiBank Pune,76458,67446,9012
2015-02-01,BNY Mellon,CitiBank Pune,78244,65333,12911
2015-03-01,BNY Mellon,CitiBank Pune,72473,65919,6554
2015-04-01,BNY Mellon,CitiBank Pune,71459,67937,3522
2015-05-01,BNY Mellon,CitiBank Pune,77549,66525,11024
2015-06-01,BNY Mellon,CitiBank Pune,71237,69363,1874
2015-07-01,BNY Mellon,CitiBank Pune,74467,65512,8955
2015-08-01,BNY Mellon,CitiBank Pune,76732,63632,13100
2015-09-01,BNY Mellon,CitiBank Pune,77638,64218,13420
2015-10-01,BNY Mellon,CitiBank Pune,79187,67871,11316
2015-11-01,BNY Mellon,CitiBank Pune,87992,66159,21833
2015-12-01,BNY Mellon,CitiBank Pune,82754,66164,16590
2016-01-01,BNY Mellon,CitiBank Pune,88371,63332,25039
2016-02-01,BNY Mellon,CitiBank Pune,82111,66429,15682
2016-03-01,BNY Mellon,CitiBank Pune,87933,69527,18406
2016-04-01,BNY Mellon,CitiBank Pune,81455,65315,16140
2016-05-01,BNY Mellon,CitiBank Pune,89554,64529,25025
2016-06-01,BNY Mellon,CitiBank Pune,87621,69264,18357
2016-07-01,BNY Mellon,CitiBank Pune,89617,66429,23188
2016-08-01,BNY Mellon,CitiBank Pune,81844,66159,15685
2016-09-01,BNY Mellon,CitiBank Pune,91762,59887,31875
2016-10-01,BNY Mellon,CitiBank Pune,98454,59221,39233
2016-11-01,BNY Mellon,CitiBank Pune,99727,55572,44155
2016-12-01,BNY Mellon,CitiBank Pune,94219,51183,43036
2017-01-01,BNY Mellon,CitiBank Pune,91828,55127,36701
2017-02-01,BNY Mellon,CitiBank Pune,92216,52271,39945
2017-03-01,BNY Mellon,CitiBank Pune,93211,54825,38386
2017-04-01,BNY Mellon,CitiBank Pune,93173,52547,40626
2017-05-01,BNY Mellon,CitiBank Pune,94726,52588,42138
2017-06-01,BNY Mellon,CitiBank Pune,99661,58253,41408
2017-07-01,BNY Mellon,CitiBank Pune,104744,58287,46457
2017-08-01,BNY Mellon,CitiBank Pune,108164,57556,50608
2017-09-01,BNY Mellon,CitiBank Pune,101653,59192,42461
2017-10-01,BNY Mellon,CitiBank Pune,101849,56482,45367
2017-11-01,BNY Mellon,CitiBank Pune,109617,56651,52966
2017-12-01,BNY Mellon,CitiBank Pune,105145,59627,45518
2018-01-01,BNY Mellon,CitiBank Pune,103643,58986,44657
2018-02-01,BNY Mellon,CitiBank Pune,106948,51587,55361
2018-03-01,BNY Mellon,CitiBank Pune,103669,58427,45242
2018-04-01,BNY Mellon,CitiBank Pune,102542,57381,45161
2010-01-01,BNY Mellon,CitiBank Singapore,13959,98542,-84583
2010-02-01,BNY Mellon,CitiBank Singapore,12361,93191,-80830
2010-03-01,BNY Mellon,CitiBank Singapore,18523,93443,-74920
2010-04-01,BNY Mellon,CitiBank Singapore,11193,92496,-81303
2010-05-01,BNY Mellon,CitiBank Singapore,17118,96141,-79023
2010-06-01,BNY Mellon,CitiBank Singapore,18814,93419,-74605
2010-07-01,BNY Mellon,CitiBank Singapore,18969,93733,-74764
2010-08-01,BNY Mellon,CitiBank Singapore,13862,95166,-81304
2010-09-01,BNY Mellon,CitiBank Singapore,14824,96768,-81944
2010-10-01,BNY Mellon,CitiBank Singapore,11552,92297,-80745
2010-11-01,BNY Mellon,CitiBank Singapore,24864,92371,-67507
2010-12-01,BNY Mellon,CitiBank Singapore,27551,91883,-64332
2011-01-01,BNY Mellon,CitiBank Singapore,24571,99143,-74572
2011-02-01,BNY Mellon,CitiBank Singapore,21936,93411,-71475
2011-03-01,BNY Mellon,CitiBank Singapore,28671,99548,-70877
2011-04-01,BNY Mellon,CitiBank Singapore,24858,95513,-70655
2011-05-01,BNY Mellon,CitiBank Singapore,25248,96553,-71305
2011-06-01,BNY Mellon,CitiBank Singapore,23152,93425,-70273
2011-07-01,BNY Mellon,CitiBank Singapore,25126,92666,-67540
2011-08-01,BNY Mellon,CitiBank Singapore,27788,98529,-70741
2011-09-01,BNY Mellon,CitiBank Singapore,32716,81522,-48806
2011-10-01,BNY Mellon,CitiBank Singapore,33695,89432,-55737
2011-11-01,BNY Mellon,CitiBank Singapore,38893,89962,-51069
2011-12-01,BNY Mellon,CitiBank Singapore,38443,84245,-45802
2012-01-01,BNY Mellon,CitiBank Singapore,37218,86111,-48893
2012-02-01,BNY Mellon,CitiBank Singapore,39837,83683,-43846
2012-03-01,BNY Mellon,CitiBank Singapore,32257,89861,-57604
2012-04-01,BNY Mellon,CitiBank Singapore,34133,85455,-51322
2012-05-01,BNY Mellon,CitiBank Singapore,32914,85478,-52564
2012-06-01,BNY Mellon,CitiBank Singapore,35784,88417,-52633
2012-07-01,BNY Mellon,CitiBank Singapore,48971,89489,-40518
2012-08-01,BNY Mellon,CitiBank Singapore,48412,85365,-36953
2012-09-01,BNY Mellon,CitiBank Singapore,41675,81217,-39542
2012-10-01,BNY Mellon,CitiBank Singapore,42237,84171,-41934
2012-11-01,BNY Mellon,CitiBank Singapore,42214,82684,-40470
2012-12-01,BNY Mellon,CitiBank Singapore,42181,83254,-41073
2013-01-01,BNY Mellon,CitiBank Singapore,43751,86783,-43032
2013-02-01,BNY Mellon,CitiBank Singapore,48823,89282,-40459
2013-03-01,BNY Mellon,CitiBank Singapore,47732,85246,-37514
2013-04-01,BNY Mellon,CitiBank Singapore,42399,87586,-45187
2013-05-01,BNY Mellon,CitiBank Singapore,59817,76262,-16445
2013-06-01,BNY Mellon,CitiBank Singapore,57877,75577,-17700
2013-07-01,BNY Mellon,CitiBank Singapore,53154,72869,-19715
2013-08-01,BNY Mellon,CitiBank Singapore,52542,78114,-25572
2013-09-01,BNY Mellon,CitiBank Singapore,55812,75936,-20124
2013-10-01,BNY Mellon,CitiBank Singapore,57889,76953,-19064
2013-11-01,BNY Mellon,CitiBank Singapore,55496,75962,-20466
2013-12-01,BNY Mellon,CitiBank Singapore,57164,76288,-19124
2014-01-01,BNY Mellon,CitiBank Singapore,59458,75725,-16267
2014-02-01,BNY Mellon,CitiBank Singapore,53772,75729,-21957
2014-03-01,BNY Mellon,CitiBank Singapore,61344,71518,-10174
2014-04-01,BNY Mellon,CitiBank Singapore,68921,77361,-8440
2014-05-01,BNY Mellon,CitiBank Singapore,63741,76951,-13210
2014-06-01,BNY Mellon,CitiBank Singapore,67591,79125,-11534
2014-07-01,BNY Mellon,CitiBank Singapore,62113,78553,-16440
2014-08-01,BNY Mellon,CitiBank Singapore,63264,71358,-8094
2014-09-01,BNY Mellon,CitiBank Singapore,66496,72934,-6438
2014-10-01,BNY Mellon,CitiBank Singapore,61212,71935,-10723
2014-11-01,BNY Mellon,CitiBank Singapore,66511,76739,-10228
2014-12-01,BNY Mellon,CitiBank Singapore,69513,73287,-3774
2015-01-01,BNY Mellon,CitiBank Singapore,72719,65486,7233
2015-02-01,BNY Mellon,CitiBank Singapore,76566,66244,10322
2015-03-01,BNY Mellon,CitiBank Singapore,77421,64828,12593
2015-04-01,BNY Mellon,CitiBank Singapore,77814,69128,8686
2015-05-01,BNY Mellon,CitiBank Singapore,77292,61423,15869
2015-06-01,BNY Mellon,CitiBank Singapore,77975,66321,11654
2015-07-01,BNY Mellon,CitiBank Singapore,78925,64483,14442
2015-08-01,BNY Mellon,CitiBank Singapore,73678,62757,10921
2015-09-01,BNY Mellon,CitiBank Singapore,73557,65482,8075
2015-10-01,BNY Mellon,CitiBank Singapore,73617,65964,7653
2015-11-01,BNY Mellon,CitiBank Singapore,88565,64882,23683
2015-12-01,BNY Mellon,CitiBank Singapore,88766,64643,24123
2016-01-01,BNY Mellon,CitiBank Singapore,87653,64872,22781
2016-02-01,BNY Mellon,CitiBank Singapore,85513,66545,18968
2016-03-01,BNY Mellon,CitiBank Singapore,87336,64836,22500
2016-04-01,BNY Mellon,CitiBank Singapore,81374,61839,19535
2016-05-01,BNY Mellon,CitiBank Singapore,82995,69322,13673
2016-06-01,BNY Mellon,CitiBank Singapore,88699,67719,20980
2016-07-01,BNY Mellon,CitiBank Singapore,88323,68512,19811
2016-08-01,BNY Mellon,CitiBank Singapore,82813,64337,18476
2016-09-01,BNY Mellon,CitiBank Singapore,98589,52511,46078
2016-10-01,BNY Mellon,CitiBank Singapore,97618,53167,44451
2016-11-01,BNY Mellon,CitiBank Singapore,96761,53219,43542
2016-12-01,BNY Mellon,CitiBank Singapore,91493,54112,37381
2017-01-01,BNY Mellon,CitiBank Singapore,96338,58716,37622
2017-02-01,BNY Mellon,CitiBank Singapore,99797,56545,43252
2017-03-01,BNY Mellon,CitiBank Singapore,92975,58255,34720
2017-04-01,BNY Mellon,CitiBank Singapore,91687,55535,36152
2017-05-01,BNY Mellon,CitiBank Singapore,93177,55896,37281
2017-06-01,BNY Mellon,CitiBank Singapore,99392,56849,42543
2017-07-01,BNY Mellon,CitiBank Singapore,105998,54611,51387
2017-08-01,BNY Mellon,CitiBank Singapore,108515,54451,54064
2017-09-01,BNY Mellon,CitiBank Singapore,108439,59521,48918
2017-10-01,BNY Mellon,CitiBank Singapore,109474,56786,52688
2017-11-01,BNY Mellon,CitiBank Singapore,102117,52374,49743
2017-12-01,BNY Mellon,CitiBank Singapore,108619,59514,49105
2018-01-01,BNY Mellon,CitiBank Singapore,101633,59744,41889
2018-02-01,BNY Mellon,CitiBank Singapore,108184,52573,55611
2018-03-01,BNY Mellon,CitiBank Singapore,101971,54186,47785
2018-04-01,BNY Mellon,CitiBank Singapore,104529,54955,49574
2010-01-01,BNY Mellon,CitiBank HongKong,13147,99236,-86089
2010-02-01,BNY Mellon,CitiBank HongKong,18569,98382,-79813
2010-03-01,BNY Mellon,CitiBank HongKong,13137,95815,-82678
2010-04-01,BNY Mellon,CitiBank HongKong,17834,94997,-77163
2010-05-01,BNY Mellon,CitiBank HongKong,16417,91139,-74722
2010-06-01,BNY Mellon,CitiBank HongKong,16315,99222,-82907
2010-07-01,BNY Mellon,CitiBank HongKong,17347,96336,-78989
2010-08-01,BNY Mellon,CitiBank HongKong,12672,97852,-85180
2010-09-01,BNY Mellon,CitiBank HongKong,13423,93571,-80148
2010-10-01,BNY Mellon,CitiBank HongKong,18432,91817,-73385
2010-11-01,BNY Mellon,CitiBank HongKong,22974,96793,-73819
2010-12-01,BNY Mellon,CitiBank HongKong,25272,91878,-66606
2011-01-01,BNY Mellon,CitiBank HongKong,28496,93692,-65196
2011-02-01,BNY Mellon,CitiBank HongKong,25471,92285,-66814
2011-03-01,BNY Mellon,CitiBank HongKong,29197,92429,-63232
2011-04-01,BNY Mellon,CitiBank HongKong,21495,96333,-74838
2011-05-01,BNY Mellon,CitiBank HongKong,22315,95814,-73499
2011-06-01,BNY Mellon,CitiBank HongKong,29564,98769,-69205
2011-07-01,BNY Mellon,CitiBank HongKong,24837,95378,-70541
2011-08-01,BNY Mellon,CitiBank HongKong,28778,91744,-62966
2011-09-01,BNY Mellon,CitiBank HongKong,37368,82221,-44853
2011-10-01,BNY Mellon,CitiBank HongKong,32331,82853,-50522
2011-11-01,BNY Mellon,CitiBank HongKong,39462,86447,-46985
2011-12-01,BNY Mellon,CitiBank HongKong,34618,89358,-54740
2012-01-01,BNY Mellon,CitiBank HongKong,38439,87456,-49017
2012-02-01,BNY Mellon,CitiBank HongKong,31393,81526,-50133
2012-03-01,BNY Mellon,CitiBank HongKong,38375,86668,-48293
2012-04-01,BNY Mellon,CitiBank HongKong,32671,83646,-50975
2012-05-01,BNY Mellon,CitiBank HongKong,32435,88892,-56457
2012-06-01,BNY Mellon,CitiBank HongKong,38337,85231,-46894
2012-07-01,BNY Mellon,CitiBank HongKong,45259,89647,-44388
2012-08-01,BNY Mellon,CitiBank HongKong,48554,89711,-41157
2012-09-01,BNY Mellon,CitiBank HongKong,47271,89126,-41855
2012-10-01,BNY Mellon,CitiBank HongKong,42343,85269,-42926
2012-11-01,BNY Mellon,CitiBank HongKong,41734,88481,-46747
2012-12-01,BNY Mellon,CitiBank HongKong,45558,84881,-39323
2013-01-01,BNY Mellon,CitiBank HongKong,48386,87992,-39606
2013-02-01,BNY Mellon,CitiBank HongKong,43864,87383,-43519
2013-03-01,BNY Mellon,CitiBank HongKong,44349,87326,-42977
2013-04-01,BNY Mellon,CitiBank HongKong,47256,82915,-35659
2013-05-01,BNY Mellon,CitiBank HongKong,58218,72632,-14414
2013-06-01,BNY Mellon,CitiBank HongKong,51648,78158,-26510
2013-07-01,BNY Mellon,CitiBank HongKong,56338,74738,-18400
2013-08-01,BNY Mellon,CitiBank HongKong,52384,71126,-18742
2013-09-01,BNY Mellon,CitiBank HongKong,56795,77293,-20498
2013-10-01,BNY Mellon,CitiBank HongKong,55183,78145,-22962
2013-11-01,BNY Mellon,CitiBank HongKong,55352,72777,-17425
2013-12-01,BNY Mellon,CitiBank HongKong,59283,77469,-18186
2014-01-01,BNY Mellon,CitiBank HongKong,53852,71221,-17369
2014-02-01,BNY Mellon,CitiBank HongKong,57858,73118,-15260
2014-03-01,BNY Mellon,CitiBank HongKong,69887,79845,-9958
2014-04-01,BNY Mellon,CitiBank HongKong,67267,71995,-4728
2014-05-01,BNY Mellon,CitiBank HongKong,64578,71288,-6710
2014-06-01,BNY Mellon,CitiBank HongKong,63182,75973,-12791
2014-07-01,BNY Mellon,CitiBank HongKong,63175,76562,-13387
2014-08-01,BNY Mellon,CitiBank HongKong,67531,73254,-5723
2014-09-01,BNY Mellon,CitiBank HongKong,65268,76638,-11370
2014-10-01,BNY Mellon,CitiBank HongKong,69475,75475,-6000
2014-11-01,BNY Mellon,CitiBank HongKong,68647,76934,-8287
2014-12-01,BNY Mellon,CitiBank HongKong,63545,75892,-12347
2015-01-01,BNY Mellon,CitiBank HongKong,72564,64169,8395
2015-02-01,BNY Mellon,CitiBank HongKong,79327,65577,13750
2015-03-01,BNY Mellon,CitiBank HongKong,76295,63858,12437
2015-04-01,BNY Mellon,CitiBank HongKong,79447,62869,16578
2015-05-01,BNY Mellon,CitiBank HongKong,71462,61688,9774
2015-06-01,BNY Mellon,CitiBank HongKong,72213,62554,9659
2015-07-01,BNY Mellon,CitiBank HongKong,74351,67351,7000
2015-08-01,BNY Mellon,CitiBank HongKong,71551,65188,6363
2015-09-01,BNY Mellon,CitiBank HongKong,74471,66146,8325
2015-10-01,BNY Mellon,CitiBank HongKong,78678,62215,16463
2015-11-01,BNY Mellon,CitiBank HongKong,88489,61333,27156
2015-12-01,BNY Mellon,CitiBank HongKong,85756,63494,22262
2016-01-01,BNY Mellon,CitiBank HongKong,83312,64288,19024
2016-02-01,BNY Mellon,CitiBank HongKong,81972,67195,14777
2016-03-01,BNY Mellon,CitiBank HongKong,84185,68832,15353
2016-04-01,BNY Mellon,CitiBank HongKong,86241,61323,24918
2016-05-01,BNY Mellon,CitiBank HongKong,86212,62276,23936
2016-06-01,BNY Mellon,CitiBank HongKong,88877,69486,19391
2016-07-01,BNY Mellon,CitiBank HongKong,85441,64354,21087
2016-08-01,BNY Mellon,CitiBank HongKong,84145,69875,14270
2016-09-01,BNY Mellon,CitiBank HongKong,92491,53734,38757
2016-10-01,BNY Mellon,CitiBank HongKong,94751,52391,42360
2016-11-01,BNY Mellon,CitiBank HongKong,93493,53183,40310
2016-12-01,BNY Mellon,CitiBank HongKong,95973,56717,39256
2017-01-01,BNY Mellon,CitiBank HongKong,98891,57517,41374
2017-02-01,BNY Mellon,CitiBank HongKong,95284,53569,41715
2017-03-01,BNY Mellon,CitiBank HongKong,97698,58745,38953
2017-04-01,BNY Mellon,CitiBank HongKong,98489,58645,39844
2017-05-01,BNY Mellon,CitiBank HongKong,93853,52113,41740
2017-06-01,BNY Mellon,CitiBank HongKong,91223,52553,38670
2017-07-01,BNY Mellon,CitiBank HongKong,107237,56299,50938
2017-08-01,BNY Mellon,CitiBank HongKong,104953,54988,49965
2017-09-01,BNY Mellon,CitiBank HongKong,101674,54298,47376
2017-10-01,BNY Mellon,CitiBank HongKong,103846,59232,44614
2017-11-01,BNY Mellon,CitiBank HongKong,103174,58174,45000
2017-12-01,BNY Mellon,CitiBank HongKong,105369,52842,52527
2018-01-01,BNY Mellon,CitiBank HongKong,104847,59617,45230
2018-02-01,BNY Mellon,CitiBank HongKong,103557,57854,45703
2018-03-01,BNY Mellon,CitiBank HongKong,104428,58251,46177
2018-04-01,BNY Mellon,CitiBank HongKong,103154,51934,51220
2010-01-01,Goldman Sachs,CitiBank New York,16654,97339,-80685
2010-02-01,Goldman Sachs,CitiBank New York,15887,96392,-80505
2010-03-01,Goldman Sachs,CitiBank New York,16612,93665,-77053
2010-04-01,Goldman Sachs,CitiBank New York,17956,96443,-78487
2010-05-01,Goldman Sachs,CitiBank New York,18932,97862,-78930
2010-06-01,Goldman Sachs,CitiBank New York,17326,94477,-77151
2010-07-01,Goldman Sachs,CitiBank New York,11583,94758,-83175
2010-08-01,Goldman Sachs,CitiBank New York,13638,92689,-79051
2010-09-01,Goldman Sachs,CitiBank New York,14958,99428,-84470
2010-10-01,Goldman Sachs,CitiBank New York,15982,97283,-81301
2010-11-01,Goldman Sachs,CitiBank New York,29166,98672,-69506
2010-12-01,Goldman Sachs,CitiBank New York,23373,93517,-70144
2011-01-01,Goldman Sachs,CitiBank New York,25695,97872,-72177
2011-02-01,Goldman Sachs,CitiBank New York,23458,97941,-74483
2011-03-01,Goldman Sachs,CitiBank New York,25777,92138,-66361
2011-04-01,Goldman Sachs,CitiBank New York,22268,96425,-74157
2011-05-01,Goldman Sachs,CitiBank New York,27435,91863,-64428
2011-06-01,Goldman Sachs,CitiBank New York,23758,95311,-71553
2011-07-01,Goldman Sachs,CitiBank New York,27519,97619,-70100
2011-08-01,Goldman Sachs,CitiBank New York,23839,99915,-76076
2011-09-01,Goldman Sachs,CitiBank New York,36347,83555,-47208
2011-10-01,Goldman Sachs,CitiBank New York,39879,84829,-44950
2011-11-01,Goldman Sachs,CitiBank New York,32871,83491,-50620
2011-12-01,Goldman Sachs,CitiBank New York,38785,87557,-48772
2012-01-01,Goldman Sachs,CitiBank New York,32112,82681,-50569
2012-02-01,Goldman Sachs,CitiBank New York,35227,88252,-53025
2012-03-01,Goldman Sachs,CitiBank New York,33594,84332,-50738
2012-04-01,Goldman Sachs,CitiBank New York,32311,87999,-55688
2012-05-01,Goldman Sachs,CitiBank New York,33932,86572,-52640
2012-06-01,Goldman Sachs,CitiBank New York,38844,89925,-51081
2012-07-01,Goldman Sachs,CitiBank New York,47287,83714,-36427
2012-08-01,Goldman Sachs,CitiBank New York,42517,88324,-45807
2012-09-01,Goldman Sachs,CitiBank New York,44223,81487,-37264
2012-10-01,Goldman Sachs,CitiBank New York,44177,84427,-40250
2012-11-01,Goldman Sachs,CitiBank New York,45615,83225,-37610
2012-12-01,Goldman Sachs,CitiBank New York,43383,83998,-40615
2013-01-01,Goldman Sachs,CitiBank New York,43393,89863,-46470
2013-02-01,Goldman Sachs,CitiBank New York,42411,81355,-38944
2013-03-01,Goldman Sachs,CitiBank New York,42884,83651,-40767
2013-04-01,Goldman Sachs,CitiBank New York,42635,84886,-42251
2013-05-01,Goldman Sachs,CitiBank New York,56477,71487,-15010
2013-06-01,Goldman Sachs,CitiBank New York,57157,72976,-15819
2013-07-01,Goldman Sachs,CitiBank New York,56459,78628,-22169
2013-08-01,Goldman Sachs,CitiBank New York,55562,74131,-18569
2013-09-01,Goldman Sachs,CitiBank New York,52615,72556,-19941
2013-10-01,Goldman Sachs,CitiBank New York,55629,77186,-21557
2013-11-01,Goldman Sachs,CitiBank New York,54823,71794,-16971
2013-12-01,Goldman Sachs,CitiBank New York,54397,72575,-18178
2014-01-01,Goldman Sachs,CitiBank New York,56367,73627,-17260
2014-02-01,Goldman Sachs,CitiBank New York,58121,73513,-15392
2014-03-01,Goldman Sachs,CitiBank New York,66273,75836,-9563
2014-04-01,Goldman Sachs,CitiBank New York,61693,79284,-17591
2014-05-01,Goldman Sachs,CitiBank New York,67414,78399,-10985
2014-06-01,Goldman Sachs,CitiBank New York,64934,76162,-11228
2014-07-01,Goldman Sachs,CitiBank New York,63733,73677,-9944
2014-08-01,Goldman Sachs,CitiBank New York,68494,76788,-8294
2014-09-01,Goldman Sachs,CitiBank New York,63387,74595,-11208
2014-10-01,Goldman Sachs,CitiBank New York,69482,78293,-8811
2014-11-01,Goldman Sachs,CitiBank New York,63387,71594,-8207
2014-12-01,Goldman Sachs,CitiBank New York,69993,74518,-4525
2015-01-01,Goldman Sachs,CitiBank New York,77644,62823,14821
2015-02-01,Goldman Sachs,CitiBank New York,78715,61273,17442
2015-03-01,Goldman Sachs,CitiBank New York,71412,62854,8558
2015-04-01,Goldman Sachs,CitiBank New York,78332,66456,11876
2015-05-01,Goldman Sachs,CitiBank New York,79343,66292,13051
2015-06-01,Goldman Sachs,CitiBank New York,77216,65672,11544
2015-07-01,Goldman Sachs,CitiBank New York,77672,69736,7936
2015-08-01,Goldman Sachs,CitiBank New York,77963,69711,8252
2015-09-01,Goldman Sachs,CitiBank New York,76918,64697,12221
2015-10-01,Goldman Sachs,CitiBank New York,75551,69372,6179
2015-11-01,Goldman Sachs,CitiBank New York,83443,65669,17774
2015-12-01,Goldman Sachs,CitiBank New York,83919,65155,18764
2016-01-01,Goldman Sachs,CitiBank New York,85676,66866,18810
2016-02-01,Goldman Sachs,CitiBank New York,89399,63522,25877
2016-03-01,Goldman Sachs,CitiBank New York,83197,68336,14861
2016-04-01,Goldman Sachs,CitiBank New York,88397,68963,19434
2016-05-01,Goldman Sachs,CitiBank New York,82166,68597,13569
2016-06-01,Goldman Sachs,CitiBank New York,88896,68831,20065
2016-07-01,Goldman Sachs,CitiBank New York,88452,66579,21873
2016-08-01,Goldman Sachs,CitiBank New York,83541,66869,16672
2016-09-01,Goldman Sachs,CitiBank New York,91321,56642,34679
2016-10-01,Goldman Sachs,CitiBank New York,91268,56729,34539
2016-11-01,Goldman Sachs,CitiBank New York,93948,55163,38785
2016-12-01,Goldman Sachs,CitiBank New York,98264,58973,39291
2017-01-01,Goldman Sachs,CitiBank New York,98852,54891,43961
2017-02-01,Goldman Sachs,CitiBank New York,99323,56823,42500
2017-03-01,Goldman Sachs,CitiBank New York,91821,54212,37609
2017-04-01,Goldman Sachs,CitiBank New York,99574,53538,46036
2017-05-01,Goldman Sachs,CitiBank New York,98886,52121,46765
2017-06-01,Goldman Sachs,CitiBank New York,95386,58813,36573
2017-07-01,Goldman Sachs,CitiBank New York,103818,54268,49550
2017-08-01,Goldman Sachs,CitiBank New York,108686,54341,54345
2017-09-01,Goldman Sachs,CitiBank New York,106969,56838,50131
2017-10-01,Goldman Sachs,CitiBank New York,105942,52598,53344
2017-11-01,Goldman Sachs,CitiBank New York,102847,59157,43690
2017-12-01,Goldman Sachs,CitiBank New York,104728,52955,51773
2018-01-01,Goldman Sachs,CitiBank New York,101919,52586,49333
2018-02-01,Goldman Sachs,CitiBank New York,109811,54467,55344
2018-03-01,Goldman Sachs,CitiBank New York,108183,54183,54000
2018-04-01,Goldman Sachs,CitiBank New York,109823,57556,52267
2010-01-01,Goldman Sachs,CitiBank London,15352,96788,-81436
2010-02-01,Goldman Sachs,CitiBank London,18555,97367,-78812
2010-03-01,Goldman Sachs,CitiBank London,16577,94353,-77776
2010-04-01,Goldman Sachs,CitiBank London,14626,96393,-81767
2010-05-01,Goldman Sachs,CitiBank London,19493,94212,-74719
2010-06-01,Goldman Sachs,CitiBank London,17648,99455,-81807
2010-07-01,Goldman Sachs,CitiBank London,13368,91614,-78246
2010-08-01,Goldman Sachs,CitiBank London,17966,91199,-73233
2010-09-01,Goldman Sachs,CitiBank London,14289,96159,-81870
2010-10-01,Goldman Sachs,CitiBank London,15744,95178,-79434
2010-11-01,Goldman Sachs,CitiBank London,24931,97988,-73057
2010-12-01,Goldman Sachs,CitiBank London,24167,97631,-73464
2011-01-01,Goldman Sachs,CitiBank London,28418,99797,-71379
2011-02-01,Goldman Sachs,CitiBank London,24223,94224,-70001
2011-03-01,Goldman Sachs,CitiBank London,26681,95914,-69233
2011-04-01,Goldman Sachs,CitiBank London,25759,91443,-65684
2011-05-01,Goldman Sachs,CitiBank London,28813,93273,-64460
2011-06-01,Goldman Sachs,CitiBank London,22947,96916,-73969
2011-07-01,Goldman Sachs,CitiBank London,27479,97916,-70437
2011-08-01,Goldman Sachs,CitiBank London,21833,94297,-72464
2011-09-01,Goldman Sachs,CitiBank London,38495,84987,-46492
2011-10-01,Goldman Sachs,CitiBank London,39281,89752,-50471
2011-11-01,Goldman Sachs,CitiBank London,35162,83649,-48487
2011-12-01,Goldman Sachs,CitiBank London,31555,84628,-53073
2012-01-01,Goldman Sachs,CitiBank London,39732,85993,-46261
2012-02-01,Goldman Sachs,CitiBank London,35974,81378,-45404
2012-03-01,Goldman Sachs,CitiBank London,34896,81616,-46720
2012-04-01,Goldman Sachs,CitiBank London,33937,86842,-52905
2012-05-01,Goldman Sachs,CitiBank London,35124,88827,-53703
2012-06-01,Goldman Sachs,CitiBank London,39641,81759,-42118
2012-07-01,Goldman Sachs,CitiBank London,41732,82437,-40705
2012-08-01,Goldman Sachs,CitiBank London,42236,85435,-43199
2012-09-01,Goldman Sachs,CitiBank London,48332,87237,-38905
2012-10-01,Goldman Sachs,CitiBank London,42275,83255,-40980
2012-11-01,Goldman Sachs,CitiBank London,44377,82419,-38042
2012-12-01,Goldman Sachs,CitiBank London,43743,83449,-39706
2013-01-01,Goldman Sachs,CitiBank London,48773,86244,-37471
2013-02-01,Goldman Sachs,CitiBank London,41195,89272,-48077
2013-03-01,Goldman Sachs,CitiBank London,43637,87128,-43491
2013-04-01,Goldman Sachs,CitiBank London,49654,86916,-37262
2013-05-01,Goldman Sachs,CitiBank London,53781,75183,-21402
2013-06-01,Goldman Sachs,CitiBank London,59531,76762,-17231
2013-07-01,Goldman Sachs,CitiBank London,52189,75285,-23096
2013-08-01,Goldman Sachs,CitiBank London,59132,71355,-12223
2013-09-01,Goldman Sachs,CitiBank London,56431,74898,-18467
2013-10-01,Goldman Sachs,CitiBank London,54516,78836,-24320
2013-11-01,Goldman Sachs,CitiBank London,58991,72242,-13251
2013-12-01,Goldman Sachs,CitiBank London,53335,79285,-25950
2014-01-01,Goldman Sachs,CitiBank London,53283,74445,-21162
2014-02-01,Goldman Sachs,CitiBank London,54462,72128,-17666
2014-03-01,Goldman Sachs,CitiBank London,68666,75742,-7076
2014-04-01,Goldman Sachs,CitiBank London,62749,73942,-11193
2014-05-01,Goldman Sachs,CitiBank London,63358,76823,-13465
2014-06-01,Goldman Sachs,CitiBank London,69522,73611,-4089
2014-07-01,Goldman Sachs,CitiBank London,67293,72412,-5119
2014-08-01,Goldman Sachs,CitiBank London,65445,71479,-6034
2014-09-01,Goldman Sachs,CitiBank London,67319,71948,-4629
2014-10-01,Goldman Sachs,CitiBank London,69159,76551,-7392
2014-11-01,Goldman Sachs,CitiBank London,66738,76454,-9716
2014-12-01,Goldman Sachs,CitiBank London,64174,72523,-8349
2015-01-01,Goldman Sachs,CitiBank London,71289,64984,6305
2015-02-01,Goldman Sachs,CitiBank London,71743,68971,2772
2015-03-01,Goldman Sachs,CitiBank London,77952,65276,12676
2015-04-01,Goldman Sachs,CitiBank London,73276,65351,7925
2015-05-01,Goldman Sachs,CitiBank London,78976,65593,13383
2015-06-01,Goldman Sachs,CitiBank London,79389,68468,10921
2015-07-01,Goldman Sachs,CitiBank London,76539,65828,10711
2015-08-01,Goldman Sachs,CitiBank London,73838,67138,6700
2015-09-01,Goldman Sachs,CitiBank London,71712,62195,9517
2015-10-01,Goldman Sachs,CitiBank London,72361,61857,10504
2015-11-01,Goldman Sachs,CitiBank London,89949,64524,25425
2015-12-01,Goldman Sachs,CitiBank London,83694,66127,17567
2016-01-01,Goldman Sachs,CitiBank London,87355,62598,24757
2016-02-01,Goldman Sachs,CitiBank London,82196,67724,14472
2016-03-01,Goldman Sachs,CitiBank London,82134,66141,15993
2016-04-01,Goldman Sachs,CitiBank London,83267,68773,14494
2016-05-01,Goldman Sachs,CitiBank London,81672,62696,18976
2016-06-01,Goldman Sachs,CitiBank London,86782,67187,19595
2016-07-01,Goldman Sachs,CitiBank London,87591,69584,18007
2016-08-01,Goldman Sachs,CitiBank London,87857,61872,25985
2016-09-01,Goldman Sachs,CitiBank London,98569,53476,45093
2016-10-01,Goldman Sachs,CitiBank London,98686,55371,43315
2016-11-01,Goldman Sachs,CitiBank London,98384,57465,40919
2016-12-01,Goldman Sachs,CitiBank London,97396,54272,43124
2017-01-01,Goldman Sachs,CitiBank London,93394,55269,38125
2017-02-01,Goldman Sachs,CitiBank London,95914,57316,38598
2017-03-01,Goldman Sachs,CitiBank London,94889,54841,40048
2017-04-01,Goldman Sachs,CitiBank London,99639,51511,48128
2017-05-01,Goldman Sachs,CitiBank London,92367,56474,35893
2017-06-01,Goldman Sachs,CitiBank London,95946,56637,39309
2017-07-01,Goldman Sachs,CitiBank London,107619,53253,54366
2017-08-01,Goldman Sachs,CitiBank London,106458,58516,47942
2017-09-01,Goldman Sachs,CitiBank London,108521,53383,55138
2017-10-01,Goldman Sachs,CitiBank London,104521,53353,51168
2017-11-01,Goldman Sachs,CitiBank London,108885,52394,56491
2017-12-01,Goldman Sachs,CitiBank London,106188,57451,48737
2018-01-01,Goldman Sachs,CitiBank London,101178,57412,43766
2018-02-01,Goldman Sachs,CitiBank London,106511,55456,51055
2018-03-01,Goldman Sachs,CitiBank London,106888,59742,47146
2018-04-01,Goldman Sachs,CitiBank London,108784,52925,55859
2010-01-01,Goldman Sachs,CitiBank Pune,16944,96491,-79547
2010-02-01,Goldman Sachs,CitiBank Pune,11931,96285,-84354
2010-03-01,Goldman Sachs,CitiBank Pune,13745,97454,-83709
2010-04-01,Goldman Sachs,CitiBank Pune,19713,94944,-75231
2010-05-01,Goldman Sachs,CitiBank Pune,15993,99612,-83619
2010-06-01,Goldman Sachs,CitiBank Pune,16325,96183,-79858
2010-07-01,Goldman Sachs,CitiBank Pune,12465,99993,-87528
2010-08-01,Goldman Sachs,CitiBank Pune,18394,92558,-74164
2010-09-01,Goldman Sachs,CitiBank Pune,13672,95613,-81941
2010-10-01,Goldman Sachs,CitiBank Pune,12634,97682,-85048
2010-11-01,Goldman Sachs,CitiBank Pune,29171,94319,-65148
2010-12-01,Goldman Sachs,CitiBank Pune,27448,99578,-72130
2011-01-01,Goldman Sachs,CitiBank Pune,26552,97622,-71070
2011-02-01,Goldman Sachs,CitiBank Pune,25465,94983,-69518
2011-03-01,Goldman Sachs,CitiBank Pune,22825,93993,-71168
2011-04-01,Goldman Sachs,CitiBank Pune,29333,93275,-63942
2011-05-01,Goldman Sachs,CitiBank Pune,22935,99143,-76208
2011-06-01,Goldman Sachs,CitiBank Pune,28439,92728,-64289
2011-07-01,Goldman Sachs,CitiBank Pune,29762,93922,-64160
2011-08-01,Goldman Sachs,CitiBank Pune,26633,97481,-70848
2011-09-01,Goldman Sachs,CitiBank Pune,37781,84976,-47195
2011-10-01,Goldman Sachs,CitiBank Pune,35217,86491,-51274
2011-11-01,Goldman Sachs,CitiBank Pune,36937,89964,-53027
2011-12-01,Goldman Sachs,CitiBank Pune,38719,81598,-42879
2012-01-01,Goldman Sachs,CitiBank Pune,38583,81647,-43064
2012-02-01,Goldman Sachs,CitiBank Pune,37243,85638,-48395
2012-03-01,Goldman Sachs,CitiBank Pune,33592,89646,-56054
2012-04-01,Goldman Sachs,CitiBank Pune,36788,85598,-48810
2012-05-01,Goldman Sachs,CitiBank Pune,34627,88353,-53726
2012-06-01,Goldman Sachs,CitiBank Pune,39924,81184,-41260
2012-07-01,Goldman Sachs,CitiBank Pune,48384,88612,-40228
2012-08-01,Goldman Sachs,CitiBank Pune,44735,85585,-40850
2012-09-01,Goldman Sachs,CitiBank Pune,43624,88721,-45097
2012-10-01,Goldman Sachs,CitiBank Pune,42644,82452,-39808
2012-11-01,Goldman Sachs,CitiBank Pune,49674,81149,-31475
2012-12-01,Goldman Sachs,CitiBank Pune,46896,83878,-36982
2013-01-01,Goldman Sachs,CitiBank Pune,41111,84227,-43116
2013-02-01,Goldman Sachs,CitiBank Pune,49363,85339,-35976
2013-03-01,Goldman Sachs,CitiBank Pune,48621,87981,-39360
2013-04-01,Goldman Sachs,CitiBank Pune,48586,83544,-34958
2013-05-01,Goldman Sachs,CitiBank Pune,56231,75528,-19297
2013-06-01,Goldman Sachs,CitiBank Pune,51817,74182,-22365
2013-07-01,Goldman Sachs,CitiBank Pune,59839,71533,-11694
2013-08-01,Goldman Sachs,CitiBank Pune,51681,74642,-22961
2013-09-01,Goldman Sachs,CitiBank Pune,55763,75362,-19599
2013-10-01,Goldman Sachs,CitiBank Pune,56511,72768,-16257
2013-11-01,Goldman Sachs,CitiBank Pune,53252,78744,-25492
2013-12-01,Goldman Sachs,CitiBank Pune,58173,74487,-16314
2014-01-01,Goldman Sachs,CitiBank Pune,56154,76774,-20620
2014-02-01,Goldman Sachs,CitiBank Pune,58389,73437,-15048
2014-03-01,Goldman Sachs,CitiBank Pune,67121,77341,-10220
2014-04-01,Goldman Sachs,CitiBank Pune,66521,78196,-11675
2014-05-01,Goldman Sachs,CitiBank Pune,64728,77183,-12455
2014-06-01,Goldman Sachs,CitiBank Pune,66855,74152,-7297
2014-07-01,Goldman Sachs,CitiBank Pune,62729,78724,-15995
2014-08-01,Goldman Sachs,CitiBank Pune,63641,73237,-9596
2014-09-01,Goldman Sachs,CitiBank Pune,67938,78169,-10231
2014-10-01,Goldman Sachs,CitiBank Pune,65145,79984,-14839
2014-11-01,Goldman Sachs,CitiBank Pune,65964,78776,-12812
2014-12-01,Goldman Sachs,CitiBank Pune,67189,72459,-5270
2015-01-01,Goldman Sachs,CitiBank Pune,71481,65687,5794
2015-02-01,Goldman Sachs,CitiBank Pune,74698,62225,12473
2015-03-01,Goldman Sachs,CitiBank Pune,76636,67656,8980
2015-04-01,Goldman Sachs,CitiBank Pune,79734,63695,16039
2015-05-01,Goldman Sachs,CitiBank Pune,78867,63657,15210
2015-06-01,Goldman Sachs,CitiBank Pune,72455,62777,9678
2015-07-01,Goldman Sachs,CitiBank Pune,73357,63666,9691
2015-08-01,Goldman Sachs,CitiBank Pune,76449,61566,14883
2015-09-01,Goldman Sachs,CitiBank Pune,79453,63117,16336
2015-10-01,Goldman Sachs,CitiBank Pune,72686,66946,5740
2015-11-01,Goldman Sachs,CitiBank Pune,88911,64942,23969
2015-12-01,Goldman Sachs,CitiBank Pune,83821,65842,17979
2016-01-01,Goldman Sachs,CitiBank Pune,86735,61641,25094
2016-02-01,Goldman Sachs,CitiBank Pune,84877,66826,18051
2016-03-01,Goldman Sachs,CitiBank Pune,85422,61777,23645
2016-04-01,Goldman Sachs,CitiBank Pune,81343,62573,18770
2016-05-01,Goldman Sachs,CitiBank Pune,83791,68689,15102
2016-06-01,Goldman Sachs,CitiBank Pune,85577,68877,16700
2016-07-01,Goldman Sachs,CitiBank Pune,86785,62362,24423
2016-08-01,Goldman Sachs,CitiBank Pune,86961,66852,20109
2016-09-01,Goldman Sachs,CitiBank Pune,97564,55124,42440
2016-10-01,Goldman Sachs,CitiBank Pune,99697,52855,46842
2016-11-01,Goldman Sachs,CitiBank Pune,97559,51545,46014
2016-12-01,Goldman Sachs,CitiBank Pune,95684,59898,35786
2017-01-01,Goldman Sachs,CitiBank Pune,98778,58993,39785
2017-02-01,Goldman Sachs,CitiBank Pune,98263,57261,41002
2017-03-01,Goldman Sachs,CitiBank Pune,92836,51294,41542
2017-04-01,Goldman Sachs,CitiBank Pune,99571,59249,40322
2017-05-01,Goldman Sachs,CitiBank Pune,94537,54463,40074
2017-06-01,Goldman Sachs,CitiBank Pune,94292,54648,39644
2017-07-01,Goldman Sachs,CitiBank Pune,107622,51823,55799
2017-08-01,Goldman Sachs,CitiBank Pune,107117,54426,52691
2017-09-01,Goldman Sachs,CitiBank Pune,106496,59513,46983
2017-10-01,Goldman Sachs,CitiBank Pune,106611,54699,51912
2017-11-01,Goldman Sachs,CitiBank Pune,101936,51561,50375
2017-12-01,Goldman Sachs,CitiBank Pune,101552,52839,48713
2018-01-01,Goldman Sachs,CitiBank Pune,101932,57875,44057
2018-02-01,Goldman Sachs,CitiBank Pune,102215,55765,46450
2018-03-01,Goldman Sachs,CitiBank Pune,104241,51649,52592
2018-04-01,Goldman Sachs,CitiBank Pune,107561,58468,49093
2010-01-01,Goldman Sachs,CitiBank Singapore,19727,97317,-77590
2010-02-01,Goldman Sachs,CitiBank Singapore,18341,93776,-75435
2010-03-01,Goldman Sachs,CitiBank Singapore,18165,92772,-74607
2010-04-01,Goldman Sachs,CitiBank Singapore,11592,95624,-84032
2010-05-01,Goldman Sachs,CitiBank Singapore,18451,92695,-74244
2010-06-01,Goldman Sachs,CitiBank Singapore,13783,98652,-84869
2010-07-01,Goldman Sachs,CitiBank Singapore,15924,93455,-77531
2010-08-01,Goldman Sachs,CitiBank Singapore,16941,98442,-81501
2010-09-01,Goldman Sachs,CitiBank Singapore,11657,99268,-87611
2010-10-01,Goldman Sachs,CitiBank Singapore,15212,95789,-80577
2010-11-01,Goldman Sachs,CitiBank Singapore,22761,99868,-77107
2010-12-01,Goldman Sachs,CitiBank Singapore,29294,94611,-65317
2011-01-01,Goldman Sachs,CitiBank Singapore,27861,93945,-66084
2011-02-01,Goldman Sachs,CitiBank Singapore,23636,95823,-72187
2011-03-01,Goldman Sachs,CitiBank Singapore,27797,96145,-68348
2011-04-01,Goldman Sachs,CitiBank Singapore,27119,96249,-69130
2011-05-01,Goldman Sachs,CitiBank Singapore,28652,93545,-64893
2011-06-01,Goldman Sachs,CitiBank Singapore,23619,97967,-74348
2011-07-01,Goldman Sachs,CitiBank Singapore,21948,96771,-74823
2011-08-01,Goldman Sachs,CitiBank Singapore,25649,97747,-72098
2011-09-01,Goldman Sachs,CitiBank Singapore,34256,84878,-50622
2011-10-01,Goldman Sachs,CitiBank Singapore,35451,84274,-48823
2011-11-01,Goldman Sachs,CitiBank Singapore,38681,84971,-46290
2011-12-01,Goldman Sachs,CitiBank Singapore,34229,84419,-50190
2012-01-01,Goldman Sachs,CitiBank Singapore,36921,88815,-51894
2012-02-01,Goldman Sachs,CitiBank Singapore,36857,89254,-52397
2012-03-01,Goldman Sachs,CitiBank Singapore,33831,83118,-49287
2012-04-01,Goldman Sachs,CitiBank Singapore,35557,87157,-51600
2012-05-01,Goldman Sachs,CitiBank Singapore,31789,88235,-56446
2012-06-01,Goldman Sachs,CitiBank Singapore,31569,87544,-55975
2012-07-01,Goldman Sachs,CitiBank Singapore,45596,82452,-36856
2012-08-01,Goldman Sachs,CitiBank Singapore,49774,83283,-33509
2012-09-01,Goldman Sachs,CitiBank Singapore,48633,82453,-33820
2012-10-01,Goldman Sachs,CitiBank Singapore,49479,88148,-38669
2012-11-01,Goldman Sachs,CitiBank Singapore,47519,81522,-34003
2012-12-01,Goldman Sachs,CitiBank Singapore,48654,87183,-38529
2013-01-01,Goldman Sachs,CitiBank Singapore,42679,84416,-41737
2013-02-01,Goldman Sachs,CitiBank Singapore,41481,89755,-48274
2013-03-01,Goldman Sachs,CitiBank Singapore,43388,87484,-44096
2013-04-01,Goldman Sachs,CitiBank Singapore,43437,86798,-43361
2013-05-01,Goldman Sachs,CitiBank Singapore,54496,71742,-17246
2013-06-01,Goldman Sachs,CitiBank Singapore,53683,79679,-25996
2013-07-01,Goldman Sachs,CitiBank Singapore,57628,78552,-20924
2013-08-01,Goldman Sachs,CitiBank Singapore,59376,79282,-19906
2013-09-01,Goldman Sachs,CitiBank Singapore,59235,71728,-12493
2013-10-01,Goldman Sachs,CitiBank Singapore,59257,73728,-14471
2013-11-01,Goldman Sachs,CitiBank Singapore,57327,73521,-16194
2013-12-01,Goldman Sachs,CitiBank Singapore,55238,77578,-22340
2014-01-01,Goldman Sachs,CitiBank Singapore,57189,71487,-14298
2014-02-01,Goldman Sachs,CitiBank Singapore,53952,79959,-26007
2014-03-01,Goldman Sachs,CitiBank Singapore,61838,78916,-17078
2014-04-01,Goldman Sachs,CitiBank Singapore,68252,76518,-8266
2014-05-01,Goldman Sachs,CitiBank Singapore,64783,72569,-7786
2014-06-01,Goldman Sachs,CitiBank Singapore,61499,73269,-11770
2014-07-01,Goldman Sachs,CitiBank Singapore,68116,79925,-11809
2014-08-01,Goldman Sachs,CitiBank Singapore,61985,79158,-17173
2014-09-01,Goldman Sachs,CitiBank Singapore,67128,74791,-7663
2014-10-01,Goldman Sachs,CitiBank Singapore,66346,75877,-9531
2014-11-01,Goldman Sachs,CitiBank Singapore,65223,75227,-10004
2014-12-01,Goldman Sachs,CitiBank Singapore,67885,76151,-8266
2015-01-01,Goldman Sachs,CitiBank Singapore,74717,69922,4795
2015-02-01,Goldman Sachs,CitiBank Singapore,76236,63343,12893
2015-03-01,Goldman Sachs,CitiBank Singapore,77678,66277,11401
2015-04-01,Goldman Sachs,CitiBank Singapore,75723,64965,10758
2015-05-01,Goldman Sachs,CitiBank Singapore,75825,67874,7951
2015-06-01,Goldman Sachs,CitiBank Singapore,73576,68878,4698
2015-07-01,Goldman Sachs,CitiBank Singapore,78672,67415,11257
2015-08-01,Goldman Sachs,CitiBank Singapore,72751,63997,8754
2015-09-01,Goldman Sachs,CitiBank Singapore,72343,61989,10354
2015-10-01,Goldman Sachs,CitiBank Singapore,73629,61375,12254
2015-11-01,Goldman Sachs,CitiBank Singapore,82131,69637,12494
2015-12-01,Goldman Sachs,CitiBank Singapore,86571,65914,20657
2016-01-01,Goldman Sachs,CitiBank Singapore,84464,66544,17920
2016-02-01,Goldman Sachs,CitiBank Singapore,86929,64616,22313
2016-03-01,Goldman Sachs,CitiBank Singapore,83468,61958,21510
2016-04-01,Goldman Sachs,CitiBank Singapore,82926,68885,14041
2016-05-01,Goldman Sachs,CitiBank Singapore,88671,64865,23806
2016-06-01,Goldman Sachs,CitiBank Singapore,81471,69316,12155
2016-07-01,Goldman Sachs,CitiBank Singapore,84696,61675,23021
2016-08-01,Goldman Sachs,CitiBank Singapore,88748,66347,22401
2016-09-01,Goldman Sachs,CitiBank Singapore,92436,51325,41111
2016-10-01,Goldman Sachs,CitiBank Singapore,98942,55641,43301
2016-11-01,Goldman Sachs,CitiBank Singapore,99383,54449,44934
2016-12-01,Goldman Sachs,CitiBank Singapore,92491,52982,39509
2017-01-01,Goldman Sachs,CitiBank Singapore,92197,54395,37802
2017-02-01,Goldman Sachs,CitiBank Singapore,93361,59565,33796
2017-03-01,Goldman Sachs,CitiBank Singapore,94658,52732,41926
2017-04-01,Goldman Sachs,CitiBank Singapore,93277,51542,41735
2017-05-01,Goldman Sachs,CitiBank Singapore,94786,53178,41608
2017-06-01,Goldman Sachs,CitiBank Singapore,98198,51994,46204
2017-07-01,Goldman Sachs,CitiBank Singapore,109833,51918,57915
2017-08-01,Goldman Sachs,CitiBank Singapore,101178,52484,48694
2017-09-01,Goldman Sachs,CitiBank Singapore,108858,53199,55659
2017-10-01,Goldman Sachs,CitiBank Singapore,101811,58716,43095
2017-11-01,Goldman Sachs,CitiBank Singapore,102128,58883,43245
2017-12-01,Goldman Sachs,CitiBank Singapore,109936,54763,55173
2018-01-01,Goldman Sachs,CitiBank Singapore,101332,51565,49767
2018-02-01,Goldman Sachs,CitiBank Singapore,109983,51482,58501
2018-03-01,Goldman Sachs,CitiBank Singapore,102375,52666,49709
2018-04-01,Goldman Sachs,CitiBank Singapore,106351,52823,53528
2010-01-01,Goldman Sachs,CitiBank HongKong,13488,96411,-82923
2010-02-01,Goldman Sachs,CitiBank HongKong,13624,96741,-83117
2010-03-01,Goldman Sachs,CitiBank HongKong,16957,91273,-74316
2010-04-01,Goldman Sachs,CitiBank HongKong,18655,91913,-73258
2010-05-01,Goldman Sachs,CitiBank HongKong,13834,96598,-82764
2010-06-01,Goldman Sachs,CitiBank HongKong,18921,96782,-77861
2010-07-01,Goldman Sachs,CitiBank HongKong,15148,94925,-79777
2010-08-01,Goldman Sachs,CitiBank HongKong,13663,94317,-80654
2010-09-01,Goldman Sachs,CitiBank HongKong,13251,91612,-78361
2010-10-01,Goldman Sachs,CitiBank HongKong,19699,95272,-75573
2010-11-01,Goldman Sachs,CitiBank HongKong,22562,94269,-71707
2010-12-01,Goldman Sachs,CitiBank HongKong,27859,99182,-71323
2011-01-01,Goldman Sachs,CitiBank HongKong,21655,92129,-70474
2011-02-01,Goldman Sachs,CitiBank HongKong,29617,93669,-64052
2011-03-01,Goldman Sachs,CitiBank HongKong,26129,95396,-69267
2011-04-01,Goldman Sachs,CitiBank HongKong,28426,94676,-66250
2011-05-01,Goldman Sachs,CitiBank HongKong,21378,97316,-75938
2011-06-01,Goldman Sachs,CitiBank HongKong,22636,95639,-73003
2011-07-01,Goldman Sachs,CitiBank HongKong,21332,94856,-73524
2011-08-01,Goldman Sachs,CitiBank HongKong,24189,99778,-75589
2011-09-01,Goldman Sachs,CitiBank HongKong,37268,86116,-48848
2011-10-01,Goldman Sachs,CitiBank HongKong,34876,81688,-46812
2011-11-01,Goldman Sachs,CitiBank HongKong,39523,84583,-45060
2011-12-01,Goldman Sachs,CitiBank HongKong,33269,85218,-51949
2012-01-01,Goldman Sachs,CitiBank HongKong,39922,81954,-42032
2012-02-01,Goldman Sachs,CitiBank HongKong,32314,85197,-52883
2012-03-01,Goldman Sachs,CitiBank HongKong,35696,85958,-50262
2012-04-01,Goldman Sachs,CitiBank HongKong,39858,84517,-44659
2012-05-01,Goldman Sachs,CitiBank HongKong,33847,88276,-54429
2012-06-01,Goldman Sachs,CitiBank HongKong,38515,82974,-44459
2012-07-01,Goldman Sachs,CitiBank HongKong,46528,87666,-41138
2012-08-01,Goldman Sachs,CitiBank HongKong,41882,86167,-44285
2012-09-01,Goldman Sachs,CitiBank HongKong,41987,87992,-46005
2012-10-01,Goldman Sachs,CitiBank HongKong,42584,81899,-39315
2012-11-01,Goldman Sachs,CitiBank HongKong,46894,83264,-36370
2012-12-01,Goldman Sachs,CitiBank HongKong,42814,85219,-42405
2013-01-01,Goldman Sachs,CitiBank HongKong,43469,81392,-37923
2013-02-01,Goldman Sachs,CitiBank HongKong,41527,88422,-46895
2013-03-01,Goldman Sachs,CitiBank HongKong,47224,85519,-38295
2013-04-01,Goldman Sachs,CitiBank HongKong,43887,86799,-42912
2013-05-01,Goldman Sachs,CitiBank HongKong,52444,74942,-22498
2013-06-01,Goldman Sachs,CitiBank HongKong,58414,72795,-14381
2013-07-01,Goldman Sachs,CitiBank HongKong,52531,72449,-19918
2013-08-01,Goldman Sachs,CitiBank HongKong,51764,71612,-19848
2013-09-01,Goldman Sachs,CitiBank HongKong,52455,72594,-20139
2013-10-01,Goldman Sachs,CitiBank HongKong,56191,76537,-20346
2013-11-01,Goldman Sachs,CitiBank HongKong,51451,78877,-27426
2013-12-01,Goldman Sachs,CitiBank HongKong,56992,72249,-15257
2014-01-01,Goldman Sachs,CitiBank HongKong,57531,76496,-18965
2014-02-01,Goldman Sachs,CitiBank HongKong,51389,73763,-22374
2014-03-01,Goldman Sachs,CitiBank HongKong,65356,78564,-13208
2014-04-01,Goldman Sachs,CitiBank HongKong,69313,74698,-5385
2014-05-01,Goldman Sachs,CitiBank HongKong,68965,76934,-7969
2014-06-01,Goldman Sachs,CitiBank HongKong,61445,78668,-17223
2014-07-01,Goldman Sachs,CitiBank HongKong,63685,72188,-8503
2014-08-01,Goldman Sachs,CitiBank HongKong,61876,72396,-10520
2014-09-01,Goldman Sachs,CitiBank HongKong,65148,73343,-8195
2014-10-01,Goldman Sachs,CitiBank HongKong,68372,76574,-8202
2014-11-01,Goldman Sachs,CitiBank HongKong,67625,76489,-8864
2014-12-01,Goldman Sachs,CitiBank HongKong,67259,71113,-3854
2015-01-01,Goldman Sachs,CitiBank HongKong,71714,68265,3449
2015-02-01,Goldman Sachs,CitiBank HongKong,73878,65233,8645
2015-03-01,Goldman Sachs,CitiBank HongKong,76166,66552,9614
2015-04-01,Goldman Sachs,CitiBank HongKong,79276,65861,13415
2015-05-01,Goldman Sachs,CitiBank HongKong,75536,69474,6062
2015-06-01,Goldman Sachs,CitiBank HongKong,73245,68167,5078
2015-07-01,Goldman Sachs,CitiBank HongKong,74848,62256,12592
2015-08-01,Goldman Sachs,CitiBank HongKong,78898,61534,17364
2015-09-01,Goldman Sachs,CitiBank HongKong,73151,66388,6763
2015-10-01,Goldman Sachs,CitiBank HongKong,75977,68561,7416
2015-11-01,Goldman Sachs,CitiBank HongKong,86177,67345,18832
2015-12-01,Goldman Sachs,CitiBank HongKong,83382,67724,15658
2016-01-01,Goldman Sachs,CitiBank HongKong,88835,64466,24369
2016-02-01,Goldman Sachs,CitiBank HongKong,87426,66824,20602
2016-03-01,Goldman Sachs,CitiBank HongKong,82252,65775,16477
2016-04-01,Goldman Sachs,CitiBank HongKong,89219,65515,23704
2016-05-01,Goldman Sachs,CitiBank HongKong,84739,64595,20144
2016-06-01,Goldman Sachs,CitiBank HongKong,87368,63768,23600
2016-07-01,Goldman Sachs,CitiBank HongKong,85522,64856,20666
2016-08-01,Goldman Sachs,CitiBank HongKong,87595,66277,21318
2016-09-01,Goldman Sachs,CitiBank HongKong,98681,59812,38869
2016-10-01,Goldman Sachs,CitiBank HongKong,92549,57855,34694
2016-11-01,Goldman Sachs,CitiBank HongKong,94756,51943,42813
2016-12-01,Goldman Sachs,CitiBank HongKong,95122,55657,39465
2017-01-01,Goldman Sachs,CitiBank HongKong,96614,54594,42020
2017-02-01,Goldman Sachs,CitiBank HongKong,96522,52882,43640
2017-03-01,Goldman Sachs,CitiBank HongKong,93918,58576,35342
2017-04-01,Goldman Sachs,CitiBank HongKong,95911,54711,41200
2017-05-01,Goldman Sachs,CitiBank HongKong,95758,57327,38431
2017-06-01,Goldman Sachs,CitiBank HongKong,99369,51216,48153
2017-07-01,Goldman Sachs,CitiBank HongKong,105669,59256,46413
2017-08-01,Goldman Sachs,CitiBank HongKong,101766,52374,49392
2017-09-01,Goldman Sachs,CitiBank HongKong,101575,57516,44059
2017-10-01,Goldman Sachs,CitiBank HongKong,108752,57458,51294
2017-11-01,Goldman Sachs,CitiBank HongKong,102552,54943,47609
2017-12-01,Goldman Sachs,CitiBank HongKong,106498,56463,50035
2018-01-01,Goldman Sachs,CitiBank HongKong,104634,58839,45795
2018-02-01,Goldman Sachs,CitiBank HongKong,101769,58553,43216
2018-03-01,Goldman Sachs,CitiBank HongKong,102894,59362,43532
2018-04-01,Goldman Sachs,CitiBank HongKong,106691,58243,48448
2010-01-01,Deutsche Bank,CitiBank New York,15881,97589,-81708
2010-02-01,Deutsche Bank,CitiBank New York,15658,93681,-78023
2010-03-01,Deutsche Bank,CitiBank New York,11326,94851,-83525
2010-04-01,Deutsche Bank,CitiBank New York,16988,96288,-79300
2010-05-01,Deutsche Bank,CitiBank New York,14469,94137,-79668
2010-06-01,Deutsche Bank,CitiBank New York,15466,94365,-78899
2010-07-01,Deutsche Bank,CitiBank New York,14114,96861,-82747
2010-08-01,Deutsche Bank,CitiBank New York,15472,96237,-80765
2010-09-01,Deutsche Bank,CitiBank New York,16496,91826,-75330
2010-10-01,Deutsche Bank,CitiBank New York,18388,91539,-73151
2010-11-01,Deutsche Bank,CitiBank New York,29672,92578,-62906
2010-12-01,Deutsche Bank,CitiBank New York,24576,96984,-72408
2011-01-01,Deutsche Bank,CitiBank New York,28266,99142,-70876
2011-02-01,Deutsche Bank,CitiBank New York,26923,93138,-66215
2011-03-01,Deutsche Bank,CitiBank New York,22686,93234,-70548
2011-04-01,Deutsche Bank,CitiBank New York,23283,93174,-69891
2011-05-01,Deutsche Bank,CitiBank New York,24657,99714,-75057
2011-06-01,Deutsche Bank,CitiBank New York,25649,92243,-66594
2011-07-01,Deutsche Bank,CitiBank New York,21819,95357,-73538
2011-08-01,Deutsche Bank,CitiBank New York,29865,91662,-61797
2011-09-01,Deutsche Bank,CitiBank New York,35977,82174,-46197
2011-10-01,Deutsche Bank,CitiBank New York,38844,84338,-45494
2011-11-01,Deutsche Bank,CitiBank New York,31799,88713,-56914
2011-12-01,Deutsche Bank,CitiBank New York,35485,81614,-46129
2012-01-01,Deutsche Bank,CitiBank New York,32675,81867,-49192
2012-02-01,Deutsche Bank,CitiBank New York,37583,88552,-50969
2012-03-01,Deutsche Bank,CitiBank New York,35532,86347,-50815
2012-04-01,Deutsche Bank,CitiBank New York,36919,89333,-52414
2012-05-01,Deutsche Bank,CitiBank New York,37138,89686,-52548
2012-06-01,Deutsche Bank,CitiBank New York,36694,88334,-51640
2012-07-01,Deutsche Bank,CitiBank New York,48957,84466,-35509
2012-08-01,Deutsche Bank,CitiBank New York,47228,83578,-36350
2012-09-01,Deutsche Bank,CitiBank New York,43158,86977,-43819
2012-10-01,Deutsche Bank,CitiBank New York,41265,88533,-47268
2012-11-01,Deutsche Bank,CitiBank New York,43624,82743,-39119
2012-12-01,Deutsche Bank,CitiBank New York,47111,88238,-41127
2013-01-01,Deutsche Bank,CitiBank New York,41518,88969,-47451
2013-02-01,Deutsche Bank,CitiBank New York,48386,88511,-40125
2013-03-01,Deutsche Bank,CitiBank New York,48772,87893,-39121
2013-04-01,Deutsche Bank,CitiBank New York,47587,84932,-37345
2013-05-01,Deutsche Bank,CitiBank New York,59483,72619,-13136
2013-06-01,Deutsche Bank,CitiBank New York,53196,76138,-22942
2013-07-01,Deutsche Bank,CitiBank New York,52718,72767,-20049
2013-08-01,Deutsche Bank,CitiBank New York,53873,76833,-22960
2013-09-01,Deutsche Bank,CitiBank New York,51434,77791,-26357
2013-10-01,Deutsche Bank,CitiBank New York,55398,79971,-24573
2013-11-01,Deutsche Bank,CitiBank New York,59197,75645,-16448
2013-12-01,Deutsche Bank,CitiBank New York,56741,76841,-20100
2014-01-01,Deutsche Bank,CitiBank New York,51877,71254,-19377
2014-02-01,Deutsche Bank,CitiBank New York,56828,75882,-19054
2014-03-01,Deutsche Bank,CitiBank New York,63156,71728,-8572
2014-04-01,Deutsche Bank,CitiBank New York,69447,75999,-6552
2014-05-01,Deutsche Bank,CitiBank New York,63455,74881,-11426
2014-06-01,Deutsche Bank,CitiBank New York,65556,75865,-10309
2014-07-01,Deutsche Bank,CitiBank New York,68735,71453,-2718
2014-08-01,Deutsche Bank,CitiBank New York,65416,74524,-9108
2014-09-01,Deutsche Bank,CitiBank New York,62475,76121,-13646
2014-10-01,Deutsche Bank,CitiBank New York,62881,74827,-11946
2014-11-01,Deutsche Bank,CitiBank New York,61663,78119,-16456
2014-12-01,Deutsche Bank,CitiBank New York,65971,77925,-11954
2015-01-01,Deutsche Bank,CitiBank New York,72196,63794,8402
2015-02-01,Deutsche Bank,CitiBank New York,76229,63378,12851
2015-03-01,Deutsche Bank,CitiBank New York,72588,61161,11427
2015-04-01,Deutsche Bank,CitiBank New York,78193,64598,13595
2015-05-01,Deutsche Bank,CitiBank New York,75867,69553,6314
2015-06-01,Deutsche Bank,CitiBank New York,78979,61268,17711
2015-07-01,Deutsche Bank,CitiBank New York,77148,64222,12926
2015-08-01,Deutsche Bank,CitiBank New York,77146,68276,8870
2015-09-01,Deutsche Bank,CitiBank New York,72879,63251,9628
2015-10-01,Deutsche Bank,CitiBank New York,71712,69447,2265
2015-11-01,Deutsche Bank,CitiBank New York,86617,67487,19130
2015-12-01,Deutsche Bank,CitiBank New York,86534,66947,19587
2016-01-01,Deutsche Bank,CitiBank New York,84892,68432,16460
2016-02-01,Deutsche Bank,CitiBank New York,88132,68254,19878
2016-03-01,Deutsche Bank,CitiBank New York,85472,64423,21049
2016-04-01,Deutsche Bank,CitiBank New York,81844,62223,19621
2016-05-01,Deutsche Bank,CitiBank New York,86539,63598,22941
2016-06-01,Deutsche Bank,CitiBank New York,85718,69823,15895
2016-07-01,Deutsche Bank,CitiBank New York,81747,65344,16403
2016-08-01,Deutsche Bank,CitiBank New York,87951,65537,22414
2016-09-01,Deutsche Bank,CitiBank New York,99175,57314,41861
2016-10-01,Deutsche Bank,CitiBank New York,93415,58554,34861
2016-11-01,Deutsche Bank,CitiBank New York,92687,52286,40401
2016-12-01,Deutsche Bank,CitiBank New York,91176,55749,35427
2017-01-01,Deutsche Bank,CitiBank New York,93431,51373,42058
2017-02-01,Deutsche Bank,CitiBank New York,97996,59182,38814
2017-03-01,Deutsche Bank,CitiBank New York,95343,56875,38468
2017-04-01,Deutsche Bank,CitiBank New York,91812,52516,39296
2017-05-01,Deutsche Bank,CitiBank New York,95645,57924,37721
2017-06-01,Deutsche Bank,CitiBank New York,97525,54461,43064
2017-07-01,Deutsche Bank,CitiBank New York,102441,56919,45522
2017-08-01,Deutsche Bank,CitiBank New York,101161,51651,49510
2017-09-01,Deutsche Bank,CitiBank New York,105217,59142,46075
2017-10-01,Deutsche Bank,CitiBank New York,108134,51711,56423
2017-11-01,Deutsche Bank,CitiBank New York,103891,53883,50008
2017-12-01,Deutsche Bank,CitiBank New York,105867,55934,49933
2018-01-01,Deutsche Bank,CitiBank New York,104739,59172,45567
2018-02-01,Deutsche Bank,CitiBank New York,103673,51281,52392
2018-03-01,Deutsche Bank,CitiBank New York,109331,52888,56443
2018-04-01,Deutsche Bank,CitiBank New York,104129,53836,50293
2010-01-01,Deutsche Bank,CitiBank London,17692,91237,-73545
2010-02-01,Deutsche Bank,CitiBank London,14258,94816,-80558
2010-03-01,Deutsche Bank,CitiBank London,16377,92958,-76581
2010-04-01,Deutsche Bank,CitiBank London,17519,95698,-78179
2010-05-01,Deutsche Bank,CitiBank London,14563,99355,-84792
2010-06-01,Deutsche Bank,CitiBank London,14572,92366,-77794
2010-07-01,Deutsche Bank,CitiBank London,14687,94284,-79597
2010-08-01,Deutsche Bank,CitiBank London,14289,98817,-84528
2010-09-01,Deutsche Bank,CitiBank London,11245,93371,-82126
2010-10-01,Deutsche Bank,CitiBank London,18669,94445,-75776
2010-11-01,Deutsche Bank,CitiBank London,22483,92241,-69758
2010-12-01,Deutsche Bank,CitiBank London,23737,94569,-70832
2011-01-01,Deutsche Bank,CitiBank London,29186,94721,-65535
2011-02-01,Deutsche Bank,CitiBank London,28175,96334,-68159
2011-03-01,Deutsche Bank,CitiBank London,28716,98255,-69539
2011-04-01,Deutsche Bank,CitiBank London,26799,96142,-69343
2011-05-01,Deutsche Bank,CitiBank London,24348,97135,-72787
2011-06-01,Deutsche Bank,CitiBank London,28529,91366,-62837
2011-07-01,Deutsche Bank,CitiBank London,29426,96938,-67512
2011-08-01,Deutsche Bank,CitiBank London,28725,95923,-67198
2011-09-01,Deutsche Bank,CitiBank London,34284,87947,-53663
2011-10-01,Deutsche Bank,CitiBank London,34928,83479,-48551
2011-11-01,Deutsche Bank,CitiBank London,35849,84373,-48524
2011-12-01,Deutsche Bank,CitiBank London,35447,89134,-53687
2012-01-01,Deutsche Bank,CitiBank London,31369,85937,-54568
2012-02-01,Deutsche Bank,CitiBank London,39826,82686,-42860
2012-03-01,Deutsche Bank,CitiBank London,38995,87382,-48387
2012-04-01,Deutsche Bank,CitiBank London,34443,86419,-51976
2012-05-01,Deutsche Bank,CitiBank London,37832,84737,-46905
2012-06-01,Deutsche Bank,CitiBank London,36111,87854,-51743
2012-07-01,Deutsche Bank,CitiBank London,43637,89418,-45781
2012-08-01,Deutsche Bank,CitiBank London,48966,86191,-37225
2012-09-01,Deutsche Bank,CitiBank London,43327,86447,-43120
2012-10-01,Deutsche Bank,CitiBank London,49937,81741,-31804
2012-11-01,Deutsche Bank,CitiBank London,48625,83968,-35343
2012-12-01,Deutsche Bank,CitiBank London,48124,81215,-33091
2013-01-01,Deutsche Bank,CitiBank London,42645,87729,-45084
2013-02-01,Deutsche Bank,CitiBank London,47111,89475,-42364
2013-03-01,Deutsche Bank,CitiBank London,43531,89284,-45753
2013-04-01,Deutsche Bank,CitiBank London,45492,86636,-41144
2013-05-01,Deutsche Bank,CitiBank London,53374,71231,-17857
2013-06-01,Deutsche Bank,CitiBank London,52444,79929,-27485
2013-07-01,Deutsche Bank,CitiBank London,51227,75471,-24244
2013-08-01,Deutsche Bank,CitiBank London,59179,75329,-16150
2013-09-01,Deutsche Bank,CitiBank London,57492,73773,-16281
2013-10-01,Deutsche Bank,CitiBank London,59444,72727,-13283
2013-11-01,Deutsche Bank,CitiBank London,51667,73796,-22129
2013-12-01,Deutsche Bank,CitiBank London,59594,73522,-13928
2014-01-01,Deutsche Bank,CitiBank London,58494,72392,-13898
2014-02-01,Deutsche Bank,CitiBank London,55196,76493,-21297
2014-03-01,Deutsche Bank,CitiBank London,65296,74497,-9201
2014-04-01,Deutsche Bank,CitiBank London,61768,77676,-15908
2014-05-01,Deutsche Bank,CitiBank London,64584,73579,-8995
2014-06-01,Deutsche Bank,CitiBank London,66485,71232,-4747
2014-07-01,Deutsche Bank,CitiBank London,68393,73567,-5174
2014-08-01,Deutsche Bank,CitiBank London,68637,71547,-2910
2014-09-01,Deutsche Bank,CitiBank London,68641,78833,-10192
2014-10-01,Deutsche Bank,CitiBank London,69523,72975,-3452
2014-11-01,Deutsche Bank,CitiBank London,63436,77397,-13961
2014-12-01,Deutsche Bank,CitiBank London,64122,76888,-12766
2015-01-01,Deutsche Bank,CitiBank London,73567,67619,5948
2015-02-01,Deutsche Bank,CitiBank London,75467,65369,10098
2015-03-01,Deutsche Bank,CitiBank London,79976,62263,17713
2015-04-01,Deutsche Bank,CitiBank London,78351,62379,15972
2015-05-01,Deutsche Bank,CitiBank London,78934,67837,11097
2015-06-01,Deutsche Bank,CitiBank London,73821,63528,10293
2015-07-01,Deutsche Bank,CitiBank London,79313,63597,15716
2015-08-01,Deutsche Bank,CitiBank London,75979,67497,8482
2015-09-01,Deutsche Bank,CitiBank London,73855,68956,4899
2015-10-01,Deutsche Bank,CitiBank London,71533,63517,8016
2015-11-01,Deutsche Bank,CitiBank London,87933,63535,24398
2015-12-01,Deutsche Bank,CitiBank London,86212,64669,21543
2016-01-01,Deutsche Bank,CitiBank London,87331,69554,17777
2016-02-01,Deutsche Bank,CitiBank London,85417,68897,16520
2016-03-01,Deutsche Bank,CitiBank London,87122,68794,18328
2016-04-01,Deutsche Bank,CitiBank London,81432,62411,19021
2016-05-01,Deutsche Bank,CitiBank London,88229,66564,21665
2016-06-01,Deutsche Bank,CitiBank London,85167,66626,18541
2016-07-01,Deutsche Bank,CitiBank London,87471,66564,20907
2016-08-01,Deutsche Bank,CitiBank London,83942,64967,18975
2016-09-01,Deutsche Bank,CitiBank London,91851,56991,34860
2016-10-01,Deutsche Bank,CitiBank London,93682,54299,39383
2016-11-01,Deutsche Bank,CitiBank London,91319,56976,34343
2016-12-01,Deutsche Bank,CitiBank London,97668,59998,37670
2017-01-01,Deutsche Bank,CitiBank London,92835,53733,39102
2017-02-01,Deutsche Bank,CitiBank London,96458,58235,38223
2017-03-01,Deutsche Bank,CitiBank London,95957,55463,40494
2017-04-01,Deutsche Bank,CitiBank London,98224,53996,44228
2017-05-01,Deutsche Bank,CitiBank London,91586,53262,38324
2017-06-01,Deutsche Bank,CitiBank London,91899,52773,39126
2017-07-01,Deutsche Bank,CitiBank London,105772,54911,50861
2017-08-01,Deutsche Bank,CitiBank London,102549,58354,44195
2017-09-01,Deutsche Bank,CitiBank London,104664,53937,50727
2017-10-01,Deutsche Bank,CitiBank London,104757,52191,52566
2017-11-01,Deutsche Bank,CitiBank London,108241,53542,54699
2017-12-01,Deutsche Bank,CitiBank London,109323,55244,54079
2018-01-01,Deutsche Bank,CitiBank London,108925,53597,55328
2018-02-01,Deutsche Bank,CitiBank London,109314,53227,56087
2018-03-01,Deutsche Bank,CitiBank London,107366,52793,54573
2018-04-01,Deutsche Bank,CitiBank London,106215,59192,47023
2010-01-01,Deutsche Bank,CitiBank Pune,12371,99883,-87512
2010-02-01,Deutsche Bank,CitiBank Pune,16456,96736,-80280
2010-03-01,Deutsche Bank,CitiBank Pune,11851,95154,-83303
2010-04-01,Deutsche Bank,CitiBank Pune,13539,99179,-85640
2010-05-01,Deutsche Bank,CitiBank Pune,12945,92783,-79838
2010-06-01,Deutsche Bank,CitiBank Pune,18281,91297,-73016
2010-07-01,Deutsche Bank,CitiBank Pune,12445,91833,-79388
2010-08-01,Deutsche Bank,CitiBank Pune,19228,97859,-78631
2010-09-01,Deutsche Bank,CitiBank Pune,17171,94994,-77823
2010-10-01,Deutsche Bank,CitiBank Pune,19192,99768,-80576
2010-11-01,Deutsche Bank,CitiBank Pune,24821,93323,-68502
2010-12-01,Deutsche Bank,CitiBank Pune,26269,99527,-73258
2011-01-01,Deutsche Bank,CitiBank Pune,24516,98863,-74347
2011-02-01,Deutsche Bank,CitiBank Pune,21583,91446,-69863
2011-03-01,Deutsche Bank,CitiBank Pune,26999,93415,-66416
2011-04-01,Deutsche Bank,CitiBank Pune,27827,93566,-65739
2011-05-01,Deutsche Bank,CitiBank Pune,29281,91425,-62144
2011-06-01,Deutsche Bank,CitiBank Pune,23293,96836,-73543
2011-07-01,Deutsche Bank,CitiBank Pune,25368,91354,-65986
2011-08-01,Deutsche Bank,CitiBank Pune,22613,97198,-74585
2011-09-01,Deutsche Bank,CitiBank Pune,31726,87113,-55387
2011-10-01,Deutsche Bank,CitiBank Pune,36121,83914,-47793
2011-11-01,Deutsche Bank,CitiBank Pune,38382,84298,-45916
2011-12-01,Deutsche Bank,CitiBank Pune,32928,83572,-50644
2012-01-01,Deutsche Bank,CitiBank Pune,38789,84626,-45837
2012-02-01,Deutsche Bank,CitiBank Pune,37665,86113,-48448
2012-03-01,Deutsche Bank,CitiBank Pune,37926,81672,-43746
2012-04-01,Deutsche Bank,CitiBank Pune,31174,81849,-50675
2012-05-01,Deutsche Bank,CitiBank Pune,39793,89274,-49481
2012-06-01,Deutsche Bank,CitiBank Pune,37119,83735,-46616
2012-07-01,Deutsche Bank,CitiBank Pune,48935,81831,-32896
2012-08-01,Deutsche Bank,CitiBank Pune,49737,86862,-37125
2012-09-01,Deutsche Bank,CitiBank Pune,44185,81391,-37206
2012-10-01,Deutsche Bank,CitiBank Pune,41746,84913,-43167
2012-11-01,Deutsche Bank,CitiBank Pune,48625,88931,-40306
2012-12-01,Deutsche Bank,CitiBank Pune,44824,87871,-43047
2013-01-01,Deutsche Bank,CitiBank Pune,48938,81831,-32893
2013-02-01,Deutsche Bank,CitiBank Pune,41891,84441,-42550
2013-03-01,Deutsche Bank,CitiBank Pune,41315,88929,-47614
2013-04-01,Deutsche Bank,CitiBank Pune,41572,85592,-44020
2013-05-01,Deutsche Bank,CitiBank Pune,58541,73865,-15324
2013-06-01,Deutsche Bank,CitiBank Pune,56792,71899,-15107
2013-07-01,Deutsche Bank,CitiBank Pune,57553,74635,-17082
2013-08-01,Deutsche Bank,CitiBank Pune,55298,71372,-16074
2013-09-01,Deutsche Bank,CitiBank Pune,55935,73325,-17390
2013-10-01,Deutsche Bank,CitiBank Pune,57954,74639,-16685
2013-11-01,Deutsche Bank,CitiBank Pune,56274,78733,-22459
2013-12-01,Deutsche Bank,CitiBank Pune,59365,76774,-17409
2014-01-01,Deutsche Bank,CitiBank Pune,51825,76625,-24800
2014-02-01,Deutsche Bank,CitiBank Pune,59962,72758,-12796
2014-03-01,Deutsche Bank,CitiBank Pune,69686,74969,-5283
2014-04-01,Deutsche Bank,CitiBank Pune,64164,71133,-6969
2014-05-01,Deutsche Bank,CitiBank Pune,66469,76892,-10423
2014-06-01,Deutsche Bank,CitiBank Pune,68869,74472,-5603
2014-07-01,Deutsche Bank,CitiBank Pune,64145,75869,-11724
2014-08-01,Deutsche Bank,CitiBank Pune,62321,72638,-10317
2014-09-01,Deutsche Bank,CitiBank Pune,67853,74954,-7101
2014-10-01,Deutsche Bank,CitiBank Pune,67565,74651,-7086
2014-11-01,Deutsche Bank,CitiBank Pune,66952,73471,-6519
2014-12-01,Deutsche Bank,CitiBank Pune,64835,79197,-14362
2015-01-01,Deutsche Bank,CitiBank Pune,74463,63529,10934
2015-02-01,Deutsche Bank,CitiBank Pune,76618,66876,9742
2015-03-01,Deutsche Bank,CitiBank Pune,73645,64633,9012
2015-04-01,Deutsche Bank,CitiBank Pune,73177,63136,10041
2015-05-01,Deutsche Bank,CitiBank Pune,79739,65818,13921
2015-06-01,Deutsche Bank,CitiBank Pune,74741,69341,5400
2015-07-01,Deutsche Bank,CitiBank Pune,77138,64133,13005
2015-08-01,Deutsche Bank,CitiBank Pune,75417,65879,9538
2015-09-01,Deutsche Bank,CitiBank Pune,74157,62122,12035
2015-10-01,Deutsche Bank,CitiBank Pune,74878,61491,13387
2015-11-01,Deutsche Bank,CitiBank Pune,87937,66436,21501
2015-12-01,Deutsche Bank,CitiBank Pune,84285,68156,16129
2016-01-01,Deutsche Bank,CitiBank Pune,89444,69314,20130
2016-02-01,Deutsche Bank,CitiBank Pune,82453,65947,16506
2016-03-01,Deutsche Bank,CitiBank Pune,84428,67527,16901
2016-04-01,Deutsche Bank,CitiBank Pune,89487,66483,23004
2016-05-01,Deutsche Bank,CitiBank Pune,88329,69442,18887
2016-06-01,Deutsche Bank,CitiBank Pune,81621,69171,12450
2016-07-01,Deutsche Bank,CitiBank Pune,81684,68965,12719
2016-08-01,Deutsche Bank,CitiBank Pune,83944,63479,20465
2016-09-01,Deutsche Bank,CitiBank Pune,92267,58475,33792
2016-10-01,Deutsche Bank,CitiBank Pune,98458,59137,39321
2016-11-01,Deutsche Bank,CitiBank Pune,97373,55587,41786
2016-12-01,Deutsche Bank,CitiBank Pune,98872,55628,43244
2017-01-01,Deutsche Bank,CitiBank Pune,99371,58682,40689
2017-02-01,Deutsche Bank,CitiBank Pune,96174,57419,38755
2017-03-01,Deutsche Bank,CitiBank Pune,99129,54534,44595
2017-04-01,Deutsche Bank,CitiBank Pune,95986,57647,38339
2017-05-01,Deutsche Bank,CitiBank Pune,97151,55418,41733
2017-06-01,Deutsche Bank,CitiBank Pune,99858,54667,45191
2017-07-01,Deutsche Bank,CitiBank Pune,103483,51531,51952
2017-08-01,Deutsche Bank,CitiBank Pune,107521,53952,53569
2017-09-01,Deutsche Bank,CitiBank Pune,107315,56152,51163
2017-10-01,Deutsche Bank,CitiBank Pune,108334,57944,50390
2017-11-01,Deutsche Bank,CitiBank Pune,106437,53924,52513
2017-12-01,Deutsche Bank,CitiBank Pune,109829,58287,51542
2018-01-01,Deutsche Bank,CitiBank Pune,106612,52741,53871
2018-02-01,Deutsche Bank,CitiBank Pune,106126,56222,49904
2018-03-01,Deutsche Bank,CitiBank Pune,101218,51173,50045
2018-04-01,Deutsche Bank,CitiBank Pune,107867,55214,52653
2010-01-01,Deutsche Bank,CitiBank Singapore,12177,98733,-86556
2010-02-01,Deutsche Bank,CitiBank Singapore,16191,95227,-79036
2010-03-01,Deutsche Bank,CitiBank Singapore,17661,91317,-73656
2010-04-01,Deutsche Bank,CitiBank Singapore,14337,95154,-80817
2010-05-01,Deutsche Bank,CitiBank Singapore,18173,99182,-81009
2010-06-01,Deutsche Bank,CitiBank Singapore,12134,91786,-79652
2010-07-01,Deutsche Bank,CitiBank Singapore,19875,96992,-77117
2010-08-01,Deutsche Bank,CitiBank Singapore,15531,97152,-81621
2010-09-01,Deutsche Bank,CitiBank Singapore,11683,94622,-82939
2010-10-01,Deutsche Bank,CitiBank Singapore,15716,96294,-80578
2010-11-01,Deutsche Bank,CitiBank Singapore,29845,98733,-68888
2010-12-01,Deutsche Bank,CitiBank Singapore,28995,99122,-70127
2011-01-01,Deutsche Bank,CitiBank Singapore,22766,96868,-74102
2011-02-01,Deutsche Bank,CitiBank Singapore,21766,96831,-75065
2011-03-01,Deutsche Bank,CitiBank Singapore,25876,93859,-67983
2011-04-01,Deutsche Bank,CitiBank Singapore,26565,99649,-73084
2011-05-01,Deutsche Bank,CitiBank Singapore,22744,92628,-69884
2011-06-01,Deutsche Bank,CitiBank Singapore,23892,95625,-71733
2011-07-01,Deutsche Bank,CitiBank Singapore,24622,91249,-66627
2011-08-01,Deutsche Bank,CitiBank Singapore,23269,91776,-68507
2011-09-01,Deutsche Bank,CitiBank Singapore,39962,85196,-45234
2011-10-01,Deutsche Bank,CitiBank Singapore,37516,83488,-45972
2011-11-01,Deutsche Bank,CitiBank Singapore,36584,85156,-48572
2011-12-01,Deutsche Bank,CitiBank Singapore,32953,81527,-48574
2012-01-01,Deutsche Bank,CitiBank Singapore,32524,82389,-49865
2012-02-01,Deutsche Bank,CitiBank Singapore,36263,84376,-48113
2012-03-01,Deutsche Bank,CitiBank Singapore,36858,84149,-47291
2012-04-01,Deutsche Bank,CitiBank Singapore,36183,85629,-49446
2012-05-01,Deutsche Bank,CitiBank Singapore,36971,81384,-44413
2012-06-01,Deutsche Bank,CitiBank Singapore,35593,86323,-50730
2012-07-01,Deutsche Bank,CitiBank Singapore,46458,85385,-38927
2012-08-01,Deutsche Bank,CitiBank Singapore,44127,85721,-41594
2012-09-01,Deutsche Bank,CitiBank Singapore,46753,87567,-40814
2012-10-01,Deutsche Bank,CitiBank Singapore,42371,85484,-43113
2012-11-01,Deutsche Bank,CitiBank Singapore,49191,81263,-32072
2012-12-01,Deutsche Bank,CitiBank Singapore,42179,83916,-41737
2013-01-01,Deutsche Bank,CitiBank Singapore,42547,82225,-39678
2013-02-01,Deutsche Bank,CitiBank Singapore,47217,86746,-39529
2013-03-01,Deutsche Bank,CitiBank Singapore,42548,88825,-46277
2013-04-01,Deutsche Bank,CitiBank Singapore,49969,81872,-31903
2013-05-01,Deutsche Bank,CitiBank Singapore,58577,74146,-15569
2013-06-01,Deutsche Bank,CitiBank Singapore,55796,72723,-16927
2013-07-01,Deutsche Bank,CitiBank Singapore,55492,74921,-19429
2013-08-01,Deutsche Bank,CitiBank Singapore,58146,72264,-14118
2013-09-01,Deutsche Bank,CitiBank Singapore,51396,72472,-21076
2013-10-01,Deutsche Bank,CitiBank Singapore,59728,78218,-18490
2013-11-01,Deutsche Bank,CitiBank Singapore,54281,79348,-25067
2013-12-01,Deutsche Bank,CitiBank Singapore,52629,73383,-20754
2014-01-01,Deutsche Bank,CitiBank Singapore,57326,71879,-14553
2014-02-01,Deutsche Bank,CitiBank Singapore,52821,75298,-22477
2014-03-01,Deutsche Bank,CitiBank Singapore,63885,73799,-9914
2014-04-01,Deutsche Bank,CitiBank Singapore,64567,73543,-8976
2014-05-01,Deutsche Bank,CitiBank Singapore,67714,75329,-7615
2014-06-01,Deutsche Bank,CitiBank Singapore,67345,79818,-12473
2014-07-01,Deutsche Bank,CitiBank Singapore,65726,76862,-11136
2014-08-01,Deutsche Bank,CitiBank Singapore,61892,74614,-12722
2014-09-01,Deutsche Bank,CitiBank Singapore,65499,78978,-13479
2014-10-01,Deutsche Bank,CitiBank Singapore,68267,76443,-8176
2014-11-01,Deutsche Bank,CitiBank Singapore,62748,75279,-12531
2014-12-01,Deutsche Bank,CitiBank Singapore,67143,77927,-10784
2015-01-01,Deutsche Bank,CitiBank Singapore,79793,68551,11242
2015-02-01,Deutsche Bank,CitiBank Singapore,72192,62575,9617
2015-03-01,Deutsche Bank,CitiBank Singapore,79877,61173,18704
2015-04-01,Deutsche Bank,CitiBank Singapore,75969,68273,7696
2015-05-01,Deutsche Bank,CitiBank Singapore,71971,67964,4007
2015-06-01,Deutsche Bank,CitiBank Singapore,79725,69951,9774
2015-07-01,Deutsche Bank,CitiBank Singapore,76138,65865,10273
2015-08-01,Deutsche Bank,CitiBank Singapore,74843,64739,10104
2015-09-01,Deutsche Bank,CitiBank Singapore,71956,66748,5208
2015-10-01,Deutsche Bank,CitiBank Singapore,71723,61122,10601
2015-11-01,Deutsche Bank,CitiBank Singapore,85315,67296,18019
2015-12-01,Deutsche Bank,CitiBank Singapore,84594,68346,16248
2016-01-01,Deutsche Bank,CitiBank Singapore,89291,69247,20044
2016-02-01,Deutsche Bank,CitiBank Singapore,81626,69239,12387
2016-03-01,Deutsche Bank,CitiBank Singapore,86274,62527,23747
2016-04-01,Deutsche Bank,CitiBank Singapore,87867,68352,19515
2016-05-01,Deutsche Bank,CitiBank Singapore,81329,61972,19357
2016-06-01,Deutsche Bank,CitiBank Singapore,88112,65592,22520
2016-07-01,Deutsche Bank,CitiBank Singapore,82146,64698,17448
2016-08-01,Deutsche Bank,CitiBank Singapore,86741,68363,18378
2016-09-01,Deutsche Bank,CitiBank Singapore,99435,54819,44616
2016-10-01,Deutsche Bank,CitiBank Singapore,99532,51439,48093
2016-11-01,Deutsche Bank,CitiBank Singapore,96928,52418,44510
2016-12-01,Deutsche Bank,CitiBank Singapore,98375,57728,40647
2017-01-01,Deutsche Bank,CitiBank Singapore,99745,51645,48100
2017-02-01,Deutsche Bank,CitiBank Singapore,97854,51635,46219
2017-03-01,Deutsche Bank,CitiBank Singapore,97277,57516,39761
2017-04-01,Deutsche Bank,CitiBank Singapore,92967,51427,41540
2017-05-01,Deutsche Bank,CitiBank Singapore,93173,53762,39411
2017-06-01,Deutsche Bank,CitiBank Singapore,97318,56558,40760
2017-07-01,Deutsche Bank,CitiBank Singapore,105723,57866,47857
2017-08-01,Deutsche Bank,CitiBank Singapore,106324,52511,53813
2017-09-01,Deutsche Bank,CitiBank Singapore,105833,57839,47994
2017-10-01,Deutsche Bank,CitiBank Singapore,106651,56433,50218
2017-11-01,Deutsche Bank,CitiBank Singapore,103787,51896,51891
2017-12-01,Deutsche Bank,CitiBank Singapore,104626,52398,52228
2018-01-01,Deutsche Bank,CitiBank Singapore,105884,53929,51955
2018-02-01,Deutsche Bank,CitiBank Singapore,107981,55997,51984
2018-03-01,Deutsche Bank,CitiBank Singapore,103916,55788,48128
2018-04-01,Deutsche Bank,CitiBank Singapore,108129,56544,51585
2010-01-01,Deutsche Bank,CitiBank HongKong,16859,96767,-79908
2010-02-01,Deutsche Bank,CitiBank HongKong,17889,99445,-81556
2010-03-01,Deutsche Bank,CitiBank HongKong,19132,99734,-80602
2010-04-01,Deutsche Bank,CitiBank HongKong,15428,93433,-78005
2010-05-01,Deutsche Bank,CitiBank HongKong,11382,96995,-85613
2010-06-01,Deutsche Bank,CitiBank HongKong,18381,99497,-81116
2010-07-01,Deutsche Bank,CitiBank HongKong,16431,96451,-80020
2010-08-01,Deutsche Bank,CitiBank HongKong,17564,93498,-75934
2010-09-01,Deutsche Bank,CitiBank HongKong,13218,93939,-80721
2010-10-01,Deutsche Bank,CitiBank HongKong,11462,99527,-88065
2010-11-01,Deutsche Bank,CitiBank HongKong,23361,95268,-71907
2010-12-01,Deutsche Bank,CitiBank HongKong,25398,97457,-72059
2011-01-01,Deutsche Bank,CitiBank HongKong,23868,93292,-69424
2011-02-01,Deutsche Bank,CitiBank HongKong,27757,92433,-64676
2011-03-01,Deutsche Bank,CitiBank HongKong,26752,92767,-66015
2011-04-01,Deutsche Bank,CitiBank HongKong,29458,92933,-63475
2011-05-01,Deutsche Bank,CitiBank HongKong,29684,94893,-65209
2011-06-01,Deutsche Bank,CitiBank HongKong,24879,93357,-68478
2011-07-01,Deutsche Bank,CitiBank HongKong,23936,94542,-70606
2011-08-01,Deutsche Bank,CitiBank HongKong,21154,94523,-73369
2011-09-01,Deutsche Bank,CitiBank HongKong,37761,84479,-46718
2011-10-01,Deutsche Bank,CitiBank HongKong,34613,84196,-49583
2011-11-01,Deutsche Bank,CitiBank HongKong,32624,86192,-53568
2011-12-01,Deutsche Bank,CitiBank HongKong,35481,86146,-50665
2012-01-01,Deutsche Bank,CitiBank HongKong,36789,84747,-47958
2012-02-01,Deutsche Bank,CitiBank HongKong,35576,86846,-51270
2012-03-01,Deutsche Bank,CitiBank HongKong,31987,85314,-53327
2012-04-01,Deutsche Bank,CitiBank HongKong,39916,87523,-47607
2012-05-01,Deutsche Bank,CitiBank HongKong,35324,82417,-47093
2012-06-01,Deutsche Bank,CitiBank HongKong,33754,86227,-52473
2012-07-01,Deutsche Bank,CitiBank HongKong,49374,84175,-34801
2012-08-01,Deutsche Bank,CitiBank HongKong,43374,85242,-41868
2012-09-01,Deutsche Bank,CitiBank HongKong,49359,89448,-40089
2012-10-01,Deutsche Bank,CitiBank HongKong,46384,83591,-37207
2012-11-01,Deutsche Bank,CitiBank HongKong,44216,89953,-45737
2012-12-01,Deutsche Bank,CitiBank HongKong,43682,86576,-42894
2013-01-01,Deutsche Bank,CitiBank HongKong,44165,87229,-43064
2013-02-01,Deutsche Bank,CitiBank HongKong,47675,88788,-41113
2013-03-01,Deutsche Bank,CitiBank HongKong,42631,85767,-43136
2013-04-01,Deutsche Bank,CitiBank HongKong,41618,85866,-44248
2013-05-01,Deutsche Bank,CitiBank HongKong,57612,72427,-14815
2013-06-01,Deutsche Bank,CitiBank HongKong,59277,72584,-13307
2013-07-01,Deutsche Bank,CitiBank HongKong,53259,72252,-18993
2013-08-01,Deutsche Bank,CitiBank HongKong,57943,78224,-20281
2013-09-01,Deutsche Bank,CitiBank HongKong,51643,76347,-24704
2013-10-01,Deutsche Bank,CitiBank HongKong,57133,74185,-17052
2013-11-01,Deutsche Bank,CitiBank HongKong,52259,71958,-19699
2013-12-01,Deutsche Bank,CitiBank HongKong,53714,76627,-22913
2014-01-01,Deutsche Bank,CitiBank HongKong,51424,74313,-22889
2014-02-01,Deutsche Bank,CitiBank HongKong,55937,71182,-15245
2014-03-01,Deutsche Bank,CitiBank HongKong,61395,76798,-15403
2014-04-01,Deutsche Bank,CitiBank HongKong,67663,77372,-9709
2014-05-01,Deutsche Bank,CitiBank HongKong,69876,75876,-6000
2014-06-01,Deutsche Bank,CitiBank HongKong,64875,75189,-10314
2014-07-01,Deutsche Bank,CitiBank HongKong,68567,74144,-5577
2014-08-01,Deutsche Bank,CitiBank HongKong,68544,77271,-8727
2014-09-01,Deutsche Bank,CitiBank HongKong,68575,75148,-6573
2014-10-01,Deutsche Bank,CitiBank HongKong,68467,72396,-3929
2014-11-01,Deutsche Bank,CitiBank HongKong,62435,73663,-11228
2014-12-01,Deutsche Bank,CitiBank HongKong,65766,71745,-5979
2015-01-01,Deutsche Bank,CitiBank HongKong,71327,66272,5055
2015-02-01,Deutsche Bank,CitiBank HongKong,79928,68291,11637
2015-03-01,Deutsche Bank,CitiBank HongKong,76397,61757,14640
2015-04-01,Deutsche Bank,CitiBank HongKong,72948,65878,7070
2015-05-01,Deutsche Bank,CitiBank HongKong,76738,68112,8626
2015-06-01,Deutsche Bank,CitiBank HongKong,73233,64585,8648
2015-07-01,Deutsche Bank,CitiBank HongKong,76475,68121,8354
2015-08-01,Deutsche Bank,CitiBank HongKong,79377,65143,14234
2015-09-01,Deutsche Bank,CitiBank HongKong,78489,66459,12030
2015-10-01,Deutsche Bank,CitiBank HongKong,71916,65237,6679
2015-11-01,Deutsche Bank,CitiBank HongKong,88212,68664,19548
2015-12-01,Deutsche Bank,CitiBank HongKong,88637,68314,20323
2016-01-01,Deutsche Bank,CitiBank HongKong,82763,67922,14841
2016-02-01,Deutsche Bank,CitiBank HongKong,84817,64265,20552
2016-03-01,Deutsche Bank,CitiBank HongKong,87364,68269,19095
2016-04-01,Deutsche Bank,CitiBank HongKong,84679,63354,21325
2016-05-01,Deutsche Bank,CitiBank HongKong,87466,63335,24131
2016-06-01,Deutsche Bank,CitiBank HongKong,82379,62452,19927
2016-07-01,Deutsche Bank,CitiBank HongKong,88882,69987,18895
2016-08-01,Deutsche Bank,CitiBank HongKong,83681,62334,21347
2016-09-01,Deutsche Bank,CitiBank HongKong,99176,52948,46228
2016-10-01,Deutsche Bank,CitiBank HongKong,97352,56926,40426
2016-11-01,Deutsche Bank,CitiBank HongKong,96254,55964,40290
2016-12-01,Deutsche Bank,CitiBank HongKong,95987,57484,38503
2017-01-01,Deutsche Bank,CitiBank HongKong,94665,52341,42324
2017-02-01,Deutsche Bank,CitiBank HongKong,96816,51543,45273
2017-03-01,Deutsche Bank,CitiBank HongKong,98463,55399,43064
2017-04-01,Deutsche Bank,CitiBank HongKong,98345,59878,38467
2017-05-01,Deutsche Bank,CitiBank HongKong,95649,51125,44524
2017-06-01,Deutsche Bank,CitiBank HongKong,91829,57597,34232
2017-07-01,Deutsche Bank,CitiBank HongKong,102964,55884,47080
2017-08-01,Deutsche Bank,CitiBank HongKong,104674,53583,51091
2017-09-01,Deutsche Bank,CitiBank HongKong,102442,55292,47150
2017-10-01,Deutsche Bank,CitiBank HongKong,107998,53914,54084
2017-11-01,Deutsche Bank,CitiBank HongKong,106654,58255,48399
2017-12-01,Deutsche Bank,CitiBank HongKong,105842,54611,51231
2018-01-01,Deutsche Bank,CitiBank HongKong,101864,52943,48921
2018-02-01,Deutsche Bank,CitiBank HongKong,104278,53421,50857
2018-03-01,Deutsche Bank,CitiBank HongKong,102159,53214,48945
2018-04-01,Deutsche Bank,CitiBank HongKong,102542,52481,50061
2010-01-01,JP Morgan,CitiBank New York,18325,93778,-75453
2010-02-01,JP Morgan,CitiBank New York,19732,98411,-78679
2010-03-01,JP Morgan,CitiBank New York,16911,99192,-82281
2010-04-01,JP Morgan,CitiBank New York,12999,96362,-83363
2010-05-01,JP Morgan,CitiBank New York,18193,94446,-76253
2010-06-01,JP Morgan,CitiBank New York,19285,96913,-77628
2010-07-01,JP Morgan,CitiBank New York,13148,99495,-86347
2010-08-01,JP Morgan,CitiBank New York,14736,98453,-83717
2010-09-01,JP Morgan,CitiBank New York,13447,95731,-82284
2010-10-01,JP Morgan,CitiBank New York,19755,94255,-74500
2010-11-01,JP Morgan,CitiBank New York,28249,97151,-68902
2010-12-01,JP Morgan,CitiBank New York,24573,92792,-68219
2011-01-01,JP Morgan,CitiBank New York,24752,99154,-74402
2011-02-01,JP Morgan,CitiBank New York,21234,92674,-71440
2011-03-01,JP Morgan,CitiBank New York,24346,98929,-74583
2011-04-01,JP Morgan,CitiBank New York,24567,99283,-74716
2011-05-01,JP Morgan,CitiBank New York,23519,99438,-75919
2011-06-01,JP Morgan,CitiBank New York,23755,98428,-74673
2011-07-01,JP Morgan,CitiBank New York,22847,95826,-72979
2011-08-01,JP Morgan,CitiBank New York,27652,93429,-65777
2011-09-01,JP Morgan,CitiBank New York,31226,83257,-52031
2011-10-01,JP Morgan,CitiBank New York,34821,83255,-48434
2011-11-01,JP Morgan,CitiBank New York,37989,81759,-43770
2011-12-01,JP Morgan,CitiBank New York,36451,86331,-49880
2012-01-01,JP Morgan,CitiBank New York,32894,87863,-54969
2012-02-01,JP Morgan,CitiBank New York,32687,88579,-55892
2012-03-01,JP Morgan,CitiBank New York,32897,84515,-51618
2012-04-01,JP Morgan,CitiBank New York,32621,89825,-57204
2012-05-01,JP Morgan,CitiBank New York,36913,81352,-44439
2012-06-01,JP Morgan,CitiBank New York,31191,87494,-56303
2012-07-01,JP Morgan,CitiBank New York,48967,81827,-32860
2012-08-01,JP Morgan,CitiBank New York,44995,81556,-36561
2012-09-01,JP Morgan,CitiBank New York,41238,84588,-43350
2012-10-01,JP Morgan,CitiBank New York,46871,84979,-38108
2012-11-01,JP Morgan,CitiBank New York,45717,85699,-39982
2012-12-01,JP Morgan,CitiBank New York,46143,89833,-43690
2013-01-01,JP Morgan,CitiBank New York,47568,89958,-42390
2013-02-01,JP Morgan,CitiBank New York,49441,85311,-35870
2013-03-01,JP Morgan,CitiBank New York,45145,83489,-38344
2013-04-01,JP Morgan,CitiBank New York,41448,83482,-42034
2013-05-01,JP Morgan,CitiBank New York,56162,75846,-19684
2013-06-01,JP Morgan,CitiBank New York,53168,75266,-22098
2013-07-01,JP Morgan,CitiBank New York,59376,79157,-19781
2013-08-01,JP Morgan,CitiBank New York,55964,72772,-16808
2013-09-01,JP Morgan,CitiBank New York,53272,73997,-20725
2013-10-01,JP Morgan,CitiBank New York,52734,78137,-25403
2013-11-01,JP Morgan,CitiBank New York,54682,75161,-20479
2013-12-01,JP Morgan,CitiBank New York,59719,72585,-12866
2014-01-01,JP Morgan,CitiBank New York,51757,73447,-21690
2014-02-01,JP Morgan,CitiBank New York,59752,78961,-19209
2014-03-01,JP Morgan,CitiBank New York,63961,75947,-11986
2014-04-01,JP Morgan,CitiBank New York,62987,78648,-15661
2014-05-01,JP Morgan,CitiBank New York,66652,73495,-6843
2014-06-01,JP Morgan,CitiBank New York,63376,76952,-13576
2014-07-01,JP Morgan,CitiBank New York,68365,76328,-7963
2014-08-01,JP Morgan,CitiBank New York,61241,75485,-14244
2014-09-01,JP Morgan,CitiBank New York,67212,78259,-11047
2014-10-01,JP Morgan,CitiBank New York,69877,74976,-5099
2014-11-01,JP Morgan,CitiBank New York,64448,73246,-8798
2014-12-01,JP Morgan,CitiBank New York,66864,72534,-5670
2015-01-01,JP Morgan,CitiBank New York,75787,64883,10904
2015-02-01,JP Morgan,CitiBank New York,76464,64764,11700
2015-03-01,JP Morgan,CitiBank New York,79184,65349,13835
2015-04-01,JP Morgan,CitiBank New York,74534,65996,8538
2015-05-01,JP Morgan,CitiBank New York,76986,66843,10143
2015-06-01,JP Morgan,CitiBank New York,76533,63717,12816
2015-07-01,JP Morgan,CitiBank New York,78485,64297,14188
2015-08-01,JP Morgan,CitiBank New York,72444,67754,4690
2015-09-01,JP Morgan,CitiBank New York,74619,68731,5888
2015-10-01,JP Morgan,CitiBank New York,78693,67388,11305
2015-11-01,JP Morgan,CitiBank New York,87487,68958,18529
2015-12-01,JP Morgan,CitiBank New York,89214,64423,24791
2016-01-01,JP Morgan,CitiBank New York,82827,65235,17592
2016-02-01,JP Morgan,CitiBank New York,83296,61252,22044
2016-03-01,JP Morgan,CitiBank New York,86739,63219,23520
2016-04-01,JP Morgan,CitiBank New York,85347,62251,23096
2016-05-01,JP Morgan,CitiBank New York,82888,65192,17696
2016-06-01,JP Morgan,CitiBank New York,89135,68917,20218
2016-07-01,JP Morgan,CitiBank New York,86842,69761,17081
2016-08-01,JP Morgan,CitiBank New York,87626,61547,26079
2016-09-01,JP Morgan,CitiBank New York,97887,54319,43568
2016-10-01,JP Morgan,CitiBank New York,93751,52182,41569
2016-11-01,JP Morgan,CitiBank New York,98126,51131,46995
2016-12-01,JP Morgan,CitiBank New York,95327,57311,38016
2017-01-01,JP Morgan,CitiBank New York,91326,53469,37857
2017-02-01,JP Morgan,CitiBank New York,97448,59369,38079
2017-03-01,JP Morgan,CitiBank New York,93462,56417,37045
2017-04-01,JP Morgan,CitiBank New York,94716,56923,37793
2017-05-01,JP Morgan,CitiBank New York,96798,53961,42837
2017-06-01,JP Morgan,CitiBank New York,97725,54189,43536
2017-07-01,JP Morgan,CitiBank New York,104379,56857,47522
2017-08-01,JP Morgan,CitiBank New York,103584,58818,44766
2017-09-01,JP Morgan,CitiBank New York,104214,58572,45642
2017-10-01,JP Morgan,CitiBank New York,101514,53166,48348
2017-11-01,JP Morgan,CitiBank New York,102639,54979,47660
2017-12-01,JP Morgan,CitiBank New York,107318,53556,53762
2018-01-01,JP Morgan,CitiBank New York,105521,57354,48167
2018-02-01,JP Morgan,CitiBank New York,109375,51519,57856
2018-03-01,JP Morgan,CitiBank New York,107128,59288,47840
2018-04-01,JP Morgan,CitiBank New York,109554,53763,55791
2010-01-01,JP Morgan,CitiBank London,13357,91241,-77884
2010-02-01,JP Morgan,CitiBank London,11568,99812,-88244
2010-03-01,JP Morgan,CitiBank London,16958,97395,-80437
2010-04-01,JP Morgan,CitiBank London,15567,92435,-76868
2010-05-01,JP Morgan,CitiBank London,15574,95858,-80284
2010-06-01,JP Morgan,CitiBank London,12658,91589,-78931
2010-07-01,JP Morgan,CitiBank London,14677,93856,-79179
2010-08-01,JP Morgan,CitiBank London,11317,93241,-81924
2010-09-01,JP Morgan,CitiBank London,14128,95541,-81413
2010-10-01,JP Morgan,CitiBank London,11741,98451,-86710
2010-11-01,JP Morgan,CitiBank London,24772,91198,-66426
2010-12-01,JP Morgan,CitiBank London,29182,97773,-68591
2011-01-01,JP Morgan,CitiBank London,26537,92163,-65626
2011-02-01,JP Morgan,CitiBank London,24191,93753,-69562
2011-03-01,JP Morgan,CitiBank London,26787,96272,-69485
2011-04-01,JP Morgan,CitiBank London,22449,99551,-77102
2011-05-01,JP Morgan,CitiBank London,23569,96889,-73320
2011-06-01,JP Morgan,CitiBank London,25234,99575,-74341
2011-07-01,JP Morgan,CitiBank London,28799,94113,-65314
2011-08-01,JP Morgan,CitiBank London,21319,93819,-72500
2011-09-01,JP Morgan,CitiBank London,33817,82188,-48371
2011-10-01,JP Morgan,CitiBank London,32947,86792,-53845
2011-11-01,JP Morgan,CitiBank London,39638,87194,-47556
2011-12-01,JP Morgan,CitiBank London,33583,89892,-56309
2012-01-01,JP Morgan,CitiBank London,33444,86145,-52701
2012-02-01,JP Morgan,CitiBank London,36679,81498,-44819
2012-03-01,JP Morgan,CitiBank London,35667,85536,-49869
2012-04-01,JP Morgan,CitiBank London,35615,86536,-50921
2012-05-01,JP Morgan,CitiBank London,32637,85872,-53235
2012-06-01,JP Morgan,CitiBank London,33754,87521,-53767
2012-07-01,JP Morgan,CitiBank London,49554,85435,-35881
2012-08-01,JP Morgan,CitiBank London,42987,87264,-44277
2012-09-01,JP Morgan,CitiBank London,45731,81825,-36094
2012-10-01,JP Morgan,CitiBank London,46244,84589,-38345
2012-11-01,JP Morgan,CitiBank London,43719,83915,-40196
2012-12-01,JP Morgan,CitiBank London,48144,88849,-40705
2013-01-01,JP Morgan,CitiBank London,47763,86823,-39060
2013-02-01,JP Morgan,CitiBank London,45235,82627,-37392
2013-03-01,JP Morgan,CitiBank London,49531,85558,-36027
2013-04-01,JP Morgan,CitiBank London,47725,83782,-36057
2013-05-01,JP Morgan,CitiBank London,53388,72961,-19573
2013-06-01,JP Morgan,CitiBank London,55986,72647,-16661
2013-07-01,JP Morgan,CitiBank London,57227,79388,-22161
2013-08-01,JP Morgan,CitiBank London,59333,72979,-13646
2013-09-01,JP Morgan,CitiBank London,52423,74758,-22335
2013-10-01,JP Morgan,CitiBank London,59493,75543,-16050
2013-11-01,JP Morgan,CitiBank London,51859,73993,-22134
2013-12-01,JP Morgan,CitiBank London,58669,76716,-18047
2014-01-01,JP Morgan,CitiBank London,51664,74454,-22790
2014-02-01,JP Morgan,CitiBank London,56192,72726,-16534
2014-03-01,JP Morgan,CitiBank London,66869,78941,-12072
2014-04-01,JP Morgan,CitiBank London,61417,74811,-13394
2014-05-01,JP Morgan,CitiBank London,69798,77113,-7315
2014-06-01,JP Morgan,CitiBank London,62385,76318,-13933
2014-07-01,JP Morgan,CitiBank London,62782,73245,-10463
2014-08-01,JP Morgan,CitiBank London,68478,73833,-5355
2014-09-01,JP Morgan,CitiBank London,66846,72284,-5438
2014-10-01,JP Morgan,CitiBank London,69161,71864,-2703
2014-11-01,JP Morgan,CitiBank London,64788,76866,-12078
2014-12-01,JP Morgan,CitiBank London,67681,73116,-5435
2015-01-01,JP Morgan,CitiBank London,75411,68499,6912
2015-02-01,JP Morgan,CitiBank London,77149,69363,7786
2015-03-01,JP Morgan,CitiBank London,72222,62848,9374
2015-04-01,JP Morgan,CitiBank London,71658,62645,9013
2015-05-01,JP Morgan,CitiBank London,72591,64934,7657
2015-06-01,JP Morgan,CitiBank London,77682,61247,16435
2015-07-01,JP Morgan,CitiBank London,72143,64921,7222
2015-08-01,JP Morgan,CitiBank London,73982,61872,12110
2015-09-01,JP Morgan,CitiBank London,74399,62669,11730
2015-10-01,JP Morgan,CitiBank London,72453,69666,2787
2015-11-01,JP Morgan,CitiBank London,88459,61929,26530
2015-12-01,JP Morgan,CitiBank London,82116,62885,19231
2016-01-01,JP Morgan,CitiBank London,81425,65468,15957
2016-02-01,JP Morgan,CitiBank London,89637,67511,22126
2016-03-01,JP Morgan,CitiBank London,83126,68827,14299
2016-04-01,JP Morgan,CitiBank London,89687,62341,27346
2016-05-01,JP Morgan,CitiBank London,86226,61479,24747
2016-06-01,JP Morgan,CitiBank London,88162,62575,25587
2016-07-01,JP Morgan,CitiBank London,81897,62259,19638
2016-08-01,JP Morgan,CitiBank London,83721,65817,17904
2016-09-01,JP Morgan,CitiBank London,97287,55118,42169
2016-10-01,JP Morgan,CitiBank London,91423,56274,35149
2016-11-01,JP Morgan,CitiBank London,97283,53235,44048
2016-12-01,JP Morgan,CitiBank London,93417,53718,39699
2017-01-01,JP Morgan,CitiBank London,91451,59375,32076
2017-02-01,JP Morgan,CitiBank London,96252,59979,36273
2017-03-01,JP Morgan,CitiBank London,96822,56221,40601
2017-04-01,JP Morgan,CitiBank London,91488,54456,37032
2017-05-01,JP Morgan,CitiBank London,98363,55353,43010
2017-06-01,JP Morgan,CitiBank London,92299,58322,33977
2017-07-01,JP Morgan,CitiBank London,107456,57933,49523
2017-08-01,JP Morgan,CitiBank London,102256,56894,45362
2017-09-01,JP Morgan,CitiBank London,106884,54425,52459
2017-10-01,JP Morgan,CitiBank London,109556,55588,53968
2017-11-01,JP Morgan,CitiBank London,104888,53255,51633
2017-12-01,JP Morgan,CitiBank London,105116,53698,51418
2018-01-01,JP Morgan,CitiBank London,104117,56579,47538
2018-02-01,JP Morgan,CitiBank London,102354,57283,45071
2018-03-01,JP Morgan,CitiBank London,106756,53699,53057
2018-04-01,JP Morgan,CitiBank London,103713,51757,51956
2010-01-01,JP Morgan,CitiBank Pune,17191,98618,-81427
2010-02-01,JP Morgan,CitiBank Pune,19443,95863,-76420
2010-03-01,JP Morgan,CitiBank Pune,11419,93874,-82455
2010-04-01,JP Morgan,CitiBank Pune,19978,92325,-72347
2010-05-01,JP Morgan,CitiBank Pune,14284,97114,-82830
2010-06-01,JP Morgan,CitiBank Pune,19864,91141,-71277
2010-07-01,JP Morgan,CitiBank Pune,12272,96611,-84339
2010-08-01,JP Morgan,CitiBank Pune,19282,95753,-76471
2010-09-01,JP Morgan,CitiBank Pune,19624,94142,-74518
2010-10-01,JP Morgan,CitiBank Pune,19726,93917,-74191
2010-11-01,JP Morgan,CitiBank Pune,24261,92695,-68434
2010-12-01,JP Morgan,CitiBank Pune,22659,98674,-76015
2011-01-01,JP Morgan,CitiBank Pune,28512,94468,-65956
2011-02-01,JP Morgan,CitiBank Pune,28189,97355,-69166
2011-03-01,JP Morgan,CitiBank Pune,21997,99952,-77955
2011-04-01,JP Morgan,CitiBank Pune,25623,98683,-73060
2011-05-01,JP Morgan,CitiBank Pune,29747,99818,-70071
2011-06-01,JP Morgan,CitiBank Pune,29554,98843,-69289
2011-07-01,JP Morgan,CitiBank Pune,21424,94129,-72705
2011-08-01,JP Morgan,CitiBank Pune,22659,97857,-75198
2011-09-01,JP Morgan,CitiBank Pune,33447,87295,-53848
2011-10-01,JP Morgan,CitiBank Pune,39728,81635,-41907
2011-11-01,JP Morgan,CitiBank Pune,39798,81129,-41331
2011-12-01,JP Morgan,CitiBank Pune,37914,84869,-46955
2012-01-01,JP Morgan,CitiBank Pune,35898,83843,-47945
2012-02-01,JP Morgan,CitiBank Pune,38521,88778,-50257
2012-03-01,JP Morgan,CitiBank Pune,38472,86188,-47716
2012-04-01,JP Morgan,CitiBank Pune,39611,88982,-49371
2012-05-01,JP Morgan,CitiBank Pune,37326,82855,-45529
2012-06-01,JP Morgan,CitiBank Pune,31381,84429,-53048
2012-07-01,JP Morgan,CitiBank Pune,41939,82232,-40293
2012-08-01,JP Morgan,CitiBank Pune,46789,82519,-35730
2012-09-01,JP Morgan,CitiBank Pune,46544,87519,-40975
2012-10-01,JP Morgan,CitiBank Pune,41638,86589,-44951
2012-11-01,JP Morgan,CitiBank Pune,44677,85829,-41152
2012-12-01,JP Morgan,CitiBank Pune,48367,86186,-37819
2013-01-01,JP Morgan,CitiBank Pune,48889,89369,-40480
2013-02-01,JP Morgan,CitiBank Pune,44418,85445,-41027
2013-03-01,JP Morgan,CitiBank Pune,44519,84869,-40350
2013-04-01,JP Morgan,CitiBank Pune,47374,82767,-35393
2013-05-01,JP Morgan,CitiBank Pune,57442,74221,-16779
2013-06-01,JP Morgan,CitiBank Pune,56963,78134,-21171
2013-07-01,JP Morgan,CitiBank Pune,56297,79762,-23465
2013-08-01,JP Morgan,CitiBank Pune,53859,78786,-24927
2013-09-01,JP Morgan,CitiBank Pune,51739,79162,-27423
2013-10-01,JP Morgan,CitiBank Pune,56162,76438,-20276
2013-11-01,JP Morgan,CitiBank Pune,59689,77667,-17978
2013-12-01,JP Morgan,CitiBank Pune,51857,72718,-20861
2014-01-01,JP Morgan,CitiBank Pune,59353,74676,-15323
2014-02-01,JP Morgan,CitiBank Pune,51959,72757,-20798
2014-03-01,JP Morgan,CitiBank Pune,67652,75887,-8235
2014-04-01,JP Morgan,CitiBank Pune,64362,74528,-10166
2014-05-01,JP Morgan,CitiBank Pune,69677,73816,-4139
2014-06-01,JP Morgan,CitiBank Pune,67317,71262,-3945
2014-07-01,JP Morgan,CitiBank Pune,68976,71688,-2712
2014-08-01,JP Morgan,CitiBank Pune,67251,79124,-11873
2014-09-01,JP Morgan,CitiBank Pune,62873,71641,-8768
2014-10-01,JP Morgan,CitiBank Pune,63323,77775,-14452
2014-11-01,JP Morgan,CitiBank Pune,62899,75612,-12713
2014-12-01,JP Morgan,CitiBank Pune,63554,71531,-7977
2015-01-01,JP Morgan,CitiBank Pune,78516,64739,13777
2015-02-01,JP Morgan,CitiBank Pune,72332,66589,5743
2015-03-01,JP Morgan,CitiBank Pune,72598,68696,3902
2015-04-01,JP Morgan,CitiBank Pune,74141,66692,7449
2015-05-01,JP Morgan,CitiBank Pune,79878,69629,10249
2015-06-01,JP Morgan,CitiBank Pune,79365,61261,18104
2015-07-01,JP Morgan,CitiBank Pune,76941,61446,15495
2015-08-01,JP Morgan,CitiBank Pune,71348,68237,3111
2015-09-01,JP Morgan,CitiBank Pune,73844,69661,4183
2015-10-01,JP Morgan,CitiBank Pune,76724,66262,10462
2015-11-01,JP Morgan,CitiBank Pune,83774,68241,15533
2015-12-01,JP Morgan,CitiBank Pune,86366,64426,21940
2016-01-01,JP Morgan,CitiBank Pune,87881,66497,21384
2016-02-01,JP Morgan,CitiBank Pune,89379,69193,20186
2016-03-01,JP Morgan,CitiBank Pune,89123,65459,23664
2016-04-01,JP Morgan,CitiBank Pune,87656,65576,22080
2016-05-01,JP Morgan,CitiBank Pune,86978,62126,24852
2016-06-01,JP Morgan,CitiBank Pune,84451,67336,17115
2016-07-01,JP Morgan,CitiBank Pune,89536,63351,26185
2016-08-01,JP Morgan,CitiBank Pune,85928,66256,19672
2016-09-01,JP Morgan,CitiBank Pune,96678,55996,40682
2016-10-01,JP Morgan,CitiBank Pune,95381,55989,39392
2016-11-01,JP Morgan,CitiBank Pune,96287,58359,37928
2016-12-01,JP Morgan,CitiBank Pune,97468,59199,38269
2017-01-01,JP Morgan,CitiBank Pune,91786,53134,38652
2017-02-01,JP Morgan,CitiBank Pune,96961,51448,45513
2017-03-01,JP Morgan,CitiBank Pune,98389,54527,43862
2017-04-01,JP Morgan,CitiBank Pune,95921,53263,42658
2017-05-01,JP Morgan,CitiBank Pune,96422,57575,38847
2017-06-01,JP Morgan,CitiBank Pune,96928,58934,37994
2017-07-01,JP Morgan,CitiBank Pune,105388,56695,48693
2017-08-01,JP Morgan,CitiBank Pune,106577,58644,47933
2017-09-01,JP Morgan,CitiBank Pune,105588,58187,47401
2017-10-01,JP Morgan,CitiBank Pune,109893,53974,55919
2017-11-01,JP Morgan,CitiBank Pune,109555,56569,52986
2017-12-01,JP Morgan,CitiBank Pune,107633,51369,56264
2018-01-01,JP Morgan,CitiBank Pune,101936,53426,48510
2018-02-01,JP Morgan,CitiBank Pune,106457,55354,51103
2018-03-01,JP Morgan,CitiBank Pune,101572,54213,47359
2018-04-01,JP Morgan,CitiBank Pune,106193,55888,50305
2010-01-01,JP Morgan,CitiBank Singapore,15997,99894,-83897
2010-02-01,JP Morgan,CitiBank Singapore,17898,97351,-79453
2010-03-01,JP Morgan,CitiBank Singapore,11517,97592,-86075
2010-04-01,JP Morgan,CitiBank Singapore,18258,95662,-77404
2010-05-01,JP Morgan,CitiBank Singapore,15551,91781,-76230
2010-06-01,JP Morgan,CitiBank Singapore,11953,98836,-86883
2010-07-01,JP Morgan,CitiBank Singapore,16297,93177,-76880
2010-08-01,JP Morgan,CitiBank Singapore,15951,91675,-75724
2010-09-01,JP Morgan,CitiBank Singapore,16272,97271,-80999
2010-10-01,JP Morgan,CitiBank Singapore,11991,99918,-87927
2010-11-01,JP Morgan,CitiBank Singapore,27649,95487,-67838
2010-12-01,JP Morgan,CitiBank Singapore,24112,95219,-71107
2011-01-01,JP Morgan,CitiBank Singapore,26412,94113,-67701
2011-02-01,JP Morgan,CitiBank Singapore,29544,92752,-63208
2011-03-01,JP Morgan,CitiBank Singapore,23482,94983,-71501
2011-04-01,JP Morgan,CitiBank Singapore,27898,99491,-71593
2011-05-01,JP Morgan,CitiBank Singapore,25564,99775,-74211
2011-06-01,JP Morgan,CitiBank Singapore,29387,92793,-63406
2011-07-01,JP Morgan,CitiBank Singapore,24561,92982,-68421
2011-08-01,JP Morgan,CitiBank Singapore,28456,97888,-69432
2011-09-01,JP Morgan,CitiBank Singapore,38566,82426,-43860
2011-10-01,JP Morgan,CitiBank Singapore,34898,88647,-53749
2011-11-01,JP Morgan,CitiBank Singapore,35628,89451,-53823
2011-12-01,JP Morgan,CitiBank Singapore,31596,89529,-57933
2012-01-01,JP Morgan,CitiBank Singapore,38947,82777,-43830
2012-02-01,JP Morgan,CitiBank Singapore,33561,82519,-48958
2012-03-01,JP Morgan,CitiBank Singapore,39263,83152,-43889
2012-04-01,JP Morgan,CitiBank Singapore,32315,82917,-50602
2012-05-01,JP Morgan,CitiBank Singapore,34664,83846,-49182
2012-06-01,JP Morgan,CitiBank Singapore,31699,89769,-58070
2012-07-01,JP Morgan,CitiBank Singapore,42528,82774,-40246
2012-08-01,JP Morgan,CitiBank Singapore,44827,83698,-38871
2012-09-01,JP Morgan,CitiBank Singapore,45385,83955,-38570
2012-10-01,JP Morgan,CitiBank Singapore,42299,84376,-42077
2012-11-01,JP Morgan,CitiBank Singapore,46173,83464,-37291
2012-12-01,JP Morgan,CitiBank Singapore,42986,82418,-39432
2013-01-01,JP Morgan,CitiBank Singapore,45828,85455,-39627
2013-02-01,JP Morgan,CitiBank Singapore,41357,88353,-46996
2013-03-01,JP Morgan,CitiBank Singapore,47621,85193,-37572
2013-04-01,JP Morgan,CitiBank Singapore,47729,89271,-41542
2013-05-01,JP Morgan,CitiBank Singapore,54833,71122,-16289
2013-06-01,JP Morgan,CitiBank Singapore,55667,77871,-22204
2013-07-01,JP Morgan,CitiBank Singapore,58345,73475,-15130
2013-08-01,JP Morgan,CitiBank Singapore,55261,76317,-21056
2013-09-01,JP Morgan,CitiBank Singapore,57278,79598,-22320
2013-10-01,JP Morgan,CitiBank Singapore,56928,78958,-22030
2013-11-01,JP Morgan,CitiBank Singapore,55577,74671,-19094
2013-12-01,JP Morgan,CitiBank Singapore,54738,72664,-17926
2014-01-01,JP Morgan,CitiBank Singapore,58857,77146,-18289
2014-02-01,JP Morgan,CitiBank Singapore,58246,78711,-20465
2014-03-01,JP Morgan,CitiBank Singapore,65567,71666,-6099
2014-04-01,JP Morgan,CitiBank Singapore,65643,78513,-12870
2014-05-01,JP Morgan,CitiBank Singapore,62834,76286,-13452
2014-06-01,JP Morgan,CitiBank Singapore,64362,75667,-11305
2014-07-01,JP Morgan,CitiBank Singapore,69721,73189,-3468
2014-08-01,JP Morgan,CitiBank Singapore,64295,72699,-8404
2014-09-01,JP Morgan,CitiBank Singapore,65329,75415,-10086
2014-10-01,JP Morgan,CitiBank Singapore,61684,74757,-13073
2014-11-01,JP Morgan,CitiBank Singapore,64791,73924,-9133
2014-12-01,JP Morgan,CitiBank Singapore,66476,71826,-5350
2015-01-01,JP Morgan,CitiBank Singapore,71957,63457,8500
2015-02-01,JP Morgan,CitiBank Singapore,71726,64955,6771
2015-03-01,JP Morgan,CitiBank Singapore,78489,64535,13954
2015-04-01,JP Morgan,CitiBank Singapore,77912,64321,13591
2015-05-01,JP Morgan,CitiBank Singapore,75232,63332,11900
2015-06-01,JP Morgan,CitiBank Singapore,79766,63961,15805
2015-07-01,JP Morgan,CitiBank Singapore,77289,67332,9957
2015-08-01,JP Morgan,CitiBank Singapore,73393,66341,7052
2015-09-01,JP Morgan,CitiBank Singapore,71899,63247,8652
2015-10-01,JP Morgan,CitiBank Singapore,75373,65134,10239
2015-11-01,JP Morgan,CitiBank Singapore,85578,69588,15990
2015-12-01,JP Morgan,CitiBank Singapore,82781,62971,19810
2016-01-01,JP Morgan,CitiBank Singapore,85139,65815,19324
2016-02-01,JP Morgan,CitiBank Singapore,85691,66516,19175
2016-03-01,JP Morgan,CitiBank Singapore,85424,62312,23112
2016-04-01,JP Morgan,CitiBank Singapore,86278,69916,16362
2016-05-01,JP Morgan,CitiBank Singapore,86449,63651,22798
2016-06-01,JP Morgan,CitiBank Singapore,84668,63732,20936
2016-07-01,JP Morgan,CitiBank Singapore,83744,66935,16809
2016-08-01,JP Morgan,CitiBank Singapore,87818,67619,20199
2016-09-01,JP Morgan,CitiBank Singapore,95555,59798,35757
2016-10-01,JP Morgan,CitiBank Singapore,98973,53925,45048
2016-11-01,JP Morgan,CitiBank Singapore,97263,53822,43441
2016-12-01,JP Morgan,CitiBank Singapore,92161,55675,36486
2017-01-01,JP Morgan,CitiBank Singapore,93474,58184,35290
2017-02-01,JP Morgan,CitiBank Singapore,91962,56523,35439
2017-03-01,JP Morgan,CitiBank Singapore,97679,54238,43441
2017-04-01,JP Morgan,CitiBank Singapore,99543,59178,40365
2017-05-01,JP Morgan,CitiBank Singapore,97272,52239,45033
2017-06-01,JP Morgan,CitiBank Singapore,95467,56444,39023
2017-07-01,JP Morgan,CitiBank Singapore,104187,53123,51064
2017-08-01,JP Morgan,CitiBank Singapore,107927,52882,55045
2017-09-01,JP Morgan,CitiBank Singapore,105489,51444,54045
2017-10-01,JP Morgan,CitiBank Singapore,107549,57588,49961
2017-11-01,JP Morgan,CitiBank Singapore,105866,52512,53354
2017-12-01,JP Morgan,CitiBank Singapore,102573,56478,46095
2018-01-01,JP Morgan,CitiBank Singapore,104433,54473,49960
2018-02-01,JP Morgan,CitiBank Singapore,102165,55953,46212
2018-03-01,JP Morgan,CitiBank Singapore,109969,59964,50005
2018-04-01,JP Morgan,CitiBank Singapore,107276,51786,55490
2010-01-01,JP Morgan,CitiBank HongKong,12754,99718,-86964
2010-02-01,JP Morgan,CitiBank HongKong,12766,98626,-85860
2010-03-01,JP Morgan,CitiBank HongKong,14995,92192,-77197
2010-04-01,JP Morgan,CitiBank HongKong,12422,94173,-81751
2010-05-01,JP Morgan,CitiBank HongKong,11585,91779,-80194
2010-06-01,JP Morgan,CitiBank HongKong,14435,93945,-79510
2010-07-01,JP Morgan,CitiBank HongKong,14711,92417,-77706
2010-08-01,JP Morgan,CitiBank HongKong,12272,93784,-81512
2010-09-01,JP Morgan,CitiBank HongKong,15727,94951,-79224
2010-10-01,JP Morgan,CitiBank HongKong,14114,92174,-78060
2010-11-01,JP Morgan,CitiBank HongKong,26843,92748,-65905
2010-12-01,JP Morgan,CitiBank HongKong,29716,97997,-68281
2011-01-01,JP Morgan,CitiBank HongKong,28534,92124,-63590
2011-02-01,JP Morgan,CitiBank HongKong,27965,93456,-65491
2011-03-01,JP Morgan,CitiBank HongKong,29911,94442,-64531
2011-04-01,JP Morgan,CitiBank HongKong,29442,95677,-66235
2011-05-01,JP Morgan,CitiBank HongKong,29359,92384,-63025
2011-06-01,JP Morgan,CitiBank HongKong,26191,99843,-73652
2011-07-01,JP Morgan,CitiBank HongKong,26714,95192,-68478
2011-08-01,JP Morgan,CitiBank HongKong,28727,95136,-66409
2011-09-01,JP Morgan,CitiBank HongKong,36341,88658,-52317
2011-10-01,JP Morgan,CitiBank HongKong,39769,83467,-43698
2011-11-01,JP Morgan,CitiBank HongKong,39165,82154,-42989
2011-12-01,JP Morgan,CitiBank HongKong,39183,86264,-47081
2012-01-01,JP Morgan,CitiBank HongKong,31234,86885,-55651
2012-02-01,JP Morgan,CitiBank HongKong,36776,81914,-45138
2012-03-01,JP Morgan,CitiBank HongKong,34434,86639,-52205
2012-04-01,JP Morgan,CitiBank HongKong,39946,81422,-41476
2012-05-01,JP Morgan,CitiBank HongKong,36148,82249,-46101
2012-06-01,JP Morgan,CitiBank HongKong,39996,86724,-46728
2012-07-01,JP Morgan,CitiBank HongKong,47659,83461,-35802
2012-08-01,JP Morgan,CitiBank HongKong,41423,82271,-40848
2012-09-01,JP Morgan,CitiBank HongKong,42635,82943,-40308
2012-10-01,JP Morgan,CitiBank HongKong,46897,85239,-38342
2012-11-01,JP Morgan,CitiBank HongKong,41737,81475,-39738
2012-12-01,JP Morgan,CitiBank HongKong,41575,81149,-39574
2013-01-01,JP Morgan,CitiBank HongKong,48673,88137,-39464
2013-02-01,JP Morgan,CitiBank HongKong,42549,83623,-41074
2013-03-01,JP Morgan,CitiBank HongKong,43421,82833,-39412
2013-04-01,JP Morgan,CitiBank HongKong,49219,84171,-34952
2013-05-01,JP Morgan,CitiBank HongKong,59493,76699,-17206
2013-06-01,JP Morgan,CitiBank HongKong,56382,73423,-17041
2013-07-01,JP Morgan,CitiBank HongKong,55288,71217,-15929
2013-08-01,JP Morgan,CitiBank HongKong,56262,77271,-21009
2013-09-01,JP Morgan,CitiBank HongKong,56233,75864,-19631
2013-10-01,JP Morgan,CitiBank HongKong,56464,72726,-16262
2013-11-01,JP Morgan,CitiBank HongKong,58569,76685,-18116
2013-12-01,JP Morgan,CitiBank HongKong,54333,77664,-23331
2014-01-01,JP Morgan,CitiBank HongKong,58886,75233,-16347
2014-02-01,JP Morgan,CitiBank HongKong,53394,73834,-20440
2014-03-01,JP Morgan,CitiBank HongKong,63988,71685,-7697
2014-04-01,JP Morgan,CitiBank HongKong,65473,74887,-9414
2014-05-01,JP Morgan,CitiBank HongKong,64158,72249,-8091
2014-06-01,JP Morgan,CitiBank HongKong,69133,74939,-5806
2014-07-01,JP Morgan,CitiBank HongKong,61192,76679,-15487
2014-08-01,JP Morgan,CitiBank HongKong,65676,71677,-6001
2014-09-01,JP Morgan,CitiBank HongKong,61778,72488,-10710
2014-10-01,JP Morgan,CitiBank HongKong,61954,79893,-17939
2014-11-01,JP Morgan,CitiBank HongKong,66857,71788,-4931
2014-12-01,JP Morgan,CitiBank HongKong,69748,71473,-1725
2015-01-01,JP Morgan,CitiBank HongKong,72513,69668,2845
2015-02-01,JP Morgan,CitiBank HongKong,73815,61493,12322
2015-03-01,JP Morgan,CitiBank HongKong,76641,62583,14058
2015-04-01,JP Morgan,CitiBank HongKong,73514,66732,6782
2015-05-01,JP Morgan,CitiBank HongKong,77419,66879,10540
2015-06-01,JP Morgan,CitiBank HongKong,73442,65774,7668
2015-07-01,JP Morgan,CitiBank HongKong,73772,67821,5951
2015-08-01,JP Morgan,CitiBank HongKong,75647,64212,11435
2015-09-01,JP Morgan,CitiBank HongKong,72498,67986,4512
2015-10-01,JP Morgan,CitiBank HongKong,78516,63833,14683
2015-11-01,JP Morgan,CitiBank HongKong,84353,66296,18057
2015-12-01,JP Morgan,CitiBank HongKong,83314,64131,19183
2016-01-01,JP Morgan,CitiBank HongKong,81968,65283,16685
2016-02-01,JP Morgan,CitiBank HongKong,81384,67197,14187
2016-03-01,JP Morgan,CitiBank HongKong,85563,64269,21294
2016-04-01,JP Morgan,CitiBank HongKong,85519,62578,22941
2016-05-01,JP Morgan,CitiBank HongKong,83544,65413,18131
2016-06-01,JP Morgan,CitiBank HongKong,86633,65616,21017
2016-07-01,JP Morgan,CitiBank HongKong,88547,62111,26436
2016-08-01,JP Morgan,CitiBank HongKong,85818,65275,20543
2016-09-01,JP Morgan,CitiBank HongKong,99691,53949,45742
2016-10-01,JP Morgan,CitiBank HongKong,96761,57657,39104
2016-11-01,JP Morgan,CitiBank HongKong,93414,52584,40830
2016-12-01,JP Morgan,CitiBank HongKong,93688,53713,39975
2017-01-01,JP Morgan,CitiBank HongKong,92373,58783,33590
2017-02-01,JP Morgan,CitiBank HongKong,99624,57882,41742
2017-03-01,JP Morgan,CitiBank HongKong,99224,51883,47341
2017-04-01,JP Morgan,CitiBank HongKong,99319,57233,42086
2017-05-01,JP Morgan,CitiBank HongKong,92261,52892,39369
2017-06-01,JP Morgan,CitiBank HongKong,98915,51747,47168
2017-07-01,JP Morgan,CitiBank HongKong,108329,51335,56994
2017-08-01,JP Morgan,CitiBank HongKong,102949,51511,51438
2017-09-01,JP Morgan,CitiBank HongKong,106564,55558,51006
2017-10-01,JP Morgan,CitiBank HongKong,106533,53224,53309
2017-11-01,JP Morgan,CitiBank HongKong,109885,58475,51410
2017-12-01,JP Morgan,CitiBank HongKong,101365,59659,41706
2018-01-01,JP Morgan,CitiBank HongKong,106761,59963,46798
2018-02-01,JP Morgan,CitiBank HongKong,108287,54879,53408
2018-03-01,JP Morgan,CitiBank HongKong,109572,54227,55345
2018-04-01,JP Morgan,CitiBank HongKong,105965,53913,52052
2010-01-01,Bank of America,CitiBank New York,16227,96285,-80058
2010-02-01,Bank of America,CitiBank New York,13852,96345,-82493
2010-03-01,Bank of America,CitiBank New York,17281,94946,-77665
2010-04-01,Bank of America,CitiBank New York,13247,96465,-83218
2010-05-01,Bank of America,CitiBank New York,13845,99319,-85474
2010-06-01,Bank of America,CitiBank New York,15455,95853,-80398
2010-07-01,Bank of America,CitiBank New York,11139,96893,-85754
2010-08-01,Bank of America,CitiBank New York,11321,95486,-84165
2010-09-01,Bank of America,CitiBank New York,13411,98219,-84808
2010-10-01,Bank of America,CitiBank New York,12343,99518,-87175
2010-11-01,Bank of America,CitiBank New York,26554,97887,-71333
2010-12-01,Bank of America,CitiBank New York,27626,94898,-67272
2011-01-01,Bank of America,CitiBank New York,29398,98795,-69397
2011-02-01,Bank of America,CitiBank New York,28715,99484,-70769
2011-03-01,Bank of America,CitiBank New York,29414,93922,-64508
2011-04-01,Bank of America,CitiBank New York,24141,94272,-70131
2011-05-01,Bank of America,CitiBank New York,25461,94245,-68784
2011-06-01,Bank of America,CitiBank New York,26385,98618,-72233
2011-07-01,Bank of America,CitiBank New York,21223,93319,-72096
2011-08-01,Bank of America,CitiBank New York,25883,94594,-68711
2011-09-01,Bank of America,CitiBank New York,33269,83165,-49896
2011-10-01,Bank of America,CitiBank New York,31367,83616,-52249
2011-11-01,Bank of America,CitiBank New York,32931,81888,-48957
2011-12-01,Bank of America,CitiBank New York,32854,83158,-50304
2012-01-01,Bank of America,CitiBank New York,31429,88855,-57426
2012-02-01,Bank of America,CitiBank New York,36459,85742,-49283
2012-03-01,Bank of America,CitiBank New York,39723,88322,-48599
2012-04-01,Bank of America,CitiBank New York,38784,85642,-46858
2012-05-01,Bank of America,CitiBank New York,34916,82448,-47532
2012-06-01,Bank of America,CitiBank New York,38593,82937,-44344
2012-07-01,Bank of America,CitiBank New York,44247,81423,-37176
2012-08-01,Bank of America,CitiBank New York,45717,88756,-43039
2012-09-01,Bank of America,CitiBank New York,41965,81597,-39632
2012-10-01,Bank of America,CitiBank New York,47475,87746,-40271
2012-11-01,Bank of America,CitiBank New York,46668,89912,-43244
2012-12-01,Bank of America,CitiBank New York,49649,83353,-33704
2013-01-01,Bank of America,CitiBank New York,47859,81361,-33502
2013-02-01,Bank of America,CitiBank New York,44692,88431,-43739
2013-03-01,Bank of America,CitiBank New York,46413,88882,-42469
2013-04-01,Bank of America,CitiBank New York,46488,87398,-40910
2013-05-01,Bank of America,CitiBank New York,58367,79557,-21190
2013-06-01,Bank of America,CitiBank New York,57938,76354,-18416
2013-07-01,Bank of America,CitiBank New York,53628,75917,-22289
2013-08-01,Bank of America,CitiBank New York,53369,77557,-24188
2013-09-01,Bank of America,CitiBank New York,55439,78117,-22678
2013-10-01,Bank of America,CitiBank New York,56286,79654,-23368
2013-11-01,Bank of America,CitiBank New York,53289,75867,-22578
2013-12-01,Bank of America,CitiBank New York,55677,72369,-16692
2014-01-01,Bank of America,CitiBank New York,59723,76433,-16710
2014-02-01,Bank of America,CitiBank New York,52252,77521,-25269
2014-03-01,Bank of America,CitiBank New York,68723,73447,-4724
2014-04-01,Bank of America,CitiBank New York,65577,76648,-11071
2014-05-01,Bank of America,CitiBank New York,69242,78924,-9682
2014-06-01,Bank of America,CitiBank New York,62627,78653,-16026
2014-07-01,Bank of America,CitiBank New York,67573,71948,-4375
2014-08-01,Bank of America,CitiBank New York,64879,76949,-12070
2014-09-01,Bank of America,CitiBank New York,64455,76888,-12433
2014-10-01,Bank of America,CitiBank New York,63737,74733,-10996
2014-11-01,Bank of America,CitiBank New York,66941,78253,-11312
2014-12-01,Bank of America,CitiBank New York,65555,74762,-9207
2015-01-01,Bank of America,CitiBank New York,76776,69834,6942
2015-02-01,Bank of America,CitiBank New York,75588,65474,10114
2015-03-01,Bank of America,CitiBank New York,75712,65757,9955
2015-04-01,Bank of America,CitiBank New York,76836,61593,15243
2015-05-01,Bank of America,CitiBank New York,72245,68234,4011
2015-06-01,Bank of America,CitiBank New York,72659,61413,11246
2015-07-01,Bank of America,CitiBank New York,78133,68294,9839
2015-08-01,Bank of America,CitiBank New York,72399,62757,9642
2015-09-01,Bank of America,CitiBank New York,75748,64722,11026
2015-10-01,Bank of America,CitiBank New York,78895,62328,16567
2015-11-01,Bank of America,CitiBank New York,88486,68754,19732
2015-12-01,Bank of America,CitiBank New York,89589,61538,28051
2016-01-01,Bank of America,CitiBank New York,81271,64952,16319
2016-02-01,Bank of America,CitiBank New York,86483,63778,22705
2016-03-01,Bank of America,CitiBank New York,86758,64346,22412
2016-04-01,Bank of America,CitiBank New York,83755,66558,17197
2016-05-01,Bank of America,CitiBank New York,82629,62282,20347
2016-06-01,Bank of America,CitiBank New York,86566,67795,18771
2016-07-01,Bank of America,CitiBank New York,88118,62686,25432
2016-08-01,Bank of America,CitiBank New York,86912,69714,17198
2016-09-01,Bank of America,CitiBank New York,97172,57815,39357
2016-10-01,Bank of America,CitiBank New York,98742,54443,44299
2016-11-01,Bank of America,CitiBank New York,96653,55218,41435
2016-12-01,Bank of America,CitiBank New York,94438,57748,36690
2017-01-01,Bank of America,CitiBank New York,95669,51431,44238
2017-02-01,Bank of America,CitiBank New York,97749,59612,38137
2017-03-01,Bank of America,CitiBank New York,99933,57188,42745
2017-04-01,Bank of America,CitiBank New York,98325,54223,44102
2017-05-01,Bank of America,CitiBank New York,99234,51186,48048
2017-06-01,Bank of America,CitiBank New York,96779,53538,43241
2017-07-01,Bank of America,CitiBank New York,109912,58289,51623
2017-08-01,Bank of America,CitiBank New York,105714,53456,52258
2017-09-01,Bank of America,CitiBank New York,102851,57976,44875
2017-10-01,Bank of America,CitiBank New York,105922,54278,51644
2017-11-01,Bank of America,CitiBank New York,101341,54496,46845
2017-12-01,Bank of America,CitiBank New York,106757,58212,48545
2018-01-01,Bank of America,CitiBank New York,105648,52217,53431
2018-02-01,Bank of America,CitiBank New York,101977,56269,45708
2018-03-01,Bank of America,CitiBank New York,108387,58411,49976
2018-04-01,Bank of America,CitiBank New York,102462,51462,51000
2010-01-01,Bank of America,CitiBank London,17351,99924,-82573
2010-02-01,Bank of America,CitiBank London,15785,96753,-80968
2010-03-01,Bank of America,CitiBank London,11915,96216,-84301
2010-04-01,Bank of America,CitiBank London,19188,98573,-79385
2010-05-01,Bank of America,CitiBank London,11153,99157,-88004
2010-06-01,Bank of America,CitiBank London,13239,97379,-84140
2010-07-01,Bank of America,CitiBank London,13224,97246,-84022
2010-08-01,Bank of America,CitiBank London,14272,94775,-80503
2010-09-01,Bank of America,CitiBank London,17841,95743,-77902
2010-10-01,Bank of America,CitiBank London,16255,94174,-77919
2010-11-01,Bank of America,CitiBank London,23223,95817,-72594
2010-12-01,Bank of America,CitiBank London,22228,96255,-74027
2011-01-01,Bank of America,CitiBank London,26619,95758,-69139
2011-02-01,Bank of America,CitiBank London,23484,93792,-70308
2011-03-01,Bank of America,CitiBank London,26379,92634,-66255
2011-04-01,Bank of America,CitiBank London,21613,96338,-74725
2011-05-01,Bank of America,CitiBank London,27695,91531,-63836
2011-06-01,Bank of America,CitiBank London,26463,99774,-73311
2011-07-01,Bank of America,CitiBank London,27949,97186,-69237
2011-08-01,Bank of America,CitiBank London,28562,99931,-71369
2011-09-01,Bank of America,CitiBank London,38489,88444,-49955
2011-10-01,Bank of America,CitiBank London,35186,81527,-46341
2011-11-01,Bank of America,CitiBank London,39175,85848,-46673
2011-12-01,Bank of America,CitiBank London,33738,82463,-48725
2012-01-01,Bank of America,CitiBank London,31878,87311,-55433
2012-02-01,Bank of America,CitiBank London,31113,88676,-57563
2012-03-01,Bank of America,CitiBank London,37643,88769,-51126
2012-04-01,Bank of America,CitiBank London,33318,85455,-52137
2012-05-01,Bank of America,CitiBank London,32425,83977,-51552
2012-06-01,Bank of America,CitiBank London,37158,81151,-43993
2012-07-01,Bank of America,CitiBank London,45562,83492,-37930
2012-08-01,Bank of America,CitiBank London,47258,81638,-34380
2012-09-01,Bank of America,CitiBank London,46173,83533,-37360
2012-10-01,Bank of America,CitiBank London,46926,83765,-36839
2012-11-01,Bank of America,CitiBank London,49929,83381,-33452
2012-12-01,Bank of America,CitiBank London,46617,83721,-37104
2013-01-01,Bank of America,CitiBank London,47661,86369,-38708
2013-02-01,Bank of America,CitiBank London,49245,86657,-37412
2013-03-01,Bank of America,CitiBank London,41887,82396,-40509
2013-04-01,Bank of America,CitiBank London,44549,89868,-45319
2013-05-01,Bank of America,CitiBank London,53443,76124,-22681
2013-06-01,Bank of America,CitiBank London,52862,79778,-26916
2013-07-01,Bank of America,CitiBank London,51755,76769,-25014
2013-08-01,Bank of America,CitiBank London,52932,74646,-21714
2013-09-01,Bank of America,CitiBank London,55536,77632,-22096
2013-10-01,Bank of America,CitiBank London,56953,76335,-19382
2013-11-01,Bank of America,CitiBank London,54584,75841,-21257
2013-12-01,Bank of America,CitiBank London,57822,76695,-18873
2014-01-01,Bank of America,CitiBank London,59544,74211,-14667
2014-02-01,Bank of America,CitiBank London,52688,74877,-22189
2014-03-01,Bank of America,CitiBank London,66435,75158,-8723
2014-04-01,Bank of America,CitiBank London,63987,74817,-10830
2014-05-01,Bank of America,CitiBank London,63352,75177,-11825
2014-06-01,Bank of America,CitiBank London,67244,76682,-9438
2014-07-01,Bank of America,CitiBank London,69586,71483,-1897
2014-08-01,Bank of America,CitiBank London,64637,77553,-12916
2014-09-01,Bank of America,CitiBank London,62178,74953,-12775
2014-10-01,Bank of America,CitiBank London,63137,74223,-11086
2014-11-01,Bank of America,CitiBank London,65952,71843,-5891
2014-12-01,Bank of America,CitiBank London,67998,79146,-11148
2015-01-01,Bank of America,CitiBank London,74316,61616,12700
2015-02-01,Bank of America,CitiBank London,74776,66991,7785
2015-03-01,Bank of America,CitiBank London,73642,65965,7677
2015-04-01,Bank of America,CitiBank London,72437,64997,7440
2015-05-01,Bank of America,CitiBank London,76381,68516,7865
2015-06-01,Bank of America,CitiBank London,73281,66956,6325
2015-07-01,Bank of America,CitiBank London,75284,66965,8319
2015-08-01,Bank of America,CitiBank London,74927,68595,6332
2015-09-01,Bank of America,CitiBank London,79822,61125,18697
2015-10-01,Bank of America,CitiBank London,77626,66324,11302
2015-11-01,Bank of America,CitiBank London,86984,63211,23773
2015-12-01,Bank of America,CitiBank London,87667,68448,19219
2016-01-01,Bank of America,CitiBank London,81344,67471,13873
2016-02-01,Bank of America,CitiBank London,83166,68122,15044
2016-03-01,Bank of America,CitiBank London,85528,65264,20264
2016-04-01,Bank of America,CitiBank London,84218,64439,19779
2016-05-01,Bank of America,CitiBank London,84233,63812,20421
2016-06-01,Bank of America,CitiBank London,87583,66551,21032
2016-07-01,Bank of America,CitiBank London,85949,66562,19387
2016-08-01,Bank of America,CitiBank London,88363,66265,22098
2016-09-01,Bank of America,CitiBank London,95452,58955,36497
2016-10-01,Bank of America,CitiBank London,93172,57191,35981
2016-11-01,Bank of America,CitiBank London,97737,52794,44943
2016-12-01,Bank of America,CitiBank London,99391,51253,48138
2017-01-01,Bank of America,CitiBank London,98262,55341,42921
2017-02-01,Bank of America,CitiBank London,99279,54973,44306
2017-03-01,Bank of America,CitiBank London,99328,51767,47561
2017-04-01,Bank of America,CitiBank London,96544,57726,38818
2017-05-01,Bank of America,CitiBank London,99556,53737,45819
2017-06-01,Bank of America,CitiBank London,91747,51686,40061
2017-07-01,Bank of America,CitiBank London,104883,59317,45566
2017-08-01,Bank of America,CitiBank London,104451,53771,50680
2017-09-01,Bank of America,CitiBank London,107489,56541,50948
2017-10-01,Bank of America,CitiBank London,104963,57612,47351
2017-11-01,Bank of America,CitiBank London,108168,54685,53483
2017-12-01,Bank of America,CitiBank London,103485,52633,50852
2018-01-01,Bank of America,CitiBank London,106387,57696,48691
2018-02-01,Bank of America,CitiBank London,101947,59317,42630
2018-03-01,Bank of America,CitiBank London,109196,57284,51912
2018-04-01,Bank of America,CitiBank London,108213,53315,54898
2010-01-01,Bank of America,CitiBank Pune,15295,96271,-80976
2010-02-01,Bank of America,CitiBank Pune,19713,95414,-75701
2010-03-01,Bank of America,CitiBank Pune,18345,98453,-80108
2010-04-01,Bank of America,CitiBank Pune,15322,92999,-77677
2010-05-01,Bank of America,CitiBank Pune,13816,97916,-84100
2010-06-01,Bank of America,CitiBank Pune,15371,94156,-78785
2010-07-01,Bank of America,CitiBank Pune,16215,96854,-80639
2010-08-01,Bank of America,CitiBank Pune,15142,91231,-76089
2010-09-01,Bank of America,CitiBank Pune,16841,97731,-80890
2010-10-01,Bank of America,CitiBank Pune,14218,97955,-83737
2010-11-01,Bank of America,CitiBank Pune,24979,93233,-68254
2010-12-01,Bank of America,CitiBank Pune,24898,99632,-74734
2011-01-01,Bank of America,CitiBank Pune,24542,95461,-70919
2011-02-01,Bank of America,CitiBank Pune,21742,93986,-72244
2011-03-01,Bank of America,CitiBank Pune,26984,97688,-70704
2011-04-01,Bank of America,CitiBank Pune,29187,92571,-63384
2011-05-01,Bank of America,CitiBank Pune,26365,98867,-72502
2011-06-01,Bank of America,CitiBank Pune,23338,95291,-71953
2011-07-01,Bank of America,CitiBank Pune,26615,94749,-68134
2011-08-01,Bank of America,CitiBank Pune,21622,92742,-71120
2011-09-01,Bank of America,CitiBank Pune,37264,82957,-45693
2011-10-01,Bank of America,CitiBank Pune,37573,89831,-52258
2011-11-01,Bank of America,CitiBank Pune,34531,88962,-54431
2011-12-01,Bank of America,CitiBank Pune,35291,83237,-47946
2012-01-01,Bank of America,CitiBank Pune,39721,81914,-42193
2012-02-01,Bank of America,CitiBank Pune,31427,81961,-50534
2012-03-01,Bank of America,CitiBank Pune,32459,82631,-50172
2012-04-01,Bank of America,CitiBank Pune,38999,82261,-43262
2012-05-01,Bank of America,CitiBank Pune,31831,86353,-54522
2012-06-01,Bank of America,CitiBank Pune,33147,82494,-49347
2012-07-01,Bank of America,CitiBank Pune,41299,81395,-40096
2012-08-01,Bank of America,CitiBank Pune,41789,86656,-44867
2012-09-01,Bank of America,CitiBank Pune,43687,88188,-44501
2012-10-01,Bank of America,CitiBank Pune,44237,88479,-44242
2012-11-01,Bank of America,CitiBank Pune,45131,83531,-38400
2012-12-01,Bank of America,CitiBank Pune,41382,86336,-44954
2013-01-01,Bank of America,CitiBank Pune,41764,86658,-44894
2013-02-01,Bank of America,CitiBank Pune,45987,85657,-39670
2013-03-01,Bank of America,CitiBank Pune,41512,87186,-45674
2013-04-01,Bank of America,CitiBank Pune,43998,88921,-44923
2013-05-01,Bank of America,CitiBank Pune,59694,75584,-15890
2013-06-01,Bank of America,CitiBank Pune,52222,76273,-24051
2013-07-01,Bank of America,CitiBank Pune,52242,76684,-24442
2013-08-01,Bank of America,CitiBank Pune,51211,76991,-25780
2013-09-01,Bank of America,CitiBank Pune,59855,73277,-13422
2013-10-01,Bank of America,CitiBank Pune,59453,78322,-18869
2013-11-01,Bank of America,CitiBank Pune,56478,75466,-18988
2013-12-01,Bank of America,CitiBank Pune,57314,74669,-17355
2014-01-01,Bank of America,CitiBank Pune,51235,74626,-23391
2014-02-01,Bank of America,CitiBank Pune,53397,77573,-24176
2014-03-01,Bank of America,CitiBank Pune,63616,72992,-9376
2014-04-01,Bank of America,CitiBank Pune,68497,77217,-8720
2014-05-01,Bank of America,CitiBank Pune,61645,78648,-17003
2014-06-01,Bank of America,CitiBank Pune,67989,78861,-10872
2014-07-01,Bank of America,CitiBank Pune,66134,78637,-12503
2014-08-01,Bank of America,CitiBank Pune,66169,71815,-5646
2014-09-01,Bank of America,CitiBank Pune,62619,79753,-17134
2014-10-01,Bank of America,CitiBank Pune,65211,75613,-10402
2014-11-01,Bank of America,CitiBank Pune,68266,74598,-6332
2014-12-01,Bank of America,CitiBank Pune,64332,74944,-10612
2015-01-01,Bank of America,CitiBank Pune,72114,68769,3345
2015-02-01,Bank of America,CitiBank Pune,79456,61868,17588
2015-03-01,Bank of America,CitiBank Pune,76434,66554,9880
2015-04-01,Bank of America,CitiBank Pune,75761,66143,9618
2015-05-01,Bank of America,CitiBank Pune,78788,63598,15190
2015-06-01,Bank of America,CitiBank Pune,78619,63747,14872
2015-07-01,Bank of America,CitiBank Pune,76951,62487,14464
2015-08-01,Bank of America,CitiBank Pune,75411,64358,11053
2015-09-01,Bank of America,CitiBank Pune,71996,67885,4111
2015-10-01,Bank of America,CitiBank Pune,75171,61976,13195
2015-11-01,Bank of America,CitiBank Pune,83814,67865,15949
2015-12-01,Bank of America,CitiBank Pune,86243,67595,18648
2016-01-01,Bank of America,CitiBank Pune,88975,69677,19298
2016-02-01,Bank of America,CitiBank Pune,84677,65155,19522
2016-03-01,Bank of America,CitiBank Pune,88159,69681,18478
2016-04-01,Bank of America,CitiBank Pune,87123,64436,22687
2016-05-01,Bank of America,CitiBank Pune,81363,61948,19415
2016-06-01,Bank of America,CitiBank Pune,84233,68696,15537
2016-07-01,Bank of America,CitiBank Pune,88567,64333,24234
2016-08-01,Bank of America,CitiBank Pune,82447,67237,15210
2016-09-01,Bank of America,CitiBank Pune,91946,57371,34575
2016-10-01,Bank of America,CitiBank Pune,96959,53543,43416
2016-11-01,Bank of America,CitiBank Pune,96243,51196,45047
2016-12-01,Bank of America,CitiBank Pune,98973,57241,41732
2017-01-01,Bank of America,CitiBank Pune,94771,59489,35282
2017-02-01,Bank of America,CitiBank Pune,95134,52321,42813
2017-03-01,Bank of America,CitiBank Pune,96566,58617,37949
2017-04-01,Bank of America,CitiBank Pune,98437,57592,40845
2017-05-01,Bank of America,CitiBank Pune,97361,55256,42105
2017-06-01,Bank of America,CitiBank Pune,92228,58826,33402
2017-07-01,Bank of America,CitiBank Pune,101521,58178,43343
2017-08-01,Bank of America,CitiBank Pune,109771,53796,55975
2017-09-01,Bank of America,CitiBank Pune,107882,53952,53930
2017-10-01,Bank of America,CitiBank Pune,103595,53596,49999
2017-11-01,Bank of America,CitiBank Pune,105916,55196,50720
2017-12-01,Bank of America,CitiBank Pune,102522,56265,46257
2018-01-01,Bank of America,CitiBank Pune,105965,52441,53524
2018-02-01,Bank of America,CitiBank Pune,104361,52737,51624
2018-03-01,Bank of America,CitiBank Pune,109281,58667,50614
2018-04-01,Bank of America,CitiBank Pune,102677,59694,42983
2010-01-01,Bank of America,CitiBank Singapore,14732,96625,-81893
2010-02-01,Bank of America,CitiBank Singapore,19721,98878,-79157
2010-03-01,Bank of America,CitiBank Singapore,13295,91159,-77864
2010-04-01,Bank of America,CitiBank Singapore,13696,91647,-77951
2010-05-01,Bank of America,CitiBank Singapore,18382,96927,-78545
2010-06-01,Bank of America,CitiBank Singapore,19131,96465,-77334
2010-07-01,Bank of America,CitiBank Singapore,19157,97385,-78228
2010-08-01,Bank of America,CitiBank Singapore,18335,92324,-73989
2010-09-01,Bank of America,CitiBank Singapore,14453,93129,-78676
2010-10-01,Bank of America,CitiBank Singapore,17222,93169,-75947
2010-11-01,Bank of America,CitiBank Singapore,21523,96438,-74915
2010-12-01,Bank of America,CitiBank Singapore,29568,95296,-65728
2011-01-01,Bank of America,CitiBank Singapore,28649,93544,-64895
2011-02-01,Bank of America,CitiBank Singapore,21644,95697,-74053
2011-03-01,Bank of America,CitiBank Singapore,27398,98652,-71254
2011-04-01,Bank of America,CitiBank Singapore,24222,98223,-74001
2011-05-01,Bank of America,CitiBank Singapore,23284,95894,-72610
2011-06-01,Bank of America,CitiBank Singapore,27981,97485,-69504
2011-07-01,Bank of America,CitiBank Singapore,24848,94134,-69286
2011-08-01,Bank of America,CitiBank Singapore,26593,96862,-70269
2011-09-01,Bank of America,CitiBank Singapore,36315,82146,-45831
2011-10-01,Bank of America,CitiBank Singapore,35712,86657,-50945
2011-11-01,Bank of America,CitiBank Singapore,39364,82595,-43231
2011-12-01,Bank of America,CitiBank Singapore,34868,87788,-52920
2012-01-01,Bank of America,CitiBank Singapore,36248,88766,-52518
2012-02-01,Bank of America,CitiBank Singapore,33568,84577,-51009
2012-03-01,Bank of America,CitiBank Singapore,35149,84457,-49308
2012-04-01,Bank of America,CitiBank Singapore,37836,87241,-49405
2012-05-01,Bank of America,CitiBank Singapore,33468,87824,-54356
2012-06-01,Bank of America,CitiBank Singapore,39913,85182,-45269
2012-07-01,Bank of America,CitiBank Singapore,47946,82284,-34338
2012-08-01,Bank of America,CitiBank Singapore,41998,88983,-46985
2012-09-01,Bank of America,CitiBank Singapore,45735,87426,-41691
2012-10-01,Bank of America,CitiBank Singapore,41377,84276,-42899
2012-11-01,Bank of America,CitiBank Singapore,49631,83177,-33546
2012-12-01,Bank of America,CitiBank Singapore,49953,88773,-38820
2013-01-01,Bank of America,CitiBank Singapore,42213,87366,-45153
2013-02-01,Bank of America,CitiBank Singapore,47963,86224,-38261
2013-03-01,Bank of America,CitiBank Singapore,46413,86538,-40125
2013-04-01,Bank of America,CitiBank Singapore,48848,82381,-33533
2013-05-01,Bank of America,CitiBank Singapore,58644,71128,-12484
2013-06-01,Bank of America,CitiBank Singapore,53415,71528,-18113
2013-07-01,Bank of America,CitiBank Singapore,53686,71583,-17897
2013-08-01,Bank of America,CitiBank Singapore,59377,74557,-15180
2013-09-01,Bank of America,CitiBank Singapore,52641,76857,-24216
2013-10-01,Bank of America,CitiBank Singapore,54991,77584,-22593
2013-11-01,Bank of America,CitiBank Singapore,51953,75868,-23915
2013-12-01,Bank of America,CitiBank Singapore,51148,79842,-28694
2014-01-01,Bank of America,CitiBank Singapore,54115,76198,-22083
2014-02-01,Bank of America,CitiBank Singapore,58912,77953,-19041
2014-03-01,Bank of America,CitiBank Singapore,63987,76111,-12124
2014-04-01,Bank of America,CitiBank Singapore,62668,72969,-10301
2014-05-01,Bank of America,CitiBank Singapore,68536,71575,-3039
2014-06-01,Bank of America,CitiBank Singapore,65259,75726,-10467
2014-07-01,Bank of America,CitiBank Singapore,67676,71322,-3646
2014-08-01,Bank of America,CitiBank Singapore,69796,72149,-2353
2014-09-01,Bank of America,CitiBank Singapore,66535,77444,-10909
2014-10-01,Bank of America,CitiBank Singapore,67591,73343,-5752
2014-11-01,Bank of America,CitiBank Singapore,69186,73499,-4313
2014-12-01,Bank of America,CitiBank Singapore,67916,72956,-5040
2015-01-01,Bank of America,CitiBank Singapore,77893,69566,8327
2015-02-01,Bank of America,CitiBank Singapore,78593,63526,15067
2015-03-01,Bank of America,CitiBank Singapore,79343,66948,12395
2015-04-01,Bank of America,CitiBank Singapore,76137,65575,10562
2015-05-01,Bank of America,CitiBank Singapore,75247,65717,9530
2015-06-01,Bank of America,CitiBank Singapore,75167,62343,12824
2015-07-01,Bank of America,CitiBank Singapore,78952,61373,17579
2015-08-01,Bank of America,CitiBank Singapore,79439,66164,13275
2015-09-01,Bank of America,CitiBank Singapore,74289,65853,8436
2015-10-01,Bank of America,CitiBank Singapore,75955,63871,12084
2015-11-01,Bank of America,CitiBank Singapore,82413,63133,19280
2015-12-01,Bank of America,CitiBank Singapore,89587,64789,24798
2016-01-01,Bank of America,CitiBank Singapore,84126,63784,20342
2016-02-01,Bank of America,CitiBank Singapore,88577,65514,23063
2016-03-01,Bank of America,CitiBank Singapore,82544,68485,14059
2016-04-01,Bank of America,CitiBank Singapore,85259,69622,15637
2016-05-01,Bank of America,CitiBank Singapore,81428,65197,16231
2016-06-01,Bank of America,CitiBank Singapore,88195,62946,25249
2016-07-01,Bank of America,CitiBank Singapore,81175,68199,12976
2016-08-01,Bank of America,CitiBank Singapore,83722,62467,21255
2016-09-01,Bank of America,CitiBank Singapore,99971,53812,46159
2016-10-01,Bank of America,CitiBank Singapore,98767,55355,43412
2016-11-01,Bank of America,CitiBank Singapore,96783,51432,45351
2016-12-01,Bank of America,CitiBank Singapore,99337,58652,40685
2017-01-01,Bank of America,CitiBank Singapore,92454,57651,34803
2017-02-01,Bank of America,CitiBank Singapore,97564,53849,43715
2017-03-01,Bank of America,CitiBank Singapore,99811,53856,45955
2017-04-01,Bank of America,CitiBank Singapore,97344,56795,40549
2017-05-01,Bank of America,CitiBank Singapore,96154,53456,42698
2017-06-01,Bank of America,CitiBank Singapore,93249,52991,40258
2017-07-01,Bank of America,CitiBank Singapore,106418,58864,47554
2017-08-01,Bank of America,CitiBank Singapore,106694,59611,47083
2017-09-01,Bank of America,CitiBank Singapore,107383,52953,54430
2017-10-01,Bank of America,CitiBank Singapore,109875,55883,53992
2017-11-01,Bank of America,CitiBank Singapore,106324,52634,53690
2017-12-01,Bank of America,CitiBank Singapore,108412,57658,50754
2018-01-01,Bank of America,CitiBank Singapore,102468,59132,43336
2018-02-01,Bank of America,CitiBank Singapore,106621,58463,48158
2018-03-01,Bank of America,CitiBank Singapore,103322,57824,45498
2018-04-01,Bank of America,CitiBank Singapore,101527,58278,43249
2010-01-01,Bank of America,CitiBank HongKong,17472,93639,-76167
2010-02-01,Bank of America,CitiBank HongKong,14662,92453,-77791
2010-03-01,Bank of America,CitiBank HongKong,18163,97269,-79106
2010-04-01,Bank of America,CitiBank HongKong,18662,95372,-76710
2010-05-01,Bank of America,CitiBank HongKong,18344,99217,-80873
2010-06-01,Bank of America,CitiBank HongKong,16578,99137,-82559
2010-07-01,Bank of America,CitiBank HongKong,17445,97512,-80067
2010-08-01,Bank of America,CitiBank HongKong,18538,99895,-81357
2010-09-01,Bank of America,CitiBank HongKong,11954,91511,-79557
2010-10-01,Bank of America,CitiBank HongKong,16137,96284,-80147
2010-11-01,Bank of America,CitiBank HongKong,22992,99565,-76573
2010-12-01,Bank of America,CitiBank HongKong,29835,96972,-67137
2011-01-01,Bank of America,CitiBank HongKong,24871,93938,-69067
2011-02-01,Bank of America,CitiBank HongKong,25367,97439,-72072
2011-03-01,Bank of America,CitiBank HongKong,27887,96256,-68369
2011-04-01,Bank of America,CitiBank HongKong,21758,91631,-69873
2011-05-01,Bank of America,CitiBank HongKong,22745,94986,-72241
2011-06-01,Bank of America,CitiBank HongKong,23751,97293,-73542
2011-07-01,Bank of America,CitiBank HongKong,27981,91693,-63712
2011-08-01,Bank of America,CitiBank HongKong,29755,95521,-65766
2011-09-01,Bank of America,CitiBank HongKong,37435,89921,-52486
2011-10-01,Bank of America,CitiBank HongKong,35497,81647,-46150
2011-11-01,Bank of America,CitiBank HongKong,36694,81592,-44898
2011-12-01,Bank of America,CitiBank HongKong,35281,86871,-51590
2012-01-01,Bank of America,CitiBank HongKong,33964,87958,-53994
2012-02-01,Bank of America,CitiBank HongKong,37486,87929,-50443
2012-03-01,Bank of America,CitiBank HongKong,37742,85333,-47591
2012-04-01,Bank of America,CitiBank HongKong,35933,84874,-48941
2012-05-01,Bank of America,CitiBank HongKong,33736,84444,-50708
2012-06-01,Bank of America,CitiBank HongKong,38155,81899,-43744
2012-07-01,Bank of America,CitiBank HongKong,47614,81487,-33873
2012-08-01,Bank of America,CitiBank HongKong,43494,88878,-45384
2012-09-01,Bank of America,CitiBank HongKong,47776,86367,-38591
2012-10-01,Bank of America,CitiBank HongKong,41715,81369,-39654
2012-11-01,Bank of America,CitiBank HongKong,47214,82233,-35019
2012-12-01,Bank of America,CitiBank HongKong,49172,84838,-35666
2013-01-01,Bank of America,CitiBank HongKong,49522,88319,-38797
2013-02-01,Bank of America,CitiBank HongKong,44439,87192,-42753
2013-03-01,Bank of America,CitiBank HongKong,48157,83267,-35110
2013-04-01,Bank of America,CitiBank HongKong,46574,86434,-39860
2013-05-01,Bank of America,CitiBank HongKong,54885,79757,-24872
2013-06-01,Bank of America,CitiBank HongKong,52919,74729,-21810
2013-07-01,Bank of America,CitiBank HongKong,57315,72386,-15071
2013-08-01,Bank of America,CitiBank HongKong,57513,79197,-21684
2013-09-01,Bank of America,CitiBank HongKong,54114,72398,-18284
2013-10-01,Bank of America,CitiBank HongKong,52643,77296,-24653
2013-11-01,Bank of America,CitiBank HongKong,59628,77594,-17966
2013-12-01,Bank of America,CitiBank HongKong,56497,71852,-15355
2014-01-01,Bank of America,CitiBank HongKong,56755,79546,-22791
2014-02-01,Bank of America,CitiBank HongKong,54564,77471,-22907
2014-03-01,Bank of America,CitiBank HongKong,63527,73261,-9734
2014-04-01,Bank of America,CitiBank HongKong,62348,79243,-16895
2014-05-01,Bank of America,CitiBank HongKong,67374,76115,-8741
2014-06-01,Bank of America,CitiBank HongKong,69675,77363,-7688
2014-07-01,Bank of America,CitiBank HongKong,62697,75848,-13151
2014-08-01,Bank of America,CitiBank HongKong,62948,78424,-15476
2014-09-01,Bank of America,CitiBank HongKong,69935,73155,-3220
2014-10-01,Bank of America,CitiBank HongKong,63921,74536,-10615
2014-11-01,Bank of America,CitiBank HongKong,67938,74878,-6940
2014-12-01,Bank of America,CitiBank HongKong,63311,77274,-13963
2015-01-01,Bank of America,CitiBank HongKong,71795,68595,3200
2015-02-01,Bank of America,CitiBank HongKong,72856,61327,11529
2015-03-01,Bank of America,CitiBank HongKong,72442,62373,10069
2015-04-01,Bank of America,CitiBank HongKong,77635,69583,8052
2015-05-01,Bank of America,CitiBank HongKong,72939,67378,5561
2015-06-01,Bank of America,CitiBank HongKong,75383,63289,12094
2015-07-01,Bank of America,CitiBank HongKong,78586,65313,13273
2015-08-01,Bank of America,CitiBank HongKong,71123,63544,7579
2015-09-01,Bank of America,CitiBank HongKong,77529,63779,13750
2015-10-01,Bank of America,CitiBank HongKong,76473,63514,12959
2015-11-01,Bank of America,CitiBank HongKong,82357,64219,18138
2015-12-01,Bank of America,CitiBank HongKong,86272,65789,20483
2016-01-01,Bank of America,CitiBank HongKong,88711,69271,19440
2016-02-01,Bank of America,CitiBank HongKong,86158,63423,22735
2016-03-01,Bank of America,CitiBank HongKong,87287,65924,21363
2016-04-01,Bank of America,CitiBank HongKong,89464,65582,23882
2016-05-01,Bank of America,CitiBank HongKong,81964,69663,12301
2016-06-01,Bank of America,CitiBank HongKong,82944,64197,18747
2016-07-01,Bank of America,CitiBank HongKong,84457,61758,22699
2016-08-01,Bank of America,CitiBank HongKong,83932,64275,19657
2016-09-01,Bank of America,CitiBank HongKong,95845,58974,36871
2016-10-01,Bank of America,CitiBank HongKong,99544,52582,46962
2016-11-01,Bank of America,CitiBank HongKong,93231,56513,36718
2016-12-01,Bank of America,CitiBank HongKong,97229,55182,42047
2017-01-01,Bank of America,CitiBank HongKong,95173,52418,42755
2017-02-01,Bank of America,CitiBank HongKong,95174,59427,35747
2017-03-01,Bank of America,CitiBank HongKong,93214,55215,37999
2017-04-01,Bank of America,CitiBank HongKong,99763,59548,40215
2017-05-01,Bank of America,CitiBank HongKong,97261,52345,44916
2017-06-01,Bank of America,CitiBank HongKong,94518,56529,37989
2017-07-01,Bank of America,CitiBank HongKong,107674,54264,53410
2017-08-01,Bank of America,CitiBank HongKong,106554,54524,52030
2017-09-01,Bank of America,CitiBank HongKong,109389,53248,56141
2017-10-01,Bank of America,CitiBank HongKong,103124,55658,47466
2017-11-01,Bank of America,CitiBank HongKong,102478,58584,43894
2017-12-01,Bank of America,CitiBank HongKong,102371,56849,45522
2018-01-01,Bank of America,CitiBank HongKong,104387,59428,44959
2018-02-01,Bank of America,CitiBank HongKong,104219,56585,47634
2018-03-01,Bank of America,CitiBank HongKong,106582,56484,50098
2018-04-01,Bank of America,CitiBank HongKong,109686,53636,56050
2010-01-01,Barclays,CitiBank New York,17976,93994,-76018
2010-02-01,Barclays,CitiBank New York,18481,97388,-78907
2010-03-01,Barclays,CitiBank New York,18664,96359,-77695
2010-04-01,Barclays,CitiBank New York,16367,93272,-76905
2010-05-01,Barclays,CitiBank New York,17193,92748,-75555
2010-06-01,Barclays,CitiBank New York,11471,93553,-82082
2010-07-01,Barclays,CitiBank New York,11782,92925,-81143
2010-08-01,Barclays,CitiBank New York,13514,91393,-77879
2010-09-01,Barclays,CitiBank New York,17557,97757,-80200
2010-10-01,Barclays,CitiBank New York,14518,96752,-82234
2010-11-01,Barclays,CitiBank New York,26593,98969,-72376
2010-12-01,Barclays,CitiBank New York,22733,96449,-73716
2011-01-01,Barclays,CitiBank New York,25697,91282,-65585
2011-02-01,Barclays,CitiBank New York,28437,95566,-67129
2011-03-01,Barclays,CitiBank New York,22983,99384,-76401
2011-04-01,Barclays,CitiBank New York,22616,96283,-73667
2011-05-01,Barclays,CitiBank New York,21673,94327,-72654
2011-06-01,Barclays,CitiBank New York,29973,99129,-69156
2011-07-01,Barclays,CitiBank New York,28527,95392,-66865
2011-08-01,Barclays,CitiBank New York,25858,99948,-74090
2011-09-01,Barclays,CitiBank New York,38134,88541,-50407
2011-10-01,Barclays,CitiBank New York,36598,87618,-51020
2011-11-01,Barclays,CitiBank New York,37374,85154,-47780
2011-12-01,Barclays,CitiBank New York,38323,81948,-43625
2012-01-01,Barclays,CitiBank New York,39257,88756,-49499
2012-02-01,Barclays,CitiBank New York,37691,84288,-46597
2012-03-01,Barclays,CitiBank New York,31437,83247,-51810
2012-04-01,Barclays,CitiBank New York,38235,89421,-51186
2012-05-01,Barclays,CitiBank New York,35639,82467,-46828
2012-06-01,Barclays,CitiBank New York,33546,82549,-49003
2012-07-01,Barclays,CitiBank New York,43968,81395,-37427
2012-08-01,Barclays,CitiBank New York,47989,84441,-36452
2012-09-01,Barclays,CitiBank New York,47273,81422,-34149
2012-10-01,Barclays,CitiBank New York,42531,85863,-43332
2012-11-01,Barclays,CitiBank New York,43881,84463,-40582
2012-12-01,Barclays,CitiBank New York,43424,82985,-39561
2013-01-01,Barclays,CitiBank New York,48482,81711,-33229
2013-02-01,Barclays,CitiBank New York,44189,83558,-39369
2013-03-01,Barclays,CitiBank New York,45221,84813,-39592
2013-04-01,Barclays,CitiBank New York,48628,85517,-36889
2013-05-01,Barclays,CitiBank New York,52347,75899,-23552
2013-06-01,Barclays,CitiBank New York,54772,75258,-20486
2013-07-01,Barclays,CitiBank New York,54985,74931,-19946
2013-08-01,Barclays,CitiBank New York,52358,74414,-22056
2013-09-01,Barclays,CitiBank New York,53652,72965,-19313
2013-10-01,Barclays,CitiBank New York,53561,74455,-20894
2013-11-01,Barclays,CitiBank New York,55529,79924,-24395
2013-12-01,Barclays,CitiBank New York,58999,75999,-17000
2014-01-01,Barclays,CitiBank New York,56443,78875,-22432
2014-02-01,Barclays,CitiBank New York,54337,73651,-19314
2014-03-01,Barclays,CitiBank New York,62866,75871,-13005
2014-04-01,Barclays,CitiBank New York,65392,77378,-11986
2014-05-01,Barclays,CitiBank New York,66345,75388,-9043
2014-06-01,Barclays,CitiBank New York,68572,76533,-7961
2014-07-01,Barclays,CitiBank New York,61754,78656,-16902
2014-08-01,Barclays,CitiBank New York,65612,74735,-9123
2014-09-01,Barclays,CitiBank New York,67279,77357,-10078
2014-10-01,Barclays,CitiBank New York,69852,79413,-9561
2014-11-01,Barclays,CitiBank New York,66198,74249,-8051
2014-12-01,Barclays,CitiBank New York,65668,74671,-9003
2015-01-01,Barclays,CitiBank New York,78239,64754,13485
2015-02-01,Barclays,CitiBank New York,77232,65712,11520
2015-03-01,Barclays,CitiBank New York,77737,69477,8260
2015-04-01,Barclays,CitiBank New York,76524,61199,15325
2015-05-01,Barclays,CitiBank New York,72435,67448,4987
2015-06-01,Barclays,CitiBank New York,73238,68757,4481
2015-07-01,Barclays,CitiBank New York,75274,69651,5623
2015-08-01,Barclays,CitiBank New York,76773,66832,9941
2015-09-01,Barclays,CitiBank New York,73677,66516,7161
2015-10-01,Barclays,CitiBank New York,76647,69236,7411
2015-11-01,Barclays,CitiBank New York,86149,61275,24874
2015-12-01,Barclays,CitiBank New York,87169,66485,20684
2016-01-01,Barclays,CitiBank New York,88693,64251,24442
2016-02-01,Barclays,CitiBank New York,83181,62555,20626
2016-03-01,Barclays,CitiBank New York,82333,65481,16852
2016-04-01,Barclays,CitiBank New York,84274,61642,22632
2016-05-01,Barclays,CitiBank New York,88989,68824,20165
2016-06-01,Barclays,CitiBank New York,89942,67715,22227
2016-07-01,Barclays,CitiBank New York,81547,66541,15006
2016-08-01,Barclays,CitiBank New York,86153,61115,25038
2016-09-01,Barclays,CitiBank New York,91137,55672,35465
2016-10-01,Barclays,CitiBank New York,95488,52722,42766
2016-11-01,Barclays,CitiBank New York,99711,51677,48034
2016-12-01,Barclays,CitiBank New York,99869,51185,48684
2017-01-01,Barclays,CitiBank New York,91127,57889,33238
2017-02-01,Barclays,CitiBank New York,98631,51475,47156
2017-03-01,Barclays,CitiBank New York,98332,54756,43576
2017-04-01,Barclays,CitiBank New York,99477,54886,44591
2017-05-01,Barclays,CitiBank New York,94239,53413,40826
2017-06-01,Barclays,CitiBank New York,96759,51437,45322
2017-07-01,Barclays,CitiBank New York,108944,59648,49296
2017-08-01,Barclays,CitiBank New York,101575,58417,43158
2017-09-01,Barclays,CitiBank New York,101133,52369,48764
2017-10-01,Barclays,CitiBank New York,104438,55334,49104
2017-11-01,Barclays,CitiBank New York,107572,59543,48029
2017-12-01,Barclays,CitiBank New York,102992,59191,43801
2018-01-01,Barclays,CitiBank New York,105316,56484,48832
2018-02-01,Barclays,CitiBank New York,109672,58344,51328
2018-03-01,Barclays,CitiBank New York,105989,54389,51600
2018-04-01,Barclays,CitiBank New York,103153,58672,44481
2010-01-01,Barclays,CitiBank London,12726,96762,-84036
2010-02-01,Barclays,CitiBank London,11149,92742,-81593
2010-03-01,Barclays,CitiBank London,13837,97479,-83642
2010-04-01,Barclays,CitiBank London,13213,97171,-83958
2010-05-01,Barclays,CitiBank London,16534,92622,-76088
2010-06-01,Barclays,CitiBank London,19189,98363,-79174
2010-07-01,Barclays,CitiBank London,12635,92477,-79842
2010-08-01,Barclays,CitiBank London,17265,94221,-76956
2010-09-01,Barclays,CitiBank London,19973,95898,-75925
2010-10-01,Barclays,CitiBank London,12124,99737,-87613
2010-11-01,Barclays,CitiBank London,27632,91863,-64231
2010-12-01,Barclays,CitiBank London,25894,91585,-65691
2011-01-01,Barclays,CitiBank London,25145,96122,-70977
2011-02-01,Barclays,CitiBank London,26187,95167,-68980
2011-03-01,Barclays,CitiBank London,29165,97198,-68033
2011-04-01,Barclays,CitiBank London,21127,98196,-77069
2011-05-01,Barclays,CitiBank London,21225,96863,-75638
2011-06-01,Barclays,CitiBank London,22189,92744,-70555
2011-07-01,Barclays,CitiBank London,21416,99156,-77740
2011-08-01,Barclays,CitiBank London,25751,95486,-69735
2011-09-01,Barclays,CitiBank London,39132,87988,-48856
2011-10-01,Barclays,CitiBank London,34944,88571,-53627
2011-11-01,Barclays,CitiBank London,31836,84364,-52528
2011-12-01,Barclays,CitiBank London,34226,81898,-47672
2012-01-01,Barclays,CitiBank London,34338,86683,-52345
2012-02-01,Barclays,CitiBank London,32825,82358,-49533
2012-03-01,Barclays,CitiBank London,33727,88758,-55031
2012-04-01,Barclays,CitiBank London,38553,89168,-50615
2012-05-01,Barclays,CitiBank London,36371,86541,-50170
2012-06-01,Barclays,CitiBank London,35871,87339,-51468
2012-07-01,Barclays,CitiBank London,47663,85519,-37856
2012-08-01,Barclays,CitiBank London,44252,84797,-40545
2012-09-01,Barclays,CitiBank London,41144,83889,-42745
2012-10-01,Barclays,CitiBank London,49828,82996,-33168
2012-11-01,Barclays,CitiBank London,43126,86693,-43567
2012-12-01,Barclays,CitiBank London,41317,86159,-44842
2013-01-01,Barclays,CitiBank London,48518,83286,-34768
2013-02-01,Barclays,CitiBank London,47249,81744,-34495
2013-03-01,Barclays,CitiBank London,44133,83533,-39400
2013-04-01,Barclays,CitiBank London,46519,84787,-38268
2013-05-01,Barclays,CitiBank London,53496,74711,-21215
2013-06-01,Barclays,CitiBank London,57169,74292,-17123
2013-07-01,Barclays,CitiBank London,51382,79226,-27844
2013-08-01,Barclays,CitiBank London,56252,74836,-18584
2013-09-01,Barclays,CitiBank London,56274,75765,-19491
2013-10-01,Barclays,CitiBank London,56558,74436,-17878
2013-11-01,Barclays,CitiBank London,52626,72771,-20145
2013-12-01,Barclays,CitiBank London,52517,72744,-20227
2014-01-01,Barclays,CitiBank London,52926,71678,-18752
2014-02-01,Barclays,CitiBank London,58513,78794,-20281
2014-03-01,Barclays,CitiBank London,63737,76889,-13152
2014-04-01,Barclays,CitiBank London,64168,71941,-7773
2014-05-01,Barclays,CitiBank London,68786,73474,-4688
2014-06-01,Barclays,CitiBank London,64234,76713,-12479
2014-07-01,Barclays,CitiBank London,62358,73733,-11375
2014-08-01,Barclays,CitiBank London,66854,78845,-11991
2014-09-01,Barclays,CitiBank London,68369,73419,-5050
2014-10-01,Barclays,CitiBank London,68588,78556,-9968
2014-11-01,Barclays,CitiBank London,68863,78643,-9780
2014-12-01,Barclays,CitiBank London,69199,77937,-8738
2015-01-01,Barclays,CitiBank London,72547,63225,9322
2015-02-01,Barclays,CitiBank London,72618,61733,10885
2015-03-01,Barclays,CitiBank London,71969,62893,9076
2015-04-01,Barclays,CitiBank London,71827,67584,4243
2015-05-01,Barclays,CitiBank London,72686,65982,6704
2015-06-01,Barclays,CitiBank London,72636,67962,4674
2015-07-01,Barclays,CitiBank London,76126,69398,6728
2015-08-01,Barclays,CitiBank London,74542,65338,9204
2015-09-01,Barclays,CitiBank London,71747,63147,8600
2015-10-01,Barclays,CitiBank London,71528,66772,4756
2015-11-01,Barclays,CitiBank London,88717,65132,23585
2015-12-01,Barclays,CitiBank London,89898,62199,27699
2016-01-01,Barclays,CitiBank London,81293,63293,18000
2016-02-01,Barclays,CitiBank London,86246,68725,17521
2016-03-01,Barclays,CitiBank London,89792,61951,27841
2016-04-01,Barclays,CitiBank London,83369,62773,20596
2016-05-01,Barclays,CitiBank London,85873,63152,22721
2016-06-01,Barclays,CitiBank London,82447,61743,20704
2016-07-01,Barclays,CitiBank London,89942,69534,20408
2016-08-01,Barclays,CitiBank London,81647,66671,14976
2016-09-01,Barclays,CitiBank London,95874,59849,36025
2016-10-01,Barclays,CitiBank London,96999,55964,41035
2016-11-01,Barclays,CitiBank London,91196,58542,32654
2016-12-01,Barclays,CitiBank London,93354,59774,33580
2017-01-01,Barclays,CitiBank London,96575,54581,41994
2017-02-01,Barclays,CitiBank London,95762,55429,40333
2017-03-01,Barclays,CitiBank London,92729,56696,36033
2017-04-01,Barclays,CitiBank London,94286,56997,37289
2017-05-01,Barclays,CitiBank London,95825,58174,37651
2017-06-01,Barclays,CitiBank London,95281,53569,41712
2017-07-01,Barclays,CitiBank London,102898,52519,50379
2017-08-01,Barclays,CitiBank London,106341,53288,53053
2017-09-01,Barclays,CitiBank London,107788,55642,52146
2017-10-01,Barclays,CitiBank London,104379,54137,50242
2017-11-01,Barclays,CitiBank London,109233,57616,51617
2017-12-01,Barclays,CitiBank London,104252,51729,52523
2018-01-01,Barclays,CitiBank London,104224,56282,47942
2018-02-01,Barclays,CitiBank London,101833,55854,45979
2018-03-01,Barclays,CitiBank London,106955,59877,47078
2018-04-01,Barclays,CitiBank London,107969,54873,53096
2010-01-01,Barclays,CitiBank Pune,19769,93374,-73605
2010-02-01,Barclays,CitiBank Pune,11356,97775,-86419
2010-03-01,Barclays,CitiBank Pune,13875,94164,-80289
2010-04-01,Barclays,CitiBank Pune,18217,94333,-76116
2010-05-01,Barclays,CitiBank Pune,15348,92886,-77538
2010-06-01,Barclays,CitiBank Pune,18116,95413,-77297
2010-07-01,Barclays,CitiBank Pune,13583,95438,-81855
2010-08-01,Barclays,CitiBank Pune,12466,98983,-86517
2010-09-01,Barclays,CitiBank Pune,15315,98747,-83432
2010-10-01,Barclays,CitiBank Pune,12931,91898,-78967
2010-11-01,Barclays,CitiBank Pune,21322,95294,-73972
2010-12-01,Barclays,CitiBank Pune,23574,95399,-71825
2011-01-01,Barclays,CitiBank Pune,21322,92793,-71471
2011-02-01,Barclays,CitiBank Pune,28321,95627,-67306
2011-03-01,Barclays,CitiBank Pune,23686,98299,-74613
2011-04-01,Barclays,CitiBank Pune,29487,95976,-66489
2011-05-01,Barclays,CitiBank Pune,29546,91466,-61920
2011-06-01,Barclays,CitiBank Pune,26881,91669,-64788
2011-07-01,Barclays,CitiBank Pune,26766,99952,-73186
2011-08-01,Barclays,CitiBank Pune,29529,98116,-68587
2011-09-01,Barclays,CitiBank Pune,33729,82983,-49254
2011-10-01,Barclays,CitiBank Pune,37815,83489,-45674
2011-11-01,Barclays,CitiBank Pune,38837,86772,-47935
2011-12-01,Barclays,CitiBank Pune,31346,88255,-56909
2012-01-01,Barclays,CitiBank Pune,35395,83163,-47768
2012-02-01,Barclays,CitiBank Pune,32446,88117,-55671
2012-03-01,Barclays,CitiBank Pune,39836,88211,-48375
2012-04-01,Barclays,CitiBank Pune,37241,84185,-46944
2012-05-01,Barclays,CitiBank Pune,39218,82788,-43570
2012-06-01,Barclays,CitiBank Pune,34757,85242,-50485
2012-07-01,Barclays,CitiBank Pune,45173,85784,-40611
2012-08-01,Barclays,CitiBank Pune,42882,84429,-41547
2012-09-01,Barclays,CitiBank Pune,42449,89587,-47138
2012-10-01,Barclays,CitiBank Pune,47535,87784,-40249
2012-11-01,Barclays,CitiBank Pune,46283,81247,-34964
2012-12-01,Barclays,CitiBank Pune,46624,85312,-38688
2013-01-01,Barclays,CitiBank Pune,47779,85554,-37775
2013-02-01,Barclays,CitiBank Pune,44663,87132,-42469
2013-03-01,Barclays,CitiBank Pune,49562,87475,-37913
2013-04-01,Barclays,CitiBank Pune,42799,86326,-43527
2013-05-01,Barclays,CitiBank Pune,56282,77254,-20972
2013-06-01,Barclays,CitiBank Pune,52965,79388,-26423
2013-07-01,Barclays,CitiBank Pune,53794,78317,-24523
2013-08-01,Barclays,CitiBank Pune,54198,79745,-25547
2013-09-01,Barclays,CitiBank Pune,57777,77828,-20051
2013-10-01,Barclays,CitiBank Pune,52139,76127,-23988
2013-11-01,Barclays,CitiBank Pune,55215,74722,-19507
2013-12-01,Barclays,CitiBank Pune,52817,78219,-25402
2014-01-01,Barclays,CitiBank Pune,59957,72421,-12464
2014-02-01,Barclays,CitiBank Pune,53639,73425,-19786
2014-03-01,Barclays,CitiBank Pune,67269,76915,-9646
2014-04-01,Barclays,CitiBank Pune,68812,73811,-4999
2014-05-01,Barclays,CitiBank Pune,69792,73238,-3446
2014-06-01,Barclays,CitiBank Pune,69491,79642,-10151
2014-07-01,Barclays,CitiBank Pune,66991,71156,-4165
2014-08-01,Barclays,CitiBank Pune,69763,76773,-7010
2014-09-01,Barclays,CitiBank Pune,61874,74815,-12941
2014-10-01,Barclays,CitiBank Pune,62355,75544,-13189
2014-11-01,Barclays,CitiBank Pune,66485,78561,-12076
2014-12-01,Barclays,CitiBank Pune,62466,77437,-14971
2015-01-01,Barclays,CitiBank Pune,76742,69942,6800
2015-02-01,Barclays,CitiBank Pune,76267,69683,6584
2015-03-01,Barclays,CitiBank Pune,71721,61488,10233
2015-04-01,Barclays,CitiBank Pune,72297,62656,9641
2015-05-01,Barclays,CitiBank Pune,76127,69962,6165
2015-06-01,Barclays,CitiBank Pune,72562,61619,10943
2015-07-01,Barclays,CitiBank Pune,73767,61973,11794
2015-08-01,Barclays,CitiBank Pune,71282,64655,6627
2015-09-01,Barclays,CitiBank Pune,71289,62916,8373
2015-10-01,Barclays,CitiBank Pune,76294,66171,10123
2015-11-01,Barclays,CitiBank Pune,81342,63237,18105
2015-12-01,Barclays,CitiBank Pune,84823,63561,21262
2016-01-01,Barclays,CitiBank Pune,89634,61114,28520
2016-02-01,Barclays,CitiBank Pune,87559,65765,21794
2016-03-01,Barclays,CitiBank Pune,85765,63491,22274
2016-04-01,Barclays,CitiBank Pune,82293,66283,16010
2016-05-01,Barclays,CitiBank Pune,88439,69145,19294
2016-06-01,Barclays,CitiBank Pune,81363,64965,16398
2016-07-01,Barclays,CitiBank Pune,85627,61588,24039
2016-08-01,Barclays,CitiBank Pune,84576,68852,15724
2016-09-01,Barclays,CitiBank Pune,98261,51813,46448
2016-10-01,Barclays,CitiBank Pune,92567,51818,40749
2016-11-01,Barclays,CitiBank Pune,93421,59642,33779
2016-12-01,Barclays,CitiBank Pune,99997,54798,45199
2017-01-01,Barclays,CitiBank Pune,96649,51915,44734
2017-02-01,Barclays,CitiBank Pune,98616,56539,42077
2017-03-01,Barclays,CitiBank Pune,96187,53594,42593
2017-04-01,Barclays,CitiBank Pune,98354,52988,45366
2017-05-01,Barclays,CitiBank Pune,95426,51993,43433
2017-06-01,Barclays,CitiBank Pune,94113,56839,37274
2017-07-01,Barclays,CitiBank Pune,104272,55213,49059
2017-08-01,Barclays,CitiBank Pune,104186,56158,48028
2017-09-01,Barclays,CitiBank Pune,109552,52717,56835
2017-10-01,Barclays,CitiBank Pune,107143,52455,54688
2017-11-01,Barclays,CitiBank Pune,109943,56771,53172
2017-12-01,Barclays,CitiBank Pune,106292,56268,50024
2018-01-01,Barclays,CitiBank Pune,109332,52216,57116
2018-02-01,Barclays,CitiBank Pune,106448,52332,54116
2018-03-01,Barclays,CitiBank Pune,106833,59373,47460
2018-04-01,Barclays,CitiBank Pune,108477,57119,51358
2010-01-01,Barclays,CitiBank Singapore,16863,94856,-77993
2010-02-01,Barclays,CitiBank Singapore,11143,94638,-83495
2010-03-01,Barclays,CitiBank Singapore,12247,96739,-84492
2010-04-01,Barclays,CitiBank Singapore,14652,98156,-83504
2010-05-01,Barclays,CitiBank Singapore,15325,99825,-84500
2010-06-01,Barclays,CitiBank Singapore,15169,95958,-80789
2010-07-01,Barclays,CitiBank Singapore,13915,97243,-83328
2010-08-01,Barclays,CitiBank Singapore,14981,93772,-78791
2010-09-01,Barclays,CitiBank Singapore,15649,99324,-83675
2010-10-01,Barclays,CitiBank Singapore,12352,96118,-83766
2010-11-01,Barclays,CitiBank Singapore,23157,91353,-68196
2010-12-01,Barclays,CitiBank Singapore,21167,96248,-75081
2011-01-01,Barclays,CitiBank Singapore,23476,95111,-71635
2011-02-01,Barclays,CitiBank Singapore,25789,92472,-66683
2011-03-01,Barclays,CitiBank Singapore,25126,91316,-66190
2011-04-01,Barclays,CitiBank Singapore,21326,94421,-73095
2011-05-01,Barclays,CitiBank Singapore,25418,94717,-69299
2011-06-01,Barclays,CitiBank Singapore,22398,93276,-70878
2011-07-01,Barclays,CitiBank Singapore,24735,98427,-73692
2011-08-01,Barclays,CitiBank Singapore,27474,98498,-71024
2011-09-01,Barclays,CitiBank Singapore,39367,87758,-48391
2011-10-01,Barclays,CitiBank Singapore,39132,87213,-48081
2011-11-01,Barclays,CitiBank Singapore,32848,86144,-53296
2011-12-01,Barclays,CitiBank Singapore,38227,89433,-51206
2012-01-01,Barclays,CitiBank Singapore,35848,87222,-51374
2012-02-01,Barclays,CitiBank Singapore,38711,88225,-49514
2012-03-01,Barclays,CitiBank Singapore,35699,83594,-47895
2012-04-01,Barclays,CitiBank Singapore,35646,87435,-51789
2012-05-01,Barclays,CitiBank Singapore,34615,84297,-49682
2012-06-01,Barclays,CitiBank Singapore,35556,84322,-48766
2012-07-01,Barclays,CitiBank Singapore,45477,88148,-42671
2012-08-01,Barclays,CitiBank Singapore,45866,89123,-43257
2012-09-01,Barclays,CitiBank Singapore,49389,85635,-36246
2012-10-01,Barclays,CitiBank Singapore,46143,87128,-40985
2012-11-01,Barclays,CitiBank Singapore,49227,83586,-34359
2012-12-01,Barclays,CitiBank Singapore,47417,82837,-35420
2013-01-01,Barclays,CitiBank Singapore,48311,83894,-35583
2013-02-01,Barclays,CitiBank Singapore,45619,83941,-38322
2013-03-01,Barclays,CitiBank Singapore,46212,87846,-41634
2013-04-01,Barclays,CitiBank Singapore,45921,87296,-41375
2013-05-01,Barclays,CitiBank Singapore,58476,79421,-20945
2013-06-01,Barclays,CitiBank Singapore,54715,79587,-24872
2013-07-01,Barclays,CitiBank Singapore,51621,71952,-20331
2013-08-01,Barclays,CitiBank Singapore,52154,73295,-21141
2013-09-01,Barclays,CitiBank Singapore,57133,76592,-19459
2013-10-01,Barclays,CitiBank Singapore,54332,72435,-18103
2013-11-01,Barclays,CitiBank Singapore,53662,79958,-26296
2013-12-01,Barclays,CitiBank Singapore,52921,79189,-26268
2014-01-01,Barclays,CitiBank Singapore,54548,76432,-21884
2014-02-01,Barclays,CitiBank Singapore,52479,77863,-25384
2014-03-01,Barclays,CitiBank Singapore,65545,72594,-7049
2014-04-01,Barclays,CitiBank Singapore,67367,79937,-12570
2014-05-01,Barclays,CitiBank Singapore,67812,76466,-8654
2014-06-01,Barclays,CitiBank Singapore,66434,76976,-10542
2014-07-01,Barclays,CitiBank Singapore,62737,78744,-16007
2014-08-01,Barclays,CitiBank Singapore,63161,76491,-13330
2014-09-01,Barclays,CitiBank Singapore,66733,77643,-10910
2014-10-01,Barclays,CitiBank Singapore,69543,72377,-2834
2014-11-01,Barclays,CitiBank Singapore,65527,76453,-10926
2014-12-01,Barclays,CitiBank Singapore,68952,76313,-7361
2015-01-01,Barclays,CitiBank Singapore,76466,62816,13650
2015-02-01,Barclays,CitiBank Singapore,75991,64273,11718
2015-03-01,Barclays,CitiBank Singapore,76556,65342,11214
2015-04-01,Barclays,CitiBank Singapore,71548,69697,1851
2015-05-01,Barclays,CitiBank Singapore,79285,66219,13066
2015-06-01,Barclays,CitiBank Singapore,75675,64489,11186
2015-07-01,Barclays,CitiBank Singapore,77169,64877,12292
2015-08-01,Barclays,CitiBank Singapore,74124,69563,4561
2015-09-01,Barclays,CitiBank Singapore,76565,68945,7620
2015-10-01,Barclays,CitiBank Singapore,72413,66142,6271
2015-11-01,Barclays,CitiBank Singapore,81691,66759,14932
2015-12-01,Barclays,CitiBank Singapore,88556,62774,25782
2016-01-01,Barclays,CitiBank Singapore,87515,66299,21216
2016-02-01,Barclays,CitiBank Singapore,87852,61313,26539
2016-03-01,Barclays,CitiBank Singapore,83782,62872,20910
2016-04-01,Barclays,CitiBank Singapore,84163,65157,19006
2016-05-01,Barclays,CitiBank Singapore,89178,61426,27752
2016-06-01,Barclays,CitiBank Singapore,88873,68788,20085
2016-07-01,Barclays,CitiBank Singapore,84668,61786,22882
2016-08-01,Barclays,CitiBank Singapore,84467,65724,18743
2016-09-01,Barclays,CitiBank Singapore,93114,53232,39882
2016-10-01,Barclays,CitiBank Singapore,97122,59915,37207
2016-11-01,Barclays,CitiBank Singapore,94996,57748,37248
2016-12-01,Barclays,CitiBank Singapore,96418,56189,40229
2017-01-01,Barclays,CitiBank Singapore,92916,57177,35739
2017-02-01,Barclays,CitiBank Singapore,94135,57888,36247
2017-03-01,Barclays,CitiBank Singapore,96792,52379,44413
2017-04-01,Barclays,CitiBank Singapore,97733,59928,37805
2017-05-01,Barclays,CitiBank Singapore,99785,54735,45050
2017-06-01,Barclays,CitiBank Singapore,91773,56126,35647
2017-07-01,Barclays,CitiBank Singapore,103261,52361,50900
2017-08-01,Barclays,CitiBank Singapore,106528,58511,48017
2017-09-01,Barclays,CitiBank Singapore,105755,51416,54339
2017-10-01,Barclays,CitiBank Singapore,107823,59199,48624
2017-11-01,Barclays,CitiBank Singapore,108581,56259,52322
2017-12-01,Barclays,CitiBank Singapore,105939,59819,46120
2018-01-01,Barclays,CitiBank Singapore,105115,55149,49966
2018-02-01,Barclays,CitiBank Singapore,107862,56652,51210
2018-03-01,Barclays,CitiBank Singapore,109181,54928,54253
2018-04-01,Barclays,CitiBank Singapore,103552,54399,49153
2010-01-01,Barclays,CitiBank HongKong,16963,97168,-80205
2010-02-01,Barclays,CitiBank HongKong,19255,96859,-77604
2010-03-01,Barclays,CitiBank HongKong,18885,97616,-78731
2010-04-01,Barclays,CitiBank HongKong,14862,97438,-82576
2010-05-01,Barclays,CitiBank HongKong,13132,91649,-78517
2010-06-01,Barclays,CitiBank HongKong,15312,95259,-79947
2010-07-01,Barclays,CitiBank HongKong,18527,91837,-73310
2010-08-01,Barclays,CitiBank HongKong,12345,99835,-87490
2010-09-01,Barclays,CitiBank HongKong,16571,94519,-77948
2010-10-01,Barclays,CitiBank HongKong,13879,93379,-79500
2010-11-01,Barclays,CitiBank HongKong,22127,96865,-74738
2010-12-01,Barclays,CitiBank HongKong,24994,91337,-66343
2011-01-01,Barclays,CitiBank HongKong,26841,97851,-71010
2011-02-01,Barclays,CitiBank HongKong,25582,95913,-70331
2011-03-01,Barclays,CitiBank HongKong,23781,96294,-72513
2011-04-01,Barclays,CitiBank HongKong,28682,95629,-66947
2011-05-01,Barclays,CitiBank HongKong,21969,92313,-70344
2011-06-01,Barclays,CitiBank HongKong,25156,99258,-74102
2011-07-01,Barclays,CitiBank HongKong,27721,97252,-69531
2011-08-01,Barclays,CitiBank HongKong,22784,94812,-72028
2011-09-01,Barclays,CitiBank HongKong,33118,81738,-48620
2011-10-01,Barclays,CitiBank HongKong,36868,89667,-52799
2011-11-01,Barclays,CitiBank HongKong,37646,87935,-50289
2011-12-01,Barclays,CitiBank HongKong,31298,82934,-51636
2012-01-01,Barclays,CitiBank HongKong,37217,88848,-51631
2012-02-01,Barclays,CitiBank HongKong,33363,86389,-53026
2012-03-01,Barclays,CitiBank HongKong,32164,86299,-54135
2012-04-01,Barclays,CitiBank HongKong,31315,86564,-55249
2012-05-01,Barclays,CitiBank HongKong,32174,81557,-49383
2012-06-01,Barclays,CitiBank HongKong,34353,84585,-50232
2012-07-01,Barclays,CitiBank HongKong,49149,81124,-31975
2012-08-01,Barclays,CitiBank HongKong,46782,82643,-35861
2012-09-01,Barclays,CitiBank HongKong,46753,84821,-38068
2012-10-01,Barclays,CitiBank HongKong,42577,87726,-45149
2012-11-01,Barclays,CitiBank HongKong,46232,81422,-35190
2012-12-01,Barclays,CitiBank HongKong,47568,84372,-36804
2013-01-01,Barclays,CitiBank HongKong,43775,84912,-41137
2013-02-01,Barclays,CitiBank HongKong,48315,81668,-33353
2013-03-01,Barclays,CitiBank HongKong,45297,81879,-36582
2013-04-01,Barclays,CitiBank HongKong,49756,89889,-40133
2013-05-01,Barclays,CitiBank HongKong,59719,79846,-20127
2013-06-01,Barclays,CitiBank HongKong,53958,72481,-18523
2013-07-01,Barclays,CitiBank HongKong,54472,74926,-20454
2013-08-01,Barclays,CitiBank HongKong,55372,79977,-24605
2013-09-01,Barclays,CitiBank HongKong,54427,72783,-18356
2013-10-01,Barclays,CitiBank HongKong,55773,71831,-16058
2013-11-01,Barclays,CitiBank HongKong,51652,75572,-23920
2013-12-01,Barclays,CitiBank HongKong,58774,76424,-17650
2014-01-01,Barclays,CitiBank HongKong,57427,79166,-21739
2014-02-01,Barclays,CitiBank HongKong,52562,74466,-21904
2014-03-01,Barclays,CitiBank HongKong,65544,76388,-10844
2014-04-01,Barclays,CitiBank HongKong,64282,78934,-14652
2014-05-01,Barclays,CitiBank HongKong,67196,78789,-11593
2014-06-01,Barclays,CitiBank HongKong,66619,76574,-9955
2014-07-01,Barclays,CitiBank HongKong,68959,73133,-4174
2014-08-01,Barclays,CitiBank HongKong,61161,72693,-11532
2014-09-01,Barclays,CitiBank HongKong,64274,72382,-8108
2014-10-01,Barclays,CitiBank HongKong,62917,76336,-13419
2014-11-01,Barclays,CitiBank HongKong,68749,76472,-7723
2014-12-01,Barclays,CitiBank HongKong,66228,72597,-6369
2015-01-01,Barclays,CitiBank HongKong,77551,69178,8373
2015-02-01,Barclays,CitiBank HongKong,77949,63649,14300
2015-03-01,Barclays,CitiBank HongKong,77919,62483,15436
2015-04-01,Barclays,CitiBank HongKong,74779,68936,5843
2015-05-01,Barclays,CitiBank HongKong,75118,66914,8204
2015-06-01,Barclays,CitiBank HongKong,72359,67786,4573
2015-07-01,Barclays,CitiBank HongKong,76444,69438,7006
2015-08-01,Barclays,CitiBank HongKong,72573,62599,9974
2015-09-01,Barclays,CitiBank HongKong,76196,65975,10221
2015-10-01,Barclays,CitiBank HongKong,78523,64441,14082
2015-11-01,Barclays,CitiBank HongKong,81587,66936,14651
2015-12-01,Barclays,CitiBank HongKong,89862,66769,23093
2016-01-01,Barclays,CitiBank HongKong,82649,66492,16157
2016-02-01,Barclays,CitiBank HongKong,82859,68938,13921
2016-03-01,Barclays,CitiBank HongKong,84456,66148,18308
2016-04-01,Barclays,CitiBank HongKong,86429,65635,20794
2016-05-01,Barclays,CitiBank HongKong,88223,69765,18458
2016-06-01,Barclays,CitiBank HongKong,82488,65992,16496
2016-07-01,Barclays,CitiBank HongKong,89727,66274,23453
2016-08-01,Barclays,CitiBank HongKong,83829,69198,14631
2016-09-01,Barclays,CitiBank HongKong,97948,54114,43834
2016-10-01,Barclays,CitiBank HongKong,98483,55985,42498
2016-11-01,Barclays,CitiBank HongKong,94124,55593,38531
2016-12-01,Barclays,CitiBank HongKong,98485,53836,44649
2017-01-01,Barclays,CitiBank HongKong,95852,51638,44214
2017-02-01,Barclays,CitiBank HongKong,94874,55739,39135
2017-03-01,Barclays,CitiBank HongKong,98741,59235,39506
2017-04-01,Barclays,CitiBank HongKong,92266,57951,34315
2017-05-01,Barclays,CitiBank HongKong,99858,52499,47359
2017-06-01,Barclays,CitiBank HongKong,91881,52559,39322
2017-07-01,Barclays,CitiBank HongKong,104934,51612,53322
2017-08-01,Barclays,CitiBank HongKong,108189,53891,54298
2017-09-01,Barclays,CitiBank HongKong,109538,54357,55181
2017-10-01,Barclays,CitiBank HongKong,106117,54365,51752
2017-11-01,Barclays,CitiBank HongKong,103261,58779,44482
2017-12-01,Barclays,CitiBank HongKong,101924,58178,43746
2018-01-01,Barclays,CitiBank HongKong,101767,57814,43953
2018-02-01,Barclays,CitiBank HongKong,108477,56356,52121
2018-03-01,Barclays,CitiBank HongKong,104391,54533,49858
2018-04-01,Barclays,CitiBank HongKong,109316,51167,58149
